onlyoffice/4testing-docspace-doceditor,2.0.0.33,2023/11/24,350,89,71,2,0,512
vmware/kube-fluentd-operator,v1.18.1,2023/11/07,0,4,2,0,0,6
vmware/vs-openfaas-watchdog,revbf667b8,2017/12/11,211,544,568,143,35,1501
balenalib/parallella-debian-golang,20230904,2023/09/09,446,124,78,10,0,658
vmware/vsan-prometheus-exporter,v20210717,2021/07/17,15,98,110,45,0,268
rancher/vm-frontend,v0.2.0,2019/03/07,232,804,872,256,33,2197
circleci/builder-base,1.1,2017/01/11,304,355,22,2,0,683
bitnami/redis-exporter,1.55.0,2023/12/07,77,16,7,2,0,102
balena/rpi-supervisor-base,v1.4.7,2019/05/28,null
balenalib/qemux86-64-alpine-node,20231106,2023/11/07,0,7,3,0,0,10
ubuntu/apache2,2.4-23.04_edge,2023/12/11,11,2,0,0,0,13
rancher/hardened-cluster-autoscaler,v1.8.6-build20231010-s390x,2023/10/10,2,11,17,1,5,36
graphcore/poplar-minimal,3.3.0,2023/07/03,32,11,0,0,0,43
airbyte/destination-elasticsearch-strict-encrypt,0.1.6,2022/10/26,24,171,204,6,0,405
bitnami/express,4.18.2,2023/12/02,101,98,89,30,0,318
greenbone/boreas,v22.5.0,2023/05/02,93,42,30,4,0,169
rancher/nginx-ingress-controller-chroot,nginx-1.9.4-hardened1rc6-s390x,2023/10/26,2,7,17,0,0,26
balenalib/spacely-tx2-debian,20231106,2023/11/07,117,29,31,4,0,181
vmware/vs-secret-store,v0.0.1,2017/11/28,15,81,98,70,0,264
circleci/nomad-metrics,1.0,2020/11/17,0,1,0,0,0,1
balenalib/colibri-imx6dl-openjdk,20210602,2021/06/05,222,249,144,39,9,663
balenalib/i386-alpine-openjdk,8-20230911,2023/09/11,8,14,6,2,0,30
circleci/ecr-login,0.1.0-circle8,2020/05/27,null
intel/trusted-certificate-issuer,0.5.0,2023/03/10,49,48,1,0,0,98
balenalib/nitrogen6x-debian-python,20220604,2022/06/12,127,90,78,20,0,315
grafana/loki-canary-test,canary-test-58315f7-WIP,2022/09/23,0,14,14,0,0,28
rancher/docker,v1.11.2-3,2017/09/01,null
hashicorp/nomad-autoscaler-enterprise,0.3.6,2022/02/18,0,6,11,1,0,18
astronomerinc/ap-cadvisor,0.11.1,2020/01/23,0,10,2,0,0,12
balenalib/raspberrypi3,20230911,2023/09/11,121,45,42,6,0,214
balenalib/intel-nuc-ubuntu-openjdk,11-xenial-20230911,2023/09/11,null
vmware/vs-openfaas-python3-base,0.0.5-dev1,2017/12/12,15,128,162,93,0,398
datadog/apigentools,1.6.6,2023/09/21,2,3,7,2,0,14
bitnami/kafka-exporter,1.7.0,2023/12/07,77,19,8,2,0,106
jetbrains/qodana-python,2023.2,2023/09/06,145,72,72,11,0,300
airbyte/source-google-analytics-v4,0.2.2,2023/10/15,65,28,7,1,0,101
lacework/codesec,v1.0.4,2023/10/02,57,75,17,0,0,149
objectscale/throttler,0.54.0,2020/11/06,2,50,56,6,2,116
airbyte/source-convertkit,0.1.0,2022/10/27,0,19,25,1,0,45
onlyoffice/docspace-webhooks-service,test,2022/09/08,1045,346,362,23,1,1777
docker/dockerfile,1.6,2023/07/12,0,6,5,0,0,11
rancher/autoscale,v0.0.1,2016/06/23,0,27,24,10,0,61
airbyte/source-sendinblue,0.1.0,2022/11/10,0,19,25,1,0,45
airbyte/source-clickhouse-strict-encrypt,0.1.17,2023/03/22,25,176,193,6,0,400
balenalib/imx6ul-var-dart-alpine-openjdk,8-20231106,2023/11/07,0,6,2,0,0,8
balenalib/kitra520-fedora-golang,20220714,2022/07/23,null
balenalib/intel-nuc-ubuntu-node,20230911,2023/09/11,43,20,5,0,0,68
rancher/jenkins-jenkins,2.107-slim,2018/02/14,193,366,357,117,18,1051
balenalib/generic-armv7ahf-node,20230904,2023/09/09,121,47,43,6,0,217
airbyte/destination-rabbitmq,0.1.1,2022/09/09,0,19,25,1,0,45
bellsoft/buildpacks.native-image,5.9.0,1980/01/01,null
pachyderm/iris-infer,rstats,2017/04/20,234,641,708,121,40,1744
pachyderm/ubuntus3clients,v0.0.1,2020/03/05,705,1055,116,7,0,1883
docker/desktop-kubernetes-scheduler,v1.28.2,2023/09/13,0,3,4,0,0,7
pachyderm/pachyderm_jupyter,2019,2019/04/09,36,40,69,16,8,169
pachyderm/housing-prices,1.11.0,2020/07/23,451,958,191,20,0,1620
rancher/git-analyze,v0.7.0,2020/01/02,null
jetbrains/qodana-jvm-community,2023.2,2023/09/06,143,62,62,10,0,277
bitnami/fluxcd-kustomize-controller,1.1.1,2023/12/06,119,24,28,3,2,176
bitnami/postgres-exporter,0.15.0,2023/12/06,77,17,7,2,0,103
grafana/carbon-relay-ng,1.4.4,2023/07/27,0,12,6,3,0,21
mirantis/ucp-csi-resizer,3.5.3,2022/04/05,0,9,14,0,6,29
mirantis/ucp-interlock-proxy,3.7.1,2023/09/26,2,8,4,2,0,16
balenalib/jetson-tx2-debian-openjdk,20231106,2023/11/07,128,52,33,4,0,217
docker/dtr-content-cache-s390x,2.5.0-beta3,2018/01/17,0,2,2,2,0,6
kasmweb/tor-browser,1.14.0,2023/09/14,215,449,5,0,0,669
rancher/mirrored-calico-pod2daemon-flexvol,v3.26.3,2023/10/06,null
lacework/gcp-cfg-cli,v1.0,2019/01/21,833,1616,90,1,0,2540
balenalib/jetson-tx2-fedora,20231106,2023/11/06,null
balenalib/asus-tinker-board-fedora,20221210,2022/12/12,null
airbyte/destination-mysql-strict-encrypt,0.2.0,2023/06/29,29,190,236,21,0,476
cockroachdb/cockroach-unstable,v23.2.0-alpha.6,2023/11/08,17,16,0,0,0,33
airbyte/source-tiktok-marketing,3.9.2,2023/11/02,65,28,7,1,0,101
rancher/mirrored-elemental-seedimage-builder,1.3.4,2023/09/12,null
balenalib/revpi-core-3-python,20230530,2023/06/27,121,46,42,6,0,215
newrelic/k8s-nri-redis,1.4.0,2020/01/17,null
rapidfort/consul-official,1.16,2023/12/14,0,1,0,0,0,1
docker/dtr-s390x,2.4.12,2019/05/06,9,33,53,11,0,106
balenalib/odroid-xu4-ubuntu-node,20231026,2023/11/02,38,19,1,0,0,58
rapidfort/traefik,v2.9.10,2023/04/06,0,10,4,0,0,14
intel/esp-dyn-profile,v3.1.2,2023/07/25,null
onlyoffice/gdrive-builder,1.0.0-rc15,2023/09/18,0,7,5,0,0,12
objectscale/fabric-proxy,0.71.3,2021/04/05,2,18,23,0,0,43
balenalib/i386-nlp-debian-openjdk,20210225,2021/04/19,235,257,157,48,11,708
objectscale/ecs-flex-graphql,0.71.3,2021/04/14,11,34,31,1,0,77
balena/ca-private,0.0.13,2023/05/19,474,245,172,15,2,908
ubuntu/cassandra,4.0-22.04_edge,2023/05/17,38,67,12,0,0,117
rancher/hyperkube-base,v0.0.18,2023/10/16,41,52,0,0,0,93
grafana/agent-operator,v0.37.4,2023/11/06,14,7,0,0,0,21
rancher/longhornio-longhorn-ui,v1.3.1,2022/08/11,7,45,46,3,14,115
objectscale/snmp-notifier,2.114.0-264.7f91db2,2023/08/25,2,7,6,0,0,15
balenalib/generic-armv7ahf-ubuntu-node,20230904,2023/09/09,43,20,5,0,0,68
rancher/tiller,v2.11.0,2018/09/25,0,0,0,2,0,2
datadog/cws-instrumentation-dev,will-inject-k8s-user-info,2023/11/06,null
balenalib/odroid-c1-ubuntu-openjdk,20210826,2021/09/04,136,435,10,0,0,581
balenalib/spacely-tx2-ubuntu-python,20231103,2023/11/06,37,19,0,0,0,56
rancher/mirrored-kube-state-metrics-kube-state-metrics,v2.6.0,2022/08/24,0,4,4,1,0,9
balenalib/jetson-tx2-ubuntu-python,20230530,2023/06/11,54,30,4,0,0,88
intel/intelligent_traffic_management_video_inference,1.0,2022/06/17,428,1336,60,0,0,1824
docker/desktop-kubernetes-apiserver,v1.28.2,2023/09/13,0,3,4,0,0,7
bitnami/rabbitmq,3.12.8,2023/11/17,101,26,14,4,0,145
pachyderm/example-joins-inner-outer,2.1.0,2022/02/10,829,982,743,96,5,2655
airbyte/destination-databricks,1.1.0,2023/06/08,29,190,239,21,0,479
greenbone/scap-data,202311150504,2023/11/15,null
amazon/amazon-keyspaces-toolkit,0.7.8,2021/12/14,15,179,194,16,0,404
airbyte/cron,0.50.34,2023/11/09,21,73,56,2,0,152
mattermost/fleet-controller,7549599,2022/09/16,0,16,14,1,0,31
pachyderm/mount-server-arm64,97276071e371d5b1ea221437e99cfd87b5599ddf,2023/11/03,91,23,30,2,1,147
balenalib/generic-armv7ahf-fedora-openjdk,30-20210825,2021/09/03,null
atlassian/forge-tunnel,0.8.0-next.4,2020/02/11,587,831,93,6,0,1517
redislabs/redis-bionic,5.0.5,2019/06/06,93,72,2,0,0,167
vmware/photon-2.0-kube-proxy-amd64,v1.10.2-20180619,2018/06/19,17,94,117,76,0,304
balenalib/beaglebone-black-fedora-node,36-build-20230712,2023/07/17,0,1,1,0,0,2
airbyte/destination-iceberg,0.1.4,2023/07/27,32,182,239,20,0,473
balenalib/revpi-core-3-node,20230530,2023/07/02,121,47,43,6,0,217
onlyoffice/docs-proxy-de,7.5.1-1,2023/11/09,16,5,1,1,0,23
mattermost/release-bot,v0.0.1,2022/12/28,0,1,1,0,0,2
balenalib/fincm3-debian-python,20230530,2023/06/27,121,46,42,6,0,215
docker/resource-usage-extension,1.0.3,2023/05/25,0,10,2,3,0,15
balenalib/fincm3-openjdk,20230530,2023/07/04,146,81,48,6,0,281
bellsoft/liberica-openjdk-alpine-musl,21.0.1-12,2023/11/14,0,2,2,0,0,4
rancher/kibana,5.6.4,2017/11/08,50,130,107,42,20,349
google/dart-runtime,2.16-beta,2021/12/13,187,114,125,39,12,477
cockroachdb/example-orms-builder,20200729-1723,2020/07/29,910,1038,920,176,29,3073
airbyte/source-secoda,0.1.0,2022/11/08,0,19,25,1,0,45
rancher/library-traefik,2.4.9,2021/06/22,4,20,37,4,0,65
snyk/snyk-iac-rules,1.8.0,2023/06/05,0,5,2,0,0,7
airbyte/source-bamboo-hr,0.2.2,2022/10/06,78,44,39,3,0,164
astronomerinc/ap-configmap-reloader,0.12.0,2023/10/04,null
onlyoffice/docs-proxy,7.5.1-1,2023/11/09,16,5,1,1,0,23
rancher/confd,v0.12.0-alpha3,2017/02/10,1,36,13,3,0,53
balenalib/zynq-xz702-python,20220604,2022/06/12,127,90,78,20,0,315
intel/intel-optimized-clickhouse,23.11_oh,2023/04/24,48,55,6,0,0,109
grafana/enterprise-logs,v1.8.4,2023/10/18,0,5,3,0,0,8
objectscale/dell-supportassist-ese,2.71.3,2021/04/14,293,637,13,0,0,943
bitnami/wavefront-proxy-archived,12.4.0,2023/06/14,78,28,17,2,0,125
onlyoffice/documentserver-develop,develop,2022/10/24,361,1160,78,0,0,1599
rancher/mirrored-prom-prometheus,v2.18.2,2020/06/09,2,24,28,0,0,54
balenalib/armv7hf-golang,20230929,2023/10/02,445,124,79,10,0,658
grafana/otel-lgtm,0.1.0,2023/11/03,160,93,30,0,0,283
okteto/nginx,alpine,2018/11/13,2,18,6,5,0,31
airbyte/source-teradata,0.1.0,2023/04/06,25,174,193,6,0,398
onlyoffice/doc-builder-testing,next-release,2023/12/19,506,249,64,3,2,824
cockroachdb/visus,v0.2.0,2023/11/05,0,1,0,0,0,1
airbyte/airbyte-csv-destination-abprotocol,0.1.0,2020/10/20,97,79,81,24,7,288
rancher/mirrored-cilium-hubble-ui-backend,v0.12.1,2023/10/11,0,3,2,0,0,5
pachyderm/sentimentalist,1.11,2020/09/03,1474,1471,1087,154,40,4226
pachyderm/go-test-results,0.0.11,2023/08/10,0,9,10,0,0,19
vmware/vs-identity-manager,v0.0.1,2017/11/28,15,81,98,70,0,264
balenalib/bananapi-m1-plus,20230911,2023/09/11,121,45,42,6,0,214
airbyte/source-infinite-feed,dev,2021/05/07,102,91,96,27,7,323
balenalib/aarch64-ubuntu-golang,20231103,2023/11/06,141,137,1,0,0,279
jetbrains/upsource-cassandra,2020.1.1992,2022/03/11,91,161,198,63,11,524
rancher/mirrored-jetstack-cert-manager-controller,v0.8.1,2019/06/18,0,0,0,2,0,2
balenalib/hummingboard-node,20230904,2023/09/09,121,47,43,6,0,217
portainer/dev-toolkit,2023.10,2023/10/19,182,176,19,3,0,380
balenalib/parallella,20230904,2023/09/09,121,45,42,6,0,214
balenalib/parallella-debian-node,20230904,2023/09/09,121,47,43,6,0,217
balenalib/aarch64-fedora-python,20231106,2023/11/06,null
mattermost/mattermost-prod-web,v5.33.3,2021/03/31,8,31,55,9,0,103
okteto/codefresh-installer,1.0.2,2020/07/30,99,82,84,22,7,294
balenalib/zynq-xz702-debian-openjdk,20210602,2021/06/05,222,249,144,39,9,663
balenalib/qemux86-64-alpine-openjdk,8-20231106,2023/11/07,0,6,2,0,0,8
appdynamics/ad-air-load,java,2021/01/15,53,104,130,34,17,338
balenalib/beaglebone-green-ubuntu,20231026,2023/11/02,37,18,0,0,0,55
bitnami/sealed-secrets,0.24.3,2023/11/09,0,2,0,0,0,2
bitnami/postgresql-repmgr,16.1.0,2023/11/30,99,23,10,2,0,134
balenalib/via-vab820-quad-fedora,20220604,2022/06/12,null
intel/esp-smb,v3.1.2,2023/07/25,null
pachyderm/breast_cancer_classifier,1.11.6,2022/05/04,228,549,80,8,0,865
onlyoffice/4testing-documentserver-de,7.5.1.35,2023/11/15,125,120,2,1,0,248
balenalib/asus-tinker-board-s-alpine-node,18.14.1-20231106,2023/11/07,0,7,3,0,0,10
balenalib/via-vab820-quad-ubuntu-golang,20220523,2022/06/03,221,534,46,0,0,801
kong/kong-mesh-ecs-controller,0.1.0,2022/02/16,0,18,20,1,0,39
docker/dockerfile-copy-arches,v0.1.3.x86_64,2018/08/20,0,1,0,3,0,4
balenalib/apalis-imx6q-alpine,20220714,2022/07/19,7,43,33,10,0,93
balenalib/beaglebone-green-wifi-ubuntu,20231026,2023/11/02,37,18,0,0,0,55
astronomerinc/ap-dind-golang,24.0.6,2023/09/21,2,25,21,2,0,50
accurics/cli-kubescan-amd64,1.0.41,2022/09/01,0,31,28,1,0,60
airbyte/source-omnisend,0.1.0,2022/10/30,0,19,25,1,0,45
rancher/opni-opensearch-update-service,v0.12.1-rc1,2023/11/10,0,2,8,0,3,13
balenalib/beaglebone-black-ubuntu-node,20230530,2023/07/02,55,30,5,0,0,90
datadog/system-tests,uwsgi-poc.base-v1,2023/10/18,257,83,45,2,2,389
bitnami/wavefront-proxy,12.4.0,2023/06/14,78,28,17,2,0,125
lacework/datacollector-windows,1.7.2.3973,2023/11/14,null
balenalib/qemux86-64-debian-golang,20231103,2023/11/05,440,97,56,6,0,599
airbyte/source-shortio,0.2.0,2023/08/03,0,17,24,1,0,42
onlyoffice/gdrive-callback,1.0.0-rc15,2023/09/18,0,7,6,0,0,13
okteto/worker,1,2020/02/19,95,93,29,4,0,221
ubuntu/nginx,1.24-23.10_edge,2023/12/11,10,1,0,0,0,11
rancher/dns-windows,v0.17.0,2017/12/11,null
balenalib/raspberry-pi2-alpine-node,18.14.1-20231106,2023/11/07,0,7,3,0,0,10
airbyte/source-lemlist,0.2.0,2023/09/01,0,17,24,1,0,42
airbyte/secrets-migration,dev-28,2021/10/19,100,109,103,27,7,346
astronomerinc/ap-blackbox-exporter,0.24.0-3,2023/11/06,0,8,2,0,0,10
bitnami/harbor-core,2.9.1,2023/12/06,77,17,7,2,0,103
onlyoffice/docspace-migration,test,2022/09/08,1045,346,362,23,1,1777
amazon/aws-sam-cli-emulation-image-python3.7,20220125,2022/01/25,1,144,86,15,0,246
balenalib/hummingboard-alpine-python,20230904,2023/09/09,2,7,5,2,0,16
okteto/go-todo-list,dev,2021/03/11,717,517,477,76,19,1806
rancher/portainer-agent,v0.1.0,2017/03/03,0,1,5,2,0,8
pachyderm/gh-sum,v8,2018/05/02,511,1478,1010,241,53,3293
lacework/win-golang,1.21.0,2023/08/31,null
bitnami/aws-cli,2.13.30,2023/11/16,83,17,10,2,0,112
airbyte/source-outreach,0.5.0,2023/09/21,0,17,24,1,0,42
bitnami/mysql,8.2.0,2023/11/28,311,28,7,2,0,348
newrelic/k8s-nri-haproxy,2.1.0,2019/11/25,null
greenbone/pg-gvm-build,22.4,2022/07/25,523,313,257,31,1,1125
rancher/opni-python-base,3.9,2023/12/04,0,1,1,0,2,4
rancher/submariner,v0.0.1,2019/03/12,65,125,12,0,0,202
mirantis/ucp-kube-dns-dnsmasq-nanny,3.2.15,2021/06/29,0,0,0,2,0,2
vmware/sources-for-knative-adapter,v0.29.0,1970/01/01,0,4,7,0,0,11
rancher/storage-example,v0.6.1,2017/01/13,97,113,18,0,0,228
balenalib/spacely-tx2-fedora-python,20231106,2023/11/06,null
objectscale/crunchy-pgbackrest,ubi8-2.38-2,2022/07/05,268,187,47,0,0,502
graphcore/tensorflow,2,2023/03/14,161,363,59,1,0,584
kasmweb/ubuntu-focal-desktop,1.14.0,2023/09/14,296,674,0,0,0,970
airbyte/source-orb,1.1.0,2023/04/04,0,18,25,1,0,44
google/apigee-cert-manager-controller,v0.12.0,2019/11/28,0,0,0,0,6,6
solaceiotteam/solace-amplify-discovery-agent,0.2.4,2022/11/03,0,18,14,0,0,32
airbyte/source-google-directory,0.2.1,2023/06/22,0,17,25,1,0,43
airbyte/ci-runner,dev,2023/09/21,55,49,16,0,0,120
intel/intel-dlb-initcontainer,0.28.0,2023/09/22,null
circleci/welcome-config-image,0.2.1,2021/03/30,560,1527,1270,286,14,3657
balenalib/generic-armv7ahf-alpine-node,18.14.1-20230904,2023/09/09,2,7,6,2,0,17
intel/evi-ai-inference-cpu,master-ae213cd97d6931b1d44fc7689867cf5701e0f15d,2023/09/24,56,13,4,1,0,74
mattermost/chewbacca-bot,v0.1.7,2021/06/01,0,9,29,4,0,42
intel/classical-ml,2023.2-py3.10,2023/09/20,100,103,11,1,0,215
amazon/aws-otel-collector,v0.35.0,2023/11/02,0,1,1,0,0,2
rancher/prom-prometheus,v2.22.0,2020/10/15,6,38,34,0,0,78
couchbase/sdk-doctor,v1.0.5,2018/11/15,0,0,0,2,0,2
airbyte/source-gocardless,0.1.0,2022/10/19,0,19,25,1,0,45
balenalib/amd64-debian-node,20231106,2023/11/06,110,31,23,4,0,168
pachyderm/python-sdk-ci-testing,97276071e371d5b1ea221437e99cfd87b5599ddf,2023/11/03,65,13,3,1,0,82
airbyte/airbyte-api-server,0.50.34,2023/11/09,21,70,55,2,0,148
balenalib/kitra520-golang,20220714,2022/07/22,471,278,225,29,1,1004
bitnami/spring-cloud-dataflow-shell,2.11.1,2023/12/15,91,22,15,4,0,132
amazon/opendistro-for-elasticsearch-kibana,1.13.2,2021/04/05,554,535,99,13,0,1201
percona/haproxy,2.8.1,2023/11/03,133,62,3,0,0,198
mattermost/circleci-weblate-client,521a212,2020/07/30,1532,1570,1255,186,40,4583
rancher/rio-dashboard,preview,2019/11/18,203,361,38,3,0,605
rancher/mirrored-prometheus-operator-prometheus-config-reloader,v0.65.1,2023/05/05,null
cimg/deploy,2023.09.1,2023/09/25,328,387,50,0,0,765
bitnami/open-service-broker-azure-archived,1.8.4,2022/01/16,129,83,81,23,7,323
balenalib/armv7hf-fedora-node,36-build-20230911,2023/09/11,0,1,1,0,0,2
balenalib/asus-tinker-board-s-fedora-golang,20221210,2022/12/13,null
balenalib/artik533s-debian,20220714,2022/07/22,127,77,76,18,0,298
kasmweb/steam,1.14.0,2023/09/14,217,443,0,0,0,660
grafana/loki-canary,2.9.2,2023/10/25,0,4,3,0,0,7
objectscale/postgresql-repmgr,11.11.0-debian-10-r43,2021/03/30,157,116,124,35,7,439
netdata/netdata,v1.43.2,2023/10/30,0,13,2,0,0,15
onlyoffice/trello-client,1.0.7,2023/11/15,0,8,1,0,0,9
balenalib/fincm3-alpine,20230904,2023/09/09,2,6,5,2,0,15
rancher/kiali-kiali,v1.29.0,2021/01/22,240,343,30,3,0,616
kong/statsd-exporter,0.3.1,2020/04/20,null
intel/esp-aws-cli,v3.1.2,2023/07/25,0,1,0,1,0,2
intel/power-node-agent_ocp-4.13,v2.3.1,2023/09/08,27,37,8,0,0,72
balenalib/orangepi-plus2-debian-node,20230911,2023/09/11,121,47,43,6,0,217
balenalib/colibri-imx6dl-alpine,20220714,2022/07/19,7,43,33,10,0,93
balenalib/jetson-tx1-ubuntu-python,20230530,2023/06/26,54,30,4,0,0,88
datadog/chaos-injector,8.3.0,2023/10/26,39,32,25,5,0,101
cockroachdb/acceptance-gss-python,20221214-141947,2022/12/14,805,765,554,38,2,2164
balenalib/colibri-imx6dl-ubuntu,20220714,2022/08/02,87,91,11,0,0,189
continuumio/ap-git-storage,1.3.0,2018/05/31,0,28,16,31,0,75
rapidfort/mysql-official,8.0.35-debian,2023/12/19,23,9,2,0,0,34
rancher/mirrored-cilium-operator-azure,v1.14.4,2023/11/13,0,2,0,0,0,2
cimg/go,1.21.4,2023/11/07,328,370,44,0,0,742
puppet/gogrpc,go-1.17,2021/11/01,501,423,335,62,4,1325
docker/ucp-kube-compose-api,3.3.1,2019/11/07,4,14,9,1,0,28
balenalib/fincm3-fedora-python,20221109,2022/12/02,0,1,0,0,0,1
purestorage/log-upload,1.1.2,2023/10/31,0,10,6,0,0,16
airbyte/mirrored-keycloak-arm,21.1,2023/06/28,19,38,7,0,0,64
kasmweb/ubuntu-jammy-desktop,1.14.0,2023/09/14,358,599,35,0,0,992
redislabs/redis-connect,0.10.5.1,2023/10/04,3,12,8,1,0,24
bitnami/whereabouts,0.6.2,2023/12/06,77,20,9,2,0,108
balena/amd64-supervisor-base,v1.4.7,2019/05/28,null
rancher/channelserver,v0.6.0,2023/07/28,0,10,5,0,1,16
airbyte/source-kafka,0.2.3,2022/12/06,24,173,202,6,0,405
puppet/cd4pe-beta,3.13.7-rc,2021/04/16,52,75,83,16,7,233
okteto/java-gradle-getting-started,1.0.0,2023/02/27,112,89,116,36,0,353
docker/ucp-init-aws,2.1.0,2017/02/09,2,51,32,31,0,116
grafana/loki-operator,2.8.6,2023/10/17,0,6,2,0,0,8
newrelic/nri-kube-events,2.4.0,2023/11/13,0,1,1,0,0,2
google/apigee-canary-deployment-controller,1.0.0-rc4,2019/08/15,127,121,37,4,0,289
airbyte/destination-databend,0.1.2,2023/03/27,0,18,25,1,0,44
balenalib/spacely-tx2-ubuntu-node,20231103,2023/11/06,38,19,1,0,0,58
balenalib/nitrogen6x-fedora,20220604,2022/06/12,null
airbyte/cloud-cron,dev-97763408ca,2023/11/02,21,73,57,2,0,153
balenalib/armv5e-debian,20200221,2020/02/29,171,135,171,30,7,514
newrelic/k8s-nri-elasticsearch,4.2.0,2019/11/25,null
rancher/harvester-ui,v1.2.1,2023/10/25,0,106,53,17,0,176
vertica/vertica-ce,23.4.0-0,2023/09/21,618,524,6,0,0,1148
intel/intel-vpu-plugin,0.27.1,2023/06/20,56,13,4,1,0,74
airbyte/source-pexels-api,0.1.0,2022/11/18,0,19,25,1,0,45
grafana/cortex-alertmanager,w37-0193e7b7,2018/09/11,0,0,0,2,0,2
grafana/grafana-arm64v8-linux,7.0.6,2020/07/09,4,32,54,9,0,99
newrelic/fluentd,3.0.0,2020/03/26,55,216,178,13,8,470
google/apigee-authn-authz,1.8.0-preview.2,2021/08/29,0,0,0,0,5,5
balenalib/artik5-node,20220714,2022/07/20,127,79,77,18,0,301
tenable/was-scanner,2.6.1-1170,2023/11/14,10,38,1,0,0,49
airbyte/source-always-works-shim,dev,2021/05/18,101,66,81,30,8,286
rancher/lb-service-rancher,v0.9.14,2020/05/01,135,141,14,0,0,290
docker/compose,1.29.2,2021/05/10,0,2,25,4,0,31
bellsoft/buildpacks.gradle,6.11.0,1980/01/01,null
amazon/aws-lambda-go,1.2023.11.12.10,2023/11/12,0,3,0,0,0,3
rancher/pipeline-ui,v1.0.1,2018/01/11,71,75,130,41,12,329
vmware/photon-2.0-k8s-dns-sidecar-amd64,1.14.10-20180619,2018/06/19,15,72,90,57,0,234
airbyte/source-gong,0.1.0,2022/11/10,0,19,25,1,0,45
newrelic/infrastructure-k8s,2.13.11,2023/09/16,8,44,21,2,0,75
bitnami/kube-rbac-proxy,0.15.0,2023/12/07,0,2,3,0,0,5
solace/solace-pubsub-connector-tibcoems,1.0.0,2023/08/25,76,65,10,1,0,152
rancher/server-base,v1.0.0,2017/12/17,66,55,7,0,0,128
bellsoft/liberica-openjdk-centos,21.0.1-12,2023/11/14,551,504,32,3,0,1090
okteto/private,1,2022/09/09,671,314,282,43,11,1321
objectscale/nvmetargetviewer,3.9.0.0-139102.b4b5064355c,2023/05/03,3,36,28,1,0,68
balenalib/up-board-ubuntu-node,20230911,2023/09/12,43,20,5,0,0,68
balenalib/artik530-ubuntu,20220714,2022/08/02,87,91,11,0,0,189
balenalib/ts4900-ubuntu-golang,20220523,2022/06/03,221,534,46,0,0,801
grafana/mimir-continuous-test,2.10.4,2023/11/13,0,3,2,0,0,5
pachyderm/tweet-scraper,v3,2020/06/22,707,573,527,66,12,1885
rancher/hardened-kube-proxy,v1.20.2,2021/01/22,443,397,21,3,0,864
docker/assemble-backend,v0.5.0,2019/05/01,6,14,25,5,0,50
balenalib/jetson-tx2-alpine-openjdk,8-20231106,2023/11/06,8,14,2,0,0,24
rancher/mirrored-banzaicloud-logging-operator,3.17.10,2022/11/25,0,4,7,0,0,11
balenalib/asus-tinker-board-s-ubuntu-node,20231026,2023/11/02,38,19,1,0,0,58
hashicorp/vault-website,0.1.23,2019/10/16,12,186,106,14,0,318
rancher/windows-scheduler,v0.0.2,2017/02/17,306,388,24,0,0,718
objectscale/nds,0.71.3,2021/04/15,16,142,200,36,3,397
rancher/hardened-containerd,v1.7.7-k3s1-build20231010-s390x-linux,2023/10/11,2,20,23,0,5,50
rancher/rancher-agent,v2.8.0-rc3,2023/10/26,0,17,22,0,4,43
mirantis/ucp-nvidia-gpu-feature-discovery,3.7.1,2023/09/26,32,41,9,0,0,82
formio/pdf-server,5.3.5-rc.1,2023/11/14,209,206,2,0,0,417
balenalib/bananapi-m1-plus-debian,20230911,2023/09/11,121,45,42,6,0,214
docker/telemetry,1.0.0.linux-x86_64-test,0001/01/01,0,1,3,0,0,4
rancher/mirrored-flannelcni-flannel,v0.20.2,2022/11/30,3,27,22,2,0,54
airbyte/source-delighted,0.2.3,2023/09/08,65,29,7,1,0,102
cockroachdb/docs-builder,20210405-130258,2021/03/24,4,16,37,2,0,59
mattermost/mattermost-oncall-handler,v0.1.2,2023/05/11,4,26,6,0,0,36
rancher/goharbor-redis-photon,v1.7.5,2019/04/01,16,77,103,38,0,234
nginx/unit-preview,wasm-wasi-http,2023/11/02,84,22,18,4,0,128
okteto/compose,18.09.1,2019/01/17,4,15,16,10,0,45
balenalib/i386-debian-openjdk,20231106,2023/11/06,121,52,24,4,0,201
solace/pubsubplus-eventbroker-operator,1.0.2,2023/11/14,16,16,0,0,0,32
airbyte/source-psl-test,0.1.5-dev.db682fcfb4,2023/07/19,153,96,65,10,0,324
airbyte/source-freshservice,1.2.0,2023/08/16,0,17,24,1,0,42
bitnami/opensearch,2.11.0,2023/11/16,87,28,19,4,0,138
kasmweb/vmware-horizon,1.11.0,2022/07/06,440,1325,3,0,0,1768
onlyoffice/4testing-docs-docservice-de,7.5.1-1-saas,2023/11/08,16,3,1,1,0,21
grafana/grafana-dev-arm32v7-linux,master-91219227-4f9f-465a-8ea0-70670344aaaa-ubuntu,2020/05/15,129,284,40,4,0,457
docker/labs-debug-tools-extension,0.0.44,2023/11/14,13,47,20,4,0,84
cimg/openjdk,21.0.0,2023/10/17,333,371,48,0,0,752
balenalib/rpi-alpine,20231026,2023/11/01,0,6,2,0,0,8
bitnami/jasperreports,8.2.0,2023/12/17,119,63,76,17,0,275
objectscale/dellmon-pre-upgrade-crds,3.9.0.0-1588.729cf194,2023/04/25,2,12,4,0,0,18
rancher/docs,staging,2023/01/09,4,65,40,4,0,113
bitnami/discourse,9.0.4,0001/01/01,null
intel/multimodal-data-visualization,3.0,2022/07/27,0,59,83,1,0,143
balenalib/artik530-alpine,20220803,2022/08/03,7,43,33,10,0,93
airbyte/source-aws-cloudtrail,0.1.5,2023/02/28,78,39,27,2,0,146
tenable/terrascan,1.18.3,2023/08/03,1,20,4,1,0,26
docker/compose-bin,v2.23.0,2023/10/18,0,4,4,0,0,8
rancher/mirrored-k8scsi-csi-resizer,v1.1.0,2020/12/18,0,6,12,0,5,23
opensearchproject/logstash-oss-with-opensearch-output-plugin,8.9.0,2023/08/10,34,38,12,3,0,87
objectscale/bookkeeper,0.71.3,2021/03/30,634,813,85,11,0,1543
mirantis/ucp-calico-cni,3.7.1,2023/09/26,0,19,7,0,0,26
docker/dtr-registry-s390x,2.5.0-beta3,2018/01/17,0,16,41,34,0,91
balenalib/i386-alpine,20231106,2023/11/07,0,6,2,0,0,8
airbyte/source-babelforce,0.2.0,2023/08/24,0,17,24,1,0,42
okteto/chat,dev,2020/07/22,1391,1144,1077,121,20,3753
rancher/opni-ui,v0.3.1,2022/01/25,188,376,436,116,3,1119
balenalib/hummingboard-alpine,20230904,2023/09/09,2,6,5,2,0,15
airbyte/temporal,0.50.34,2023/11/09,5,48,33,2,0,88
objectscale/nvmeengine,3.9.0.0-139102.b4b5064355c,2023/05/03,3,36,28,1,0,68
balenalib/nitrogen6x-alpine-python,20220714,2022/07/19,7,44,35,10,0,96
docker/pilot,1.1.2,2019/04/12,446,623,51,0,0,1120
percona/percona-server-mongodb-operator,1.15.0,2023/10/06,26,28,5,0,0,59
percona/percona-xtradb-cluster-operator,1.13.0,2023/07/06,29,41,7,0,0,77
intel/ai-inference-cpu,evi-2.0.0,2022/10/31,34,18,0,0,0,52
rancher/storage-longhorn,v0.9.7,2018/07/09,88,163,12,0,0,263
kong/pulp-core,1.1.38,2022/08/24,4,14,10,4,0,32
balenalib/raspberrypi3-fedora-node,36-build-20230911,2023/09/12,0,1,1,0,0,2
newrelic/kube-webhook-certgen,v1.5.2-1-g18cfc89,2021/08/10,0,3,6,0,5,14
atlassian/bamboo,9.4.1,2023/12/12,53,76,20,14,0,163
airbyte/source-jira,0.10.2,2023/10/26,65,28,7,1,0,101
balenalib/artik5-debian-node,20220714,2022/07/20,127,79,77,18,0,301
okteto/buildkit,v0.7.2-6,2020/11/30,12,34,68,5,0,119
onlyoffice/4testing-docspace-ssoauth,2.0.0.33,2023/11/24,352,94,76,2,0,524
balenalib/jetson-tx1-debian-node,20230712,2023/07/18,121,50,44,6,0,221
amazon/dynamodb-local,2.1.0,2023/10/24,4,9,8,0,0,21
circleci/runner,9292817-dev,2022/12/26,74,140,2,0,0,216
rancher/etcd-tools,319,2023/11/15,6,64,39,8,0,117
rancher/opni,0.12.1-rc1,0001/01/01,null
mirantis/gerrit,2.14.11,2018/09/03,119,266,90,50,0,525
balenalib/via-vab820-quad-fedora-python,20220622,2022/07/12,0,1,1,0,0,2
jetbrains/upsource-psi-broker,2020.1.1992,2022/03/11,80,152,245,97,0,574
rapidfort/yourls,1.9.2-apache,2023/12/20,52,11,3,1,0,67
intel/evi-storage-rest,master-ae213cd97d6931b1d44fc7689867cf5701e0f15d,2023/09/23,141,53,17,1,0,212
airbyte/connector-acceptance-test,2.0.1,2023/09/08,546,319,106,10,2,983
atlassian/opsgenie-edge-encryption,2.3,2021/12/20,161,169,165,60,3,558
okteto/rails-blog,0.1.3,2019/01/29,583,1579,1302,272,14,3750
balenalib/apalis-imx6q-debian-python,20220604,2022/06/12,127,90,78,20,0,315
balenalib/aarch64-ubuntu-python,20231103,2023/11/06,34,16,0,0,0,50
sysdig/sdc-cli,0.2.8,2020/05/07,4,19,44,6,0,73
balenalib/zynq-xz702-fedora-python,20220622,2022/07/12,0,1,1,0,0,2
rancher/k8s,v1.12.10-rancher1-1,2019/09/03,414,613,35,0,0,1062
intel/intelligent_traffic_management_cloud_connector,2.0,2022/11/10,61,102,13,0,0,176
kasmweb/audacity,1.14.0,2023/09/14,229,457,0,0,0,686
redislabs/pcf-tile-manager-tests,100.0.9000481,2020/05/13,562,1546,1376,247,14,3745
mattermost/cloud-db-factory-horizontal-scaling,323a159,2020/06/16,3,15,27,4,0,49
intel/intel-sgx-plugin,0.28.0,2023/09/22,null
docker/ucp,3.3.1,2020/06/26,2,8,9,1,0,20
rancher/banzaicloud-logging-operator,3.9.0,2021/01/20,0,6,11,0,4,21
puppet/facter,5.5.1,2018/05/09,113,148,12,0,0,273
circleci/filebeat,console,2016/12/05,41,93,101,22,20,277
redhat/ubi8,8.8-1067,2023/09/13,155,45,6,0,0,206
couchbase/centos-72-jenkins-core,20170613,2017/07/06,713,885,130,12,0,1740
balenalib/armv7hf-debian-node,20230929,2023/10/02,114,47,35,6,0,202
docker/ucp-istio-mixer,3.3.1,2020/06/26,1,13,18,0,6,38
airbyte/source-jdbc,0.3.4,2022/06/17,77,81,64,19,0,241
objectscale/storagemanagement-service,0.71.3,2021/04/15,17,149,226,36,6,434
datadog/dd-lib-python-init,v2.1.7,2023/11/15,0,2,2,0,0,4
balenalib/parallella-alpine-node,18.14.1-20230904,2023/09/09,2,7,6,2,0,17
rancher/mirrored-sig-storage-csi-snapshotter,v6.2.1,2023/01/04,0,3,3,0,0,6
balenalib/armv7hf-fedora-golang,20221109,2022/12/03,null
grafana/shipwright,93616b8,2022/06/11,0,42,62,11,1,116
airbyte/source-github-test,0.3.9,2022/12/08,78,43,33,3,0,157
mirantis/ucp-csi-attacher,3.5.3,2022/04/05,0,9,14,0,6,29
grafana/plugin-builds,83986700d258dae901ead75668ed5d910256aee5pre,2023/10/04,2,12,8,2,0,24
okteto/ruby-getting-started,1.0.0,2023/02/27,780,624,357,24,2,1787
onlyoffice/4testing-ds-converter-de,6.2.0-eu-r2,2021/03/04,544,498,32,3,0,1077
balenalib/armv7hf-ubuntu-python,20231026,2023/11/02,34,16,0,0,0,50
grafana/test.k6.io,v0.0.5,2023/08/18,null
greenbone/gvm-tools,v23.11.0,2023/11/14,71,22,10,1,0,104
grafana/vectorapi,61165515c6,2023/10/30,78,20,13,4,0,115
mirantis/dtr-registry,3.0.0-alpha.2,2021/09/22,3,27,39,5,0,74
rancher/k8s-metrics-server,v0.3.6,2020/08/11,256,407,18,3,0,684
balenalib/zynq-xz702-golang,20220714,2022/07/28,471,275,219,29,1,995
mirantis/cluster,v1.9.0,2020/11/05,13,49,74,17,0,153
rancher/fleet,v0.9.0,2023/11/07,2,15,18,0,6,41
rancher/mirrored-k8s-dns-sidecar,1.22.20,2023/02/22,0,2,1,0,0,3
tenable/nessus,10.6.2-ubuntu-20231113,2023/11/13,21,35,0,0,0,56
rancher/mirrored-squareup-ghostunnel,v1.5.2,2019/11/20,5,18,34,2,0,59
docker/ucp-kube-dns-dnsmasq-nanny,3.2.7,2020/06/26,0,0,0,2,0,2
kong/go-echo,0.4.0,2023/10/25,null
kasmweb/core-ubuntu-bionic,1.14.0,2023/09/09,null
rancher/os,437034c,2017/06/20,0,19,15,6,0,40
balenalib/odroid-c1-debian-python,20220604,2022/06/12,127,90,78,20,0,315
rancher/mirrored-pause,3.7,2022/03/12,null
balenalib/spacely-tx2-fedora-openjdk,8-20231106,2023/11/06,null
percona/percona-xtradb-cluster,8.0.34,2023/10/24,79,35,0,0,0,114
onlyoffice/4testing-docspace-backup,2.0.0.33,2023/11/24,1024,156,211,13,0,1404
balenalib/beaglebone-black-fedora-golang,20220523,2022/06/05,null
rapidfort/memcached,1.6.21,2023/10/09,22,4,1,0,0,27
mirantis/rudder-federation,v0.1,2017/08/01,0,1,5,2,0,8
kasmweb/edge,1.14.0,2023/09/14,217,442,0,0,0,659
rancher/k3d-tools,5.3,2022/02/03,3,14,17,1,0,35
airbyte/destination-redis,0.1.4,2022/10/31,24,171,203,6,0,404
sysdig/sysdig,0.34.1,2023/11/07,299,203,14,0,0,516
bitnami/sonarqube,10.2.1,2023/11/17,92,54,42,4,0,192
circleci/runner-agent,machine-3.0.14-4844-3a4f06d,2023/11/09,24,17,0,0,0,41
balenalib/ts4900-alpine-openjdk,8-3.14-20220112,2022/01/19,2,50,42,13,0,107
datadog/agent-arm64,7.29.1,2021/07/12,34,130,102,5,0,271
objectscale/grafana,0.54.0,2020/11/06,2,70,81,11,3,167
rancher/mirrored-git-sync,v3.5.0,2022/03/11,122,65,78,23,5,293
atlassian/confluenec-servert,7.0.3,2021/03/29,146,400,419,129,0,1094
apachepinot/pinot-base-build,17-ms-openjdk,2023/06/14,227,279,25,0,0,531
balenalib/apalis-imx6q-alpine-python,20220714,2022/07/19,7,44,35,10,0,96
rancher/os-centosconsole,v1.5.8,2021/02/05,852,687,48,3,0,1590
okteto/go-getting-started,1.0.0,2023/02/27,652,241,211,15,6,1125
balenalib/artik530-golang,20220714,2022/07/22,471,278,225,29,1,1004
airbyte/source-notion,2.0.8,2023/11/01,65,28,7,1,0,101
balenalib/artik710-debian,20230904,2023/09/09,121,45,42,6,0,214
rancher/mirrored-neuvector-enforcer,5.2.3,2023/11/10,0,6,0,0,0,6
bitnami/phppgadmin-archived,7.13.0,2022/01/13,296,287,179,31,13,806
rancher/flannel,v0.11.0,2020/08/11,474,534,26,3,0,1037
airbyte/source-partnerstack,0.1.0,2022/11/09,0,19,25,1,0,45
kasmweb/core-rockylinux-8,1.14.0,2023/09/09,1,69,806,0,0,876
puppet/puppet-agent-ubuntu,7.20.0,2022/10/11,31,30,2,0,0,63
balenalib/orangepi-plus2-ubuntu-python,20231026,2023/11/02,37,19,0,0,0,56
bitnami/kubeapps-asset-syncer,2.9.0,2023/12/07,0,7,2,0,0,9
vmware/vke-canary,1.2,2019/01/11,15,124,156,82,0,377
grafana/grafana-plugin-ci,1.9.5,2023/10/17,204,59,72,2,3,340
airbyte/source-timely,0.3.0,2023/10/25,0,15,24,1,0,40
balenalib/ts4900-openjdk,20210602,2021/06/05,222,249,144,39,9,663
rapidfort/nginx-ib,1.25.2,2023/09/21,null
purestorage/dbdeployer,v1.2.2,2022/01/28,0,9,14,1,0,24
grafana/logstash-output-loki,2.9.2-amd64,2023/10/25,546,510,81,6,0,1143
accurics/terrascan,9814799,2020/08/16,2,15,43,4,0,64
rancher/vm,v0.2.0,2018/12/20,120,109,18,0,0,247
hashicorp/consul-smi-controller,v0.0.0-alpha.2,2019/07/17,4,14,9,3,0,30
google/apigee-istio-sidecar-injector,1.4.6,2020/02/22,648,1306,152,0,0,2106
snyk/snyk-cli,1.1228.0-gradle-5.4,2023/09/28,154,104,158,32,2,450
grafana/cloudsql-proxy,v1.18.1-prometheus2,2020/10/20,13,37,27,10,5,92
dynatrace/dynatrace-synthetic,1.275.47.20231003-143936,2023/10/03,23,19,5,0,0,47
rancher/mirrored-k8scsi-csi-attacher,v3.1.0,2020/12/16,0,6,13,0,5,24
percona/dbaas-operator,0.1.17,2023/07/04,0,3,1,0,0,4
balenalib/nitrogen6x-python,20220604,2022/06/12,127,90,78,20,0,315
google/apigee-istio-node-agent-k8s,1.4.6,2020/02/22,649,1313,158,0,0,2120
mattermost/mm-ee-cloud,21227_6978bb53_d6e98f0f,2023/11/02,52,50,6,0,0,108
balenalib/odroid-c1-ubuntu-golang,20220523,2022/06/03,221,534,46,0,0,801
atlassian/pipelines-docker-daemon-tini-init,stg-stable,2018/08/01,0,8,3,3,0,14
airbyte/destination-milvus-preview,dev,2023/08/31,65,32,11,4,0,112
balenalib/amd64-debian-golang,20231106,2023/11/06,439,97,56,6,0,598
portainer/extract-matomo,test-dockerfile,2023/02/13,0,16,4,0,0,20
vmware/notary-signer-photon,v0.5.1-v1.5.2,2018/07/18,8,54,72,36,0,170
balena/balena-push-env,9980750,2022/08/11,86,257,14,0,0,357
amazon/aws-sam-cli-emulation-image-python3.6,20220125,2022/01/25,1,143,87,15,0,246
balenalib/ts4900-ubuntu-python,20220622,2022/06/23,87,122,13,0,0,222
circleci/nomad-gc,0.0.87-74a5faf,2020/01/08,2,8,9,1,0,20
balenalib/fincm3-ubuntu-golang,20230712,2023/07/14,175,181,38,0,0,394
balenalib/armv7hf-alpine-golang,20231106,2023/11/07,0,6,2,0,0,8
astronomerinc/ap-curator,8.0.8-4,2023/11/06,0,4,0,0,0,4
newrelic/k8s-nri-apache,1.5.0,2019/12/10,null
airbyte/destination-snowflake,3.4.10,2023/11/08,8,44,61,17,0,130
okteto/movies,frontend,2019/09/09,560,1568,1266,266,14,3674
lacework/iac-scanner-jenkins,20220921,2022/09/21,218,659,66,1,0,944
google/apigee-istio-mixer,1.4.6,2020/02/22,1,13,18,0,6,38
kasmweb/core-almalinux-8,1.14.0,2023/09/09,3,105,914,0,0,1022
objectscale/zookeeper,0.30.0,2019/10/09,150,228,291,59,9,737
airbyte/np-dest,dev,2021/05/21,94,41,53,16,7,211
vmware/cascade-cli-toolchain,0.0.3,2018/10/23,198,434,450,96,14,1192
balenalib/artik530-ubuntu-golang,20220803,2022/08/03,245,468,66,0,0,779
intel/esp-dnsmasq,v3.1.2,2023/07/25,0,0,1,0,0,1
airbyte/connector-atelier-server,0.50.8,2023/07/17,26,88,112,2,0,228
intel/dlstreamer-pipeline-server,0.7.1,2022/02/22,428,1336,60,0,0,1824
launchdarkly/ld-find-code-refs-bitbucket-pipeline,2.11.4,2023/10/16,0,5,2,0,0,7
circleci/elixir,1.13.1,2022/01/01,858,1079,786,101,5,2829
redislabs/service-broker-internal,72_b401787,2019/01/08,0,0,4,2,0,6
cimg/unity,9.9.9,2022/02/11,235,663,360,39,0,1297
amazon/aws-sam-cli-emulation-image-nodejs12.x,20220125,2022/01/25,3,52,24,3,0,82
intel/query-rest,evi-2.0.0,2022/10/31,48,57,44,17,0,166
balena/cert-manager,0.1.17,2023/06/27,4,17,36,9,0,66
google/apigee-istio-proxy-init,1.2.0,2019/06/18,40,33,0,0,0,73
bellsoft/alpaquita-linux-gcc,13.2-stream-musl,2023/12/19,null
grafana/e2ealerting,master-63bd62ca,2020/11/09,2,18,42,4,0,66
grafana/bigtable-backup,master-418c0dd,2019/08/02,4,14,6,2,0,26
airbyte/cloud-worker,test,2022/10/13,30,184,209,5,0,428
cimg/testing,2023.10,2023/09/05,241,272,32,0,0,545
rapidfort/mongodb-ib,6.0.5,2023/10/25,100,53,8,0,0,161
balena/open-balena-s3,2.28.15,2023/11/02,362,115,68,6,6,557
balena/arm64-balena-multibuild-scripts,0.1.0,2019/10/01,6,22,33,3,0,64
bitnami/mastodon,4.2.1,2023/11/16,287,204,120,9,0,620
balenalib/fincm3-python,20230530,2023/06/27,121,46,42,6,0,215
launchdarkly/ld-gh-actions-pr-starts-with-verb,1.0,2019/03/03,51,54,86,21,9,221
passbolt/passbolt,3.12.0-3,2023/04/11,180,134,100,22,0,436
rancher/harvester-cluster-repo,v1.2.1,2023/10/26,0,8,11,0,1,20
rancher/hardened-sriov-cni,v2.6,2021/02/24,239,331,18,3,0,591
rancher/hardened-sriov-network-device-plugin,v3.3.1,2021/02/26,443,397,33,3,0,876
objectscale/objectscale-restapi,1.3.0-144.697e704,2023/09/07,2,10,8,0,0,20
pachyderm/mount-server,2.8.0-rc.2,2023/11/13,91,23,30,2,1,147
portainer/portable-env,1.0.3,2023/07/28,4,38,22,5,0,69
airbyte/source-alloydb-strict-encrypt,3.1.5,2023/08/23,27,167,193,6,0,393
balenalib/orangepi-plus2-node,20230911,2023/09/11,121,47,43,6,0,217
okteto/api,1.5.73,2020/03/27,3,19,43,4,0,69
rancher/lb-service-haproxy,v0.9.14,2020/05/01,263,490,23,0,0,776
airbyte/source-twilio-taskrouter,0.1.0,2022/11/18,0,19,25,1,0,45
hashicorp/demo-webapp,v3,2018/10/04,0,0,0,2,0,2
balenalib/rpi-alpine-python,20231026,2023/11/01,0,7,2,0,0,9
kasmweb/rockylinux-9-desktop,1.14.0,2023/09/14,0,6,3,0,0,9
airbyte/source-waiteraid,0.1.0,2022/10/28,0,19,25,1,0,45
airbyte/destination-postgres,0.4.0,2023/06/29,29,190,236,21,0,476
okteto/math,0.1.0,2019/05/01,6,15,25,6,0,52
portainer/portainer-extension,2.13.0-alpha.1,2022/04/28,4,39,33,1,0,77
circleci/fakes3,0.2.4,2016/09/07,504,3040,1867,503,75,5989
balena/arm-balena-multibuild-scripts,0.1.0,2019/10/01,6,22,33,3,0,64
bitnami/contour-operator,1.24.0,2023/05/15,0,2,3,0,0,5
balena/aarch64-supervisor-node,1244-update-lock-weirdness,2020/03/31,716,619,600,77,10,2022
objectscale/csi-baremetal-basemgr,0.69.0,2021/03/07,68,67,10,0,0,145
balenalib/intel-nuc-debian-golang,20231106,2023/11/06,440,97,56,6,0,599
circleci/php,8.0.12,2021/11/18,549,460,396,72,4,1481
okteto/webhook,1.5.73,2020/03/26,2,21,41,4,0,68
balenalib/beaglebone-green-wifi-fedora-python,20220928,2022/10/04,0,1,1,0,0,2
airbyte/normalization,0.6.1-alpha,2020/12/04,158,124,178,44,12,516
sysdig/sysdig-image-scanning-trigger,0.1.2,2020/05/06,2,10,27,4,0,43
jetbrains/datalore-server,2023.5.1,2023/10/18,54,115,18,0,0,187
kong/kong,20231115,2023/11/15,20,9,0,0,0,29
mirantis/ucp-csi-liveness-probe,3.5.3,2022/04/05,0,0,0,0,6,6
kong/kuma-cp,2.4.4,2023/11/06,0,2,2,0,0,4
bitnami/thanos,0.32.5,2023/12/06,0,2,2,0,0,4
airbyte/destination-mssql-strict-encrypt,0.2.0,2023/07/26,32,186,244,21,0,483
lacework/test-latest-dockerhub-tag,2023-11-15_pre-release_149e6f82c8e39153cfdffbc7f1fadc593436a7f5_RA,2023/11/15,0,2,2,0,0,4
bitnami/opensearch-dashboards,2.11.0,2023/12/02,87,26,13,8,0,134
kasmweb/desktop,1.14.0,2023/09/14,219,470,0,0,0,689
pingidentity/pingdatasync,2310,2023/11/01,3,16,11,0,0,30
portainer/k2d,1.0.0,2023/10/31,0,1,1,0,0,2
balenalib/kitra710-alpine-golang,3.16-20230904,2023/09/09,2,6,3,2,0,13
kasmweb/remnux-focal-desktop,1.14.0,2023/09/14,553,1199,146,12,0,1910
balenalib/artik533s-debian-python,20220714,2022/07/22,127,78,78,18,0,301
balenalib/zynq-xz702-ubuntu-python,20220622,2022/06/23,87,122,13,0,0,222
rancher/mirrored-k8scsi-livenessprobe,v2.2.0,2020/12/18,0,5,8,0,5,18
onlyoffice/4testing-docspace-dotnet-runtime,v1.0.0,2023/09/04,1026,188,234,16,0,1464
appdynamics/cluster-agent,23.9.0-107,2023/09/26,0,4,3,0,0,7
newrelic/nri-statsd-alpha,0.5.0,2020/04/23,3,18,21,1,0,43
airbyte/destination-langchain,0.1.1,2023/09/11,65,33,9,4,0,111
balenalib/raspberrypi3-alpine-node,18.14.1-20231106,2023/11/07,0,7,3,0,0,10
airbyte/source-appsflyer-singer,0.1.3,2021/07/06,609,357,337,50,12,1365
portainer/kubectl-shell,latest-v1.21.1-arm64,2021/11/14,7,53,48,6,0,114
appdynamics/servox,23.10.0,2023/10/06,97,89,76,28,1,291
airbyte/source-trello,1.0.2,2023/10/13,0,16,24,1,0,41
airbyte/source-braze,0.3.0,2023/11/04,0,15,24,1,0,40
rancher/os-modemmanager,v1.6.4-1,2018/12/12,76,50,93,26,12,257
kasmweb/ubuntu-focal-dind-rootless,1.14.0,2023/09/14,249,566,13,0,0,828
rancher/eks-operator,v2.0.1-rc1,2021/04/27,109,229,30,0,0,368
greenbone/vulnerability-tests,202311150559,2023/11/15,null
balenalib/orbitty-tx2-debian-python,20231106,2023/11/07,117,30,31,4,0,182
jetbrains/qodana,2022.2-eap,2022/10/26,75,162,12,2,0,251
airbyte/airbyte-base-java-image,2.0.3,2023/05/25,18,64,52,2,0,136
balenalib/odroid-c1-ubuntu-node,20220715,2022/07/19,88,113,12,0,0,213
datadog/lambda-extension,50,2023/11/02,0,0,1,0,0,1
mattermost/mattermost-elasticsearch-docker,7.17.3,2022/05/02,208,406,26,0,0,640
balenalib/hummingboard-ubuntu,20230904,2023/09/09,42,19,4,0,0,65
balena/i386-supervisor-node,1244-update-lock-weirdness,2020/03/31,716,619,600,77,10,2022
balenalib/artik533s-fedora,20220714,2022/07/23,null
airbyte/source-sap-fieldglass,0.1.0,2022/11/11,0,19,25,1,0,45
airbyte/integration-base-java,20230210,2023/02/10,23,154,179,4,0,360
docker/sso-sample-extension,0.0.2,2023/07/11,0,8,2,3,0,13
onlyoffice/4testing-ds-docservice-de,6.2.0-eu-r2,2021/03/04,544,498,32,3,0,1077
balenalib/intel-nuc-fedora-python,20231103,2023/11/04,null
balenalib/artik10-ubuntu-node,20220715,2022/08/02,88,92,12,0,0,192
rancher/rio-autoscaler,v0.1.6,2019/12/23,2,12,29,4,0,47
puppet/r10k,3.15.2,2022/10/05,1,27,22,4,0,54
balenalib/jetson-tx2-golang,20231106,2023/11/07,440,96,56,6,0,598
vmware/resource-checker-toolchain,0.2.1,2018/12/18,18,189,245,105,0,557
airbyte/normalization-oracle,0.4.3,2023/05/12,656,442,406,60,20,1584
jetbrains/qodana-python-community,2023.2,2023/09/06,145,70,72,11,0,298
docker/node-agent-k8s,1.1.2,2019/04/12,50,41,2,0,0,93
okteto/coder-python,dev,2020/04/25,1160,743,888,113,20,2924
grafana/cortex-blocksconvert,r111-453cbfce3,2020/11/03,2,19,47,4,0,72
balenalib/artik5-golang,20220714,2022/07/22,471,278,225,29,1,1004
balenalib/rpi-openjdk,8-20190705,2019/07/06,143,203,171,34,12,563
balenalib/i386-nlp-ubuntu-python,20210225,2021/04/20,121,246,17,0,0,384
airbyte/source-google-adwords-singer,0.2.6,2021/07/07,140,104,114,34,8,400
okteto/openfaas,golang,2020/06/12,722,630,552,81,12,1997
onlyoffice/4testing-docspace-telegram-service,test-2022112110,2022/11/21,1041,321,333,20,0,1715
graphcore/popart-minimal,3.3.0,2023/07/03,130,182,23,0,0,335
grafana/metrics-enterprise,v2.10.4,2023/11/14,0,4,2,0,0,6
airbyte/destination-scylla,0.1.3,2022/08/09,77,80,63,19,0,239
pachyderm/pachd,2.8.0-rc.2,2023/11/13,0,8,4,0,0,12
rancher/change-nodetemplate-owner,319,2023/11/15,30,8,0,0,0,38
balenalib/ts4900-fedora-openjdk,30-20210825,2021/09/03,null
datadog/fips-proxy,0.6.1,2023/10/26,19,10,0,0,0,29
balenalib/asus-tinker-board-s-openjdk,20230911,2023/09/12,132,73,46,6,0,257
balenalib/armv5e-openjdk,20200221,2020/02/29,245,298,213,44,9,809
bitnami/blackbox-exporter,0.24.0,2023/12/06,77,20,9,2,0,108
balenalib/orbitty-tx2-fedora-node,20231106,2023/11/06,0,1,1,0,0,2
kong/kuma-dp,2.4.4,2023/11/06,7,6,5,0,0,18
newrelic/cluster-api-controller,79dda1d3,2019/07/01,0,0,0,0,6,6
kasmweb/qbittorrent,1.14.0,2023/09/14,231,457,0,0,0,688
rancher/hardened-cilium-iproute2,4c18d06f1d545ed6fde810c2b97935dc8938ddc8-build20210521,2021/05/21,544,481,29,3,0,1057
ambassador/ambassador-agent,1.0.21,2023/11/10,0,8,7,0,0,15
kong/kong-gateway-dev,20231113-2,2023/11/13,22,10,0,0,0,32
vmware/ovs-secure-toolchain-photon,1.0.0,2018/06/23,21,214,224,93,0,552
bitnami/nginx,1.25.3,2023/12/09,77,16,7,2,0,102
rancher/mirrored-elemental-operator,1.3.4,2023/09/12,null
rancher/heapster-influxdb-amd64,v1.3.3,2017/09/05,null
airbyte/source-hubspot-singer,0.2.0,2021/03/03,102,76,83,31,8,300
atlassian/pipelines-dvcstools,1.13,2016/11/17,1,59,35,18,0,113
datadog/agent,7.50.0-rc.2,2023/11/14,10,15,2,0,0,27
circleci/container-agent,3.0,2023/03/30,0,16,3,0,0,19
mattermost/rtcd-daily,v0.11.0,2023/06/22,0,3,1,0,0,4
amazon/aws-node-termination-handler,4a12725,2019/11/26,0,9,14,0,0,23
circleci/frontend,0.2.33217-7008444,2023/10/13,42,43,1,0,0,86
rancher/cluster-register,v0.1.0,2017/09/19,null
rancher/jettech-kube-webhook-certgen,v1.5.0,2020/10/29,0,14,16,2,6,38
rancher/opni-agent,0.12.1-rc1,0001/01/01,null
airbyte/np-src,dev,2021/05/21,0,6,27,4,0,37
cimg/gcp,2023.09.1,2023/09/07,336,404,50,0,0,790
docker/runc-arches,v1.0.0-rc5.x86_64,2018/08/07,null
objectscale/geo-receiver,0.71.3,2021/04/15,15,108,141,15,6,285
balenalib/up-board-debian-openjdk,20230712,2023/07/16,null
balenalib/fincm3-fedora-golang,20220523,2022/06/04,null
bitnami/elasticsearch-exporter,1.6.0,2023/12/06,77,19,8,2,0,106
rancher/harvester-load-balancer-webhook,v0.2.2,2023/12/08,1,5,5,0,0,11
balenalib/orangepi-plus2-alpine-python,20231106,2023/11/07,0,7,2,0,0,9
rancher/k8s-dns-kube-dns-amd64,1.15.0,2018/11/12,0,0,0,2,0,2
grafana/k6,0.47.0,2023/10/10,0,5,4,0,0,9
rancher/flannel-cni,v0.3.0-rancher9-linux-arm64,2023/08/29,null
appdynamics/appdynamics-cloud-k8s-monitoring,23.10.0-1780,2023/10/23,1,15,9,0,0,25
ambassador/aes-wafsvc,v4.0.0-preview.2.dev.1,2023/10/27,0,2,1,0,0,3
objectscale/influxdb-operator,0.52.0,2019/07/30,null
snyk/kubernetes-monitor,2.4.17,2023/11/07,0,8,2,0,0,10
astronomerinc/ap-node-exporter,1.6.1,2023/07/17,0,3,1,0,0,4
google/apigee-prometheus-adapter,v0.9.1,2021/10/15,0,5,12,1,0,18
rapidfort/airflow-worker,2.5.1,2023/04/09,43,56,31,9,0,139
amazon/aws-sam-cli-emulation-image-java8,20220125,2022/01/25,1,134,113,32,0,280
balenalib/imx6ul-var-dart-fedora-golang,20221210,2022/12/13,null
hashicorp/nomad,1.7.0-beta.1,2023/11/01,0,5,1,0,0,6
formio/mongotest,1.0.0,2020/07/16,4,27,53,7,0,91
balenalib/hummingboard-debian-openjdk,20230904,2023/09/09,132,73,46,6,0,257
qualys/redis-client-for-jira-integration,1.2.0,2023/09/29,0,2,2,0,0,4
rancher/os-alpineconsole,v1.5.8,2021/02/05,5,8,9,1,0,23
hashicorp/consul-k8s-control-plane,1.3,2023/12/18,0,5,2,0,0,7
atlassian/pipelines-agent-metric-sidecar,stg-stable,2019/11/12,111,142,144,41,9,447
balenalib/via-vab820-quad-debian-golang,20220714,2022/07/28,471,275,219,29,1,995
bellsoft/liberica-openjdk-alpine,21.0.1-12,2023/11/14,0,2,2,0,0,4
amazon/aws-secrets-manager-secret-adm-controller,v0.1.5,2021/02/24,17,242,201,23,0,483
intel/rpbs_mips,1.0,2023/03/23,838,1246,60,0,0,2144
kasmweb/fedora-38-desktop,1.14.0,2023/09/14,0,4,2,0,0,6
snyk/snyk-kubernetes-operator,discardable-59116385da844f3bc116c77c893f24e55d019d20,2020/02/17,134,321,58,2,0,515
mattermost/mattermost-apps-cloud-deployer,8951213,2023/03/20,5,46,24,3,0,78
balenalib/bananapi-m1-plus-alpine-node,18.14.1-20231106,2023/11/07,0,7,3,0,0,10
puppet/pdk,3.0.0.0,2023/07/04,37,41,3,0,0,81
balenalib/beaglebone-green-fedora,20221109,2022/12/04,null
datadog/cluster-agent-dev-arm64,7-27-0-snmp-batch-size-config,2021/04/09,8,28,20,2,0,58
docker/ucp-istio-node-agent-k8s,3.3.1,2020/05/09,472,1165,149,0,0,1786
intel/esp-git,v3.1.2,2023/07/25,null
airbyte/source-airtable,4.1.5,2023/10/19,65,28,7,1,0,101
vmware/event-service-toolchain-photon,1.0.4,2019/02/21,59,266,266,102,0,693
bitnami/parse,6.3.1,2023/11/16,82,31,9,4,0,126
airbyte/destination-oracle-strict-encrypt,0.2.0,2023/06/29,29,190,236,21,0,476
balenalib/nitrogen6x-fedora-python,20220622,2022/07/12,0,1,1,0,0,2
grafana/cortex-table-manager,w37-0193e7b7,2018/09/11,0,0,0,2,0,2
balenalib/armv7hf-openjdk,20230929,2023/10/02,125,73,38,6,0,242
balenalib/imx6ul-var-dart,20230911,2023/09/11,121,45,42,6,0,214
okteto/pipeline-runner,1.0.3,2023/06/26,158,52,29,10,9,258
balenalib/intel-nuc-debian-python,20231106,2023/11/06,117,30,31,4,0,182
kumahq/kuma-injector,0.5.0-rc2,2020/04/27,2,8,7,1,0,18
rancher/kubernetes-dashboard,v0.0.1,2017/05/03,null
balenalib/parallella-fedora-node,36-build-20230530,2023/06/29,0,1,1,0,0,2
okteto/django,okteto,2020/03/24,1462,1789,1426,182,40,4899
continuumio/miniconda2,4.7.12,2019/10/16,214,222,285,60,13,794
pachyderm/kafka_spout,1.11.2,2020/08/28,165,397,404,66,12,1044
balenalib/colibri-imx6dl-debian-golang,20220714,2022/07/28,471,275,219,29,1,995
pachyderm/kubeflow_demo_trigger,v1.0.0,2020/04/10,0,19,0,0,0,19
kumahq/kuma-tcp-echo,0.4.0,2020/02/28,2,8,9,1,0,20
rancher/cert-manager-acmesolver,v0.11.0-rio.1,2019/10/22,0,0,0,0,6,6
redislabs/ng-redis-raft,966152886c0a5744ad6406b064d53aac4f20f04d,2023/01/20,72,30,24,2,0,128
rapidfort/apache-official,2.4.58-alpine3.18,2023/12/01,0,2,0,0,0,2
airbyte/source-apple-search-ads,0.1.1,2023/07/11,0,17,25,1,0,43
datadog/libddwaf,toolchain,2023/08/11,362,162,87,9,2,622
onlyoffice/docs-docservice,7.5.1-1,2023/11/09,16,3,1,1,0,21
rancher/pre-pull-images,v0.2.2,2018/06/01,306,388,24,0,0,718
airbyte/source-twitter,0.1.2,2023/03/07,0,18,25,1,0,44
balenalib/artik10-debian-python,20220714,2022/07/22,127,78,78,18,0,301
balenalib/kitra710-debian-golang,20230904,2023/09/09,446,127,78,10,0,661
intel/trusted-attestation-controller,0.4.0,2022/11/08,11,31,25,0,0,67
balenalib/colibri-imx6dl-ubuntu-python,20220622,2022/06/23,87,122,13,0,0,222
balenalib/orangepi-plus2-ubuntu,20231026,2023/11/02,37,18,0,0,0,55
jetbrains/runtime,ubuntu1804_arm64v8_clang,2021/06/22,1063,1448,142,3,1,2657
grafana/grafana-enterprise-image-tags,10.3.0-63462-arm64,2023/11/15,0,8,2,0,0,10
objectscale/influxdb,0.33.0,2020/07/06,5,53,67,6,2,133
docker/ucp-s390x,3.1.0-beta3,2018/10/04,0,2,6,16,0,24
continuumio/nginx-ingress-ws,1.5.2,2019/07/31,143,170,118,42,9,482
astronomerinc/ap-prisma,1.34.8,2020/04/08,2,19,60,26,0,107
mongodb/mongodb-enterprise-server,7.0.3-ubuntu2204-20231115T085919Z,2023/11/15,144,152,1,0,0,297
balenalib/raspberrypi3-debian-openjdk,20230530,2023/07/04,146,81,48,6,0,281
rancher/kube-proxy,v1.18.8,2020/08/28,462,471,22,3,0,958
google/apigee-cert-manager-cainjector,v0.12.0,2019/11/28,0,0,0,0,6,6
pachyderm/sqs-spout,1.9.8,2019/11/13,552,1489,1163,245,14,3463
rancher/hardened-multus-cni,v3.6,2021/02/23,242,351,38,3,0,634
airbyte/source-harness,0.1.0,2023/10/23,0,15,24,1,0,40
balenalib/artik533s,20220714,2022/07/22,127,77,76,18,0,298
kasmweb/core-opensuse-15,1.14.0,2023/09/09,5,28,42,0,1,76
mirantis/ucp-istio-proxyv2,3.4.15,2023/05/11,471,1159,140,1,0,1771
mattermost/focalboard,7.11.4,2023/09/26,95,62,49,12,7,225
okteto/dev,go1.17,2021/09/23,217,490,33,0,0,740
hashicorp/nomad-pack,0.1,2023/11/01,0,5,0,0,0,5
bitnami/cert-manager-webhook,1.13.2,2023/12/06,77,17,7,2,0,103
grafana/docker-puppeteer,1.1.0,2022/07/28,240,214,158,29,7,648
rancher/dns,v0.17.4,2018/07/09,306,388,24,0,0,718
astronomerinc/ap-postgres-exporter,3.14.2-1,2021/10/06,0,13,37,1,0,51
amazon/aws-sam-cli-emulation-image-python2.7,20220125,2022/01/25,1,141,88,15,0,245
rancher/calico-pod2daemon-flexvol,v3.18.1,2021/03/10,null
rancher/hardened-cilium-compilers,4c18d06f1d545ed6fde810c2b97935dc8938ddc8-build20210521,2021/05/21,923,1015,92,3,0,2033
balenalib/i386-nlp-python,20210225,2021/04/18,192,130,143,43,10,518
airbyte/source-bing-ads,1.13.0,2023/11/14,65,28,7,1,0,101
solaceiotteam/async-apim-admin-portal,0.4.5,2022/10/19,115,130,75,16,0,336
rancher/thanosio-thanos,v0.15.0,2020/09/07,5,26,19,0,0,50
datadog/synthetics-private-location-worker,1.41.0,2023/11/02,39,37,1,0,0,77
pachyderm/lb-interview,1.0,2022/05/27,0,14,14,1,0,29
rancher/vm-tools,v0.2.0,2018/12/21,472,657,44,0,0,1173
rancher/crictl,v1.19.0,2020/08/31,259,425,36,3,0,723
okteto/frontend,80907703,2023/02/03,4,63,36,4,0,107
bitnami/airflow-exporter,0.20220314.0,2023/12/06,77,17,7,2,0,103
bitnami/osclass,8.1.2,2023/12/02,155,96,58,5,0,314
balenalib/bananapi-m1-plus-fedora-node,36-build-20230530,2023/06/29,0,1,1,0,0,2
datadog/agent-buildimages-deb_arm64,v20433308-6861270,2023/09/25,3,25,19,0,0,47
qualys/crs-instrumenter,2.5.2.0-9,2022/09/28,2,4,14,0,0,20
rancher/istio-1.5-migration,0.1.1,2020/07/09,10,24,52,6,0,92
kasmweb/core-cuda-bionic,1.10.0,2022/06/07,234,883,20,0,0,1137
astronomerinc/ap-postgresql,15.4.0-1,2023/10/10,99,25,11,2,0,137
okteto/devtools,0.1.0,2019/01/19,706,1042,73,0,0,1821
airbyte/source-google-webfonts,0.1.0,2022/10/27,0,19,25,1,0,45
continuumio/ae-conda-packages,v3,2019/02/04,95,115,208,72,12,502
bitnami/photon-base-buildpack,4-r6,2023/06/16,5,62,40,6,0,113
objectscale/csi-resizer,v1.4.0,2022/01/21,0,4,7,0,0,11
newrelic/nr-otel-collector,0.6.0-rc,2023/11/13,0,4,3,0,0,7
vmware/clair,v2.0.1-photon,2017/11/23,11,78,117,69,0,275
balenalib/asus-tinker-board-s-debian-openjdk,20230911,2023/09/12,132,73,46,6,0,257
redislabs/redisgraph,2.12.10,2023/09/27,1,2,1,0,0,4
docker/ucp-coredns,3.3.1,2019/04/07,null
newrelic/nri-prometheus,2.19,2023/11/02,0,2,1,0,0,3
bitnami/prestashop,8.1.2,2023/12/02,152,91,72,4,0,319
balenalib/ts4900,20220714,2022/07/20,127,77,76,18,0,298
astronomerinc/ap-kibana,8.9.2,2023/10/31,21,18,1,1,0,41
balenalib/artik533s-ubuntu-node,20220715,2022/08/02,88,92,12,0,0,192
grafana/synthetic-monitoring-agent,v0.0.3,2020/08/26,95,78,83,22,7,285
circleci/cci-demo-go-primary,0.0.2,2017/03/15,209,612,632,166,36,1655
objectscale/objectscale-oktool,0.1.0-146.7ccfc1e,2023/04/20,7,64,65,6,6,148
balenalib/artik533s-openjdk,20220714,2022/07/22,160,136,87,18,0,401
redhat/ubi8-minimal,8.8-1072,2023/09/13,64,28,4,0,0,96
couchbase/analytics-demo,5.0.0-671,2017/08/22,83,79,7,0,0,169
pachyderm/pachtf,2.2.8,2022/08/18,0,16,15,0,0,31
bitnami/haproxy,2.8.3,2023/11/17,77,22,11,4,0,114
rapidfort/grafana-ib,9.5.3,2023/11/18,23,35,8,0,0,66
kasmweb/maltego,1.14.0,2023/09/14,224,474,0,0,0,698
okteto/python-getting-started,1.0.1,2023/02/27,78,37,26,2,0,143
formio/formio-enterprise,8.4.0-rc.24,2023/11/13,0,5,0,2,0,7
airbyte/source-aha,0.3.1,2023/06/05,0,17,25,1,0,43
balenalib/armv5e-debian-python,20191011,2019/10/29,183,177,177,35,9,581
rancher/rio-build,48f64897,2018/08/02,877,1348,105,0,0,2330
appdynamics/python-agent-init,5686,2023/02/06,0,12,8,0,0,20
astronomerinc/ap-po-logical-backup,1.8.1,2022/07/18,78,207,6,0,0,291
objectscale/remote-access,2.0.51,2020/09/29,45,140,171,23,0,379
portainer/config-manager,2.19.1,2023/09/27,null
rancher/opni-manager,v0.4.0,2022/04/01,5,57,42,3,17,124
docker/highland_builder,3979.0.0-stable,2023/06/20,0,8,4,4,0,16
okteto/supervisor,1.0.0,2021/04/16,0,1,0,0,0,1
airbyte/destination-gcs,0.4.4,2023/07/15,29,181,236,21,0,467
mongodb/mongodb-atlas-kubernetes-operator,2.0.0,2023/12/20,3,4,0,0,0,7
balenalib/up-board-debian-golang,20230712,2023/07/16,null
amazon/aws-sam-cli-emulation-image-provided.al2,20220125,2022/01/25,5,127,45,0,0,177
airbyte/source-chartmogul,1.0.0,2023/11/09,0,15,24,1,0,40
percona/percona-mysql-router,8.0.34,2023/09/15,240,89,13,0,0,342
balena/i386-nlp-supervisor,v10.11.3,2020/04/02,0,6,8,3,0,17
docker/volumes-backup-extension,1.1.4,2023/06/12,0,19,6,0,0,25
balenalib/ts4900-python,20220604,2022/06/12,127,90,78,20,0,315
google/apigee-envoy,v1.22.2,2022/06/10,11,18,10,2,0,41
intel/telemetry-aware-scheduling,0.6.0,2023/07/12,0,2,1,0,0,3
airbyte/source-clickup-api,0.1.1,2023/03/21,0,18,25,1,0,44
kasmweb/deluge,1.14.0,2023/09/14,224,444,0,0,0,668
newrelic/cluster-api-controller-arm,mv1a,2019/04/17,0,0,0,0,6,6
percona/dcos-mongo-tools,0.2.1,2018/07/02,null
docker/dtr-postgres-s390x,2.5.0-beta3,2018/01/17,0,15,26,5,0,46
amazon/aws-sam-cli-emulation-image-nodejs10.x,20220125,2022/01/25,3,54,30,3,0,90
onlyoffice/documentserver,7.5.1.1,2023/11/05,125,122,2,1,0,250
bellsoft/buildpacks.alpaquita-run,musl,2023/04/04,null
bitnami/telegraf,1.28.4,2023/11/13,77,18,7,2,0,104
rancher/calico,v3.13.3,2020/08/26,468,524,88,4,0,1084
bitnami/os-shell,11,2023/12/02,87,22,13,4,0,126
airbyte/source-youtube-analytics,0.1.4,2023/05/26,0,17,25,1,0,43
pachyderm/etcd,v3.5.5,2022/09/15,72,47,57,9,0,185
bitnami/wavefront-prometheus-storage-adapter-archived,1.0.7,2023/06/17,77,30,18,2,0,127
bitnami/nats,2.10.5,2023/11/10,77,17,7,2,0,103
greenbone/gvmd-build,23.1,2023/11/14,492,135,79,11,0,717
airbyte/airbyte-webapp,0.30.8-alpha-cloud-stage,2021/10/03,6,29,52,9,0,96
qualys/jira-client-for-jira-integration,1.2.0,2023/10/13,6,11,8,0,0,25
vmware/photon-2.0-kube-controller-manager-amd64,v1.10.2-20180619,2018/06/19,15,81,98,70,0,264
intel/intel-optimized-tensorflow-serving-avx512,2.8.0,2022/03/29,61,40,2,0,0,103
airbyte/normalization-clickhouse,0.4.3,2023/05/12,461,236,197,17,2,913
balenalib/imx6ul-var-dart-node,20230911,2023/09/12,121,47,43,6,0,217
grafana/cortex,single-binary-676071aa3-WIP-2,2019/05/09,0,0,0,2,0,2
percona/percona-postgresql-operator,2.2.0,2023/06/09,33,43,9,0,0,85
balena/open-balena-registry,2.39.27,2023/11/12,370,108,68,6,6,558
balenalib/apalis-imx6q-golang,20220714,2022/07/28,471,275,219,29,1,995
lacework/code-security-pipe,1.2.8,2023/10/30,58,71,22,1,0,152
atlassian/dynamodb-elasticsearch-indexer,3.0.10,2021/05/18,229,158,180,53,13,633
objectscale/rsyslog,0.54.0,2020/11/10,6,64,67,5,3,145
airbyte/source-close-com,0.4.3,2023/11/10,65,13,3,1,0,82
mattermost/node-rotator,11c4803,2023/05/25,0,12,3,3,0,18
kong/konnect-migration,debug,2022/10/12,78,46,43,3,0,170
ngrok/ngrok,3,1970/01/01,94,41,49,13,7,204
rancher/mirrored-coreos-flannel,v0.15.1,2021/11/12,2,17,27,3,0,49
balenalib/ts4900-alpine-python,20220714,2022/07/19,7,44,35,10,0,96
rancher/os-hypervvmtools,v1.5.8,2021/02/05,97,43,54,16,7,217
airbyte/source-sentry,0.3.0,2023/09/19,0,17,24,1,0,42
google/apigee-asm-ingress,1.12.9-asm.3,2022/09/30,15,12,12,0,0,39
balenalib/artik5-debian-python,20220714,2022/07/22,127,78,78,18,0,301
airbyte/destination-tidb,0.1.4,2023/06/23,31,195,250,21,0,497
balenalib/generic-aarch64-debian-openjdk,20231106,2023/11/07,128,52,33,4,0,217
rapidfort/gitlab-ce,latest-rfstub,2022/09/19,60,225,178,3,0,466
rancher/hardened-node-feature-discovery,v0.14.1-build20230926,2023/09/26,0,18,22,0,0,40
docker/dtr-jobrunner-s390x,2.5.0-beta3,2018/01/17,3,56,103,50,0,212
balenalib/zynq-xz702-fedora,20220604,2022/06/12,null
intel/oact-rps,v2.19.1,2023/11/01,0,2,0,0,0,2
kong/deck,v1.29.2,2023/11/08,0,2,2,0,0,4
docker/reefer,0.0.5,2018/08/09,0,0,0,2,0,2
astronomerinc/ap-pgbouncer,1.20.1-1,2023/11/02,0,4,0,0,0,4
adobecoldfusion/apimanager,latest-2023,2023/05/17,40,98,100,40,0,278
balena/open-balena-registry-proxy,5.0.23,2023/10/18,137,37,21,1,0,196
appdynamics/ad-air-java-services,netviz5,2021/01/26,95,133,109,32,0,369
mathworks/matlab,r2023b,2023/10/27,196,237,10,0,0,443
balenalib/raspberrypi3-ubuntu,20231026,2023/11/02,37,18,0,0,0,55
airbyte/source-kyve,0.1.0,2023/06/14,0,15,17,0,0,32
google/apigee-deployment-controller,1.1.1,2020/02/05,0,0,0,0,6,6
mirantis/ucp-hyperkube,3.7.1,2023/09/26,36,73,46,0,0,155
balenalib/ts4900-ubuntu-node,20220715,2022/07/19,88,113,12,0,0,213
balenalib/kitra520-alpine-python,20220803,2022/08/04,7,44,35,10,0,96
balenalib/nitrogen6x-debian-golang,20220714,2022/07/28,471,275,219,29,1,995
balenalib/raspberry-pi2-ubuntu-node,20231026,2023/11/02,38,19,1,0,0,58
portainer/golang-builder,cross-platform-next,2018/05/20,200,463,502,111,15,1291
intel/esp-uos-firmware-lan,v3.1.2,2023/07/25,null
appdynamics/orchestration-client,23.8.0-721,2023/08/24,0,9,5,0,0,14
grafana/mimirtool,2.10.4,2023/11/13,0,4,2,0,0,6
rancher/os-volumenetshare,v1.5.8,2021/02/05,2,17,37,4,0,60
balenalib/orbitty-tx2-golang,20231106,2023/11/07,440,96,56,6,0,598
balenalib/odroid-xu4-alpine-node,18.14.1-20231106,2023/11/07,0,7,3,0,0,10
rancher/mirrored-cilium-cilium-envoy,v1.26.6-ff0d5d3f77d610040e93c7c7a430d61a0c0b90c1,2023/10/29,19,10,0,0,0,29
rapidfort/rabbitmq,3.12.6,2023/10/17,52,16,11,3,0,82
balenalib/odroid-c1-ubuntu,20220714,2022/08/02,87,91,11,0,0,189
bitnami/cainjector,1.13.2,2023/12/06,77,16,7,2,0,102
puppet/puppet-agent-alpine,7.15.0,2022/03/23,2,8,6,0,0,16
newrelic/newrelic-istio-adapter,2.0.3,2020/08/24,2,15,19,1,0,37
balenalib/orangepi-plus2-debian-python,20230911,2023/09/11,121,46,42,6,0,215
grafana/loki-bigtable-backup,master-9930f704,2019/08/02,4,22,11,2,0,39
bitnami/redhatubi-base-buildpack,9-r4,2023/06/21,330,234,33,0,0,597
lacework/lacework-cli,v1.38.0,2023/11/09,0,4,3,0,0,7
rapidfort/redis-official,7.2.3-bookworm,2023/12/20,23,3,0,0,0,26
newrelic/k8s-nri-cassandra,2.2.0.1,2019/09/09,90,79,25,0,0,194
grafana/mimir,2.10.4,2023/11/13,0,4,2,0,0,6
redislabs/rejson,99.99.98,2023/10/09,73,23,17,2,0,115
rancher/goharbor-harbor-core,v1.7.5,2019/04/01,14,63,88,37,0,202
mirantis/dtr-jobrunner,3.0.0-alpha.2,2021/09/22,7,69,90,18,0,184
mirantis/ucp-proxy,1.1.6,2017/01/18,0,42,21,8,0,71
rancher/calico-ctl,v3.19.2,2021/08/03,0,7,9,2,0,18
rancher/git-serve,v0.7.0,2020/01/02,238,443,21,0,0,702
rapidfort/kong,3.0.0-ubuntu,2023/02/09,null
balenalib/odroid-xu4-openjdk,20230911,2023/09/11,132,73,46,6,0,257
ambassador/telepresence-docker-desktop-extension,0.0.8-alpha.2,2022/04/13,0,12,21,0,0,33
greenbone/cert-bund-data,202311150421,2023/11/15,null
docker/desktop-kubeconfig-merge,v1.1,2020/04/15,0,7,10,0,0,17
pachyderm/pachd-amd64,97276071e371d5b1ea221437e99cfd87b5599ddf,2023/11/03,0,8,4,0,0,12
airbyte/source-zendesk-chat,0.2.1,2023/10/20,65,28,7,1,0,101
couchbase/centos-69-sdk-build,20180806,2018/08/07,1622,2021,259,7,0,3909
balenalib/i386-nlp-alpine,20191223,2021/04/17,2,0,0,1,0,3
rancher/kubernetes-agent,v0.7.0,2017/09/28,312,392,24,0,0,728
pachyderm/bench,9485135059f9153350ad33a5928fe0b966502b8e,2017/04/27,65,106,17,0,0,188
airbyte/source-linkedin-ads,0.6.4,2023/10/19,65,28,7,1,0,101
balenalib/stem-x86-32-debian-python,20230904,2023/09/09,121,46,42,6,0,215
hashicorp/consul-k8s-control-plane-fips,1.3,2023/12/18,30,30,5,0,0,65
rancher/mirrored-banzaicloud-fluentd,v1.14.6-alpine-5,2022/05/25,4,42,34,6,0,86
docker/vpnkit-tap-vsockd,328ace386c62036c2a045744eeff20e46312d20a,2018/09/04,0,0,0,2,0,2
rancher/mirrored-neuvector-manager,5.2.3,2023/11/10,0,2,0,0,0,2
balenalib/apalis-imx6q-fedora,20220604,2022/06/12,null
balenalib/intel-nuc-python,20231106,2023/11/06,117,30,31,4,0,182
grafana/cortextool,v0.2.4,2020/08/12,3,21,20,0,0,44
balenalib/via-vab820-quad-debian-node,18.6-20220714,2022/07/21,127,79,77,18,0,301
bitnami/jwt-cli,6.0.0,2023/12/01,77,16,7,2,0,102
mongodb/mongo-cxx-driver,3.9.0-redhat-ubi-9.3,2023/12/05,20,16,0,0,0,36
rancher/mirrored-longhornio-livenessprobe,v2.9.0,2022/12/28,0,3,3,0,0,6
rancher/fleet-agent,v0.9.0,2023/11/07,2,22,23,0,6,53
intel/smart-city_solution,2021.4.2,2021/12/14,277,822,39,0,0,1138
docker/tilt,v0.33.6,2023/09/29,112,48,30,6,2,198
mattermost/mattermost-preview,9.1.1,2023/11/01,109,26,16,1,0,152
intel/dlstreamer,2023.0.0-ubuntu22-gpu682-dpcpp,2023/10/02,261,432,19,0,0,712
balenalib/apalis-imx6q-alpine-node,20220714,2022/07/19,7,44,34,10,0,95
balenalib/orbitty-tx2-alpine,20231106,2023/11/06,0,6,2,0,0,8
astronomerinc/ap-db-bootstrapper,0.31.7,2023/11/08,0,15,5,0,0,20
rancher/hardened-sriov-network-resources-injector,v1,2021/02/23,239,342,38,3,0,622
lacework/ghactions,6.0,2023/06/14,2,29,12,5,0,48
balenalib/odroid-xu4-node,20230911,2023/09/11,121,47,43,6,0,217
vmware/lightwave-base,1.0.0,2020/03/13,28,117,137,48,0,330
hashicorp/vault,1.15.2,2023/11/06,0,5,2,0,0,7
appdynamics/appd-oc-otel-collector,22.1.0,2022/01/31,0,5,9,0,0,14
objectscale/csi-baremetal-pre-upgrade-crds,1.4.0-124.541af8d,2023/11/03,97,20,26,3,0,146
redislabs/redis-connect-postgres,0.8.3-112,2022/03/04,5,30,41,13,0,89
mattermost/mattermod-jobserver,0.18.0,2023/10/11,29,40,8,0,0,77
vmware/photon-2.0-calico-kube-policy-controller,v1.0.0-20180619,2018/06/19,15,72,90,57,0,234
nginx/nginx-ingress-operator,2.0.2,2023/11/02,66,38,9,0,0,113
kasmweb/firefox,1.14.0,2023/09/14,215,469,0,0,0,684
opensearchproject/opensearch-benchmark,1.1.0,2023/08/10,470,161,102,11,2,746
grafana/openvas,20200716,2020/07/15,1054,1172,176,10,0,2412
airbyte/db,0.50.34,2023/11/09,0,2,2,0,0,4
bitnami/consul,1.17.0,2023/12/06,159,69,28,4,0,260
balenalib/revpi-core-3-golang,20230530,2023/06/27,382,68,50,8,0,508
newrelic/newrelic-prometheus-configurator,1.10.0,2023/11/13,0,6,2,0,0,8
balenalib/spacely-tx2-fedora,20231106,2023/11/06,null
balenalib/bananapi-m1-plus-openjdk,20230904,2023/09/09,132,73,46,6,0,257
docker/engine-community-arches,18.09.0-ce-tp6.test.x86_64,2018/09/05,null
balenalib/generic-aarch64-node,20231106,2023/11/07,117,31,32,4,0,184
bitnami/gitea,1.20.5,2023/11/17,103,30,31,5,0,169
hashicorp/vault-csi-provider,1.4.1,2023/10/26,0,3,2,0,0,5
rapidfort/haproxy-official,2.9-dev8-bullseye,2023/11/01,21,6,0,0,0,27
airbyte/destination-duckdb,0.3.0,2023/10/24,65,28,7,1,0,101
rancher/mirrored-library-registry,2.8.1,2023/05/10,0,10,2,3,0,15
cockroachdb/charts-builder,20200702-210440,2020/07/03,221,234,231,82,9,777
ubuntu/loki,2.8.4-22.04,2023/12/12,12,25,14,0,0,51
balenalib/artik10-alpine-node,20220803,2022/08/04,7,44,34,10,0,95
airbyte/source-exchangeratesapi-singer-abprotocol,0.1.2,2020/10/20,109,86,89,31,8,323
rancher/mirrored-sigwindowstools-k8s-gmsa-webhook,v0.3.0,2021/11/01,0,4,6,0,0,10
rancher/system-agent-installer-rancher,v2.8.0-rc3,2023/10/26,0,9,3,0,0,12
airbyte/destination-yugabytedb,0.1.1,2023/03/17,29,192,239,21,0,481
bitnami/grafana-tempo-vulture,2.3.0,2023/11/08,77,17,7,2,0,103
airbyte/source-firebase-realtime-database,0.1.0,2022/12/15,3,21,28,1,0,53
rancher/server,v2.0.0-beta4,2018/04/25,9,26,2,0,0,37
balenalib/zynq-xz702-node,18.6-20220714,2022/07/21,127,79,77,18,0,301
rancher/goharbor-nginx-photon,v1.7.5,2019/04/01,14,67,85,37,0,203
circleci/docker-coreos-toolbox-ubuntu,0.1,2019/10/25,133,136,6,0,0,275
bellsoft/liberica-openjdk-debian,21.0.1-12,2023/11/14,106,26,19,4,0,155
amazon/aws-sam-cli-emulation-image-python3.8,20220125,2022/01/25,3,50,17,0,0,70
mattermost/inbucket,release-1.2.0,2017/12/27,0,5,0,0,0,5
intel/its-query-rest,master-ae213cd97d6931b1d44fc7689867cf5701e0f15d,2023/09/24,66,39,24,14,0,143
apachepinot/trino,396-SNAPSHOT-amd64,2022/09/15,135,279,160,37,0,611
rancher/os-framework,55951fe-amd64,2021/10/09,18,179,159,7,9,372
accurics/terrascan_atlantis,1.14.0,2022/04/01,11,152,210,27,0,400
amazon/aws-lambda-dotnet,7.2023.11.12.09,2023/10/25,2,2,3,0,0,7
bitnami/kubeapps-kubeops-archived,2.5.1,2022/10/04,1,5,8,0,0,14
vmware/admiral,v1.5.2,2019/03/11,36,104,157,60,0,357
balenalib/nitrogen6x-alpine,20220714,2022/07/19,7,43,33,10,0,93
balenalib/ts4900-fedora-golang,20220507,2022/05/12,null
balenalib/ts4900-debian-openjdk,20210602,2021/06/05,222,249,144,39,9,663
airbyte/worker,0.50.34,2023/11/09,20,73,57,2,0,152
google/apigee-kube-rbac-proxy,v0.13.0,2022/09/20,0,4,10,1,0,15
intel/power-node-agent,v2.3.1,2023/08/28,0,3,2,0,0,5
airbyte/source-persistiq,0.2.0,2023/10/20,0,15,24,1,0,40
balenalib/hummingboard-ubuntu-python,20230904,2023/09/09,42,20,4,0,0,66
cockroachdb/cockroach,v23.1.12,2023/11/13,67,20,0,0,0,87
mirantis/k8s-externalipcontroller,tets,2019/01/04,0,10,2,0,0,12
balenalib/orbitty-tx2-ubuntu-python,20231103,2023/11/06,37,19,0,0,0,56
bitnami/trivy,0.47.0,2023/12/09,77,18,7,2,0,104
rancher/mesos-slave,0.28.1,2016/05/24,235,326,17,0,0,578
atlassian/bamboo-agent-base,9.4.1,2023/12/14,51,73,4,6,0,134
pachyderm/pachctl,2.8.0-rc.2,2023/11/13,92,27,32,2,1,154
balenalib/bananapi-m1-plus-fedora-openjdk,30-20210825,2021/09/03,null
onlyoffice/docspace-wait-bin-share,1.1.4.1,2023/10/23,null
bitnami/openresty,1.21.4-3,2023/12/02,111,36,23,4,0,174
redhat/ubi9-init,9.3-5,2023/11/01,128,42,2,0,0,172
airbyte/source-reply-io,0.1.0,2022/11/10,0,19,25,1,0,45
bitnami/cassandra-exporter,2.3.8,2023/12/17,79,28,17,2,0,126
rancher/cert-manager-acmesolver-arm64,v0.7.2-rio.1,2019/05/15,0,0,0,2,0,2
balenalib/generic-armv7ahf-debian-node,20230904,2023/09/09,121,47,43,6,0,217
objectscale/ese-callback,2.71.3,2021/04/14,2,18,22,0,0,42
balenalib/orangepi-plus2-ubuntu-node,20231026,2023/11/02,38,19,1,0,0,58
balenalib/parallella-alpine-python,20230904,2023/09/09,2,7,5,2,0,16
balenalib/spacely-tx2-debian-node,20231106,2023/11/07,117,31,32,4,0,184
intel/intel-ethernet-operator-labeler,v1.0.0,2023/07/26,4,16,4,0,0,24
docker/ucp-compose,3.3.1,2020/06/26,4,6,2,0,0,12
airbyte/destination-sqlite,0.1.0,2022/08/09,0,20,25,1,0,46
astronomerinc/ap-grafana,10.2.0,2023/10/31,0,10,5,0,0,15
balenalib/beaglebone-black-alpine-golang,20231106,2023/11/07,0,6,2,0,0,8
airbyte/destination-jdbc,0.3.14,2022/06/17,81,107,149,61,0,398
balenalib/colibri-imx6dl-python,20220604,2022/06/12,127,90,78,20,0,315
lacework/lacework-docker-extension,0.1.18,2022/07/14,0,23,31,1,0,55
pachyderm/ci_code_bundle,23875,2021/06/03,6,0,0,0,0,6
onlyoffice/docspace-backup,1.1.4.1,2023/10/23,1024,157,214,13,0,1408
kasmweb/teams,1.12.0,2022/12/01,380,1072,2,0,0,1454
ddosify/selfhosted_hammer,1.4.2,2023/07/18,0,16,9,1,0,26
balenalib/spacely-tx2-debian-python,20231106,2023/11/07,117,30,31,4,0,182
hashicorp/terraform-cloud-operator,2.0,2023/11/06,null
rancher/tekton-utils,v0.17-a3,2022/08/12,6,67,50,3,15,141
rancher/mirrored-k8scsi-csi-node-driver-registrar,v2.1.0,2020/12/18,0,5,9,0,5,19
balenalib/i386-ubuntu-openjdk,11-xenial-20230911,2023/09/11,null
objectscale/kube-metrics-adapter,3.7.0.0-1186.91aed4d8,2021/04/25,3,59,63,6,2,133
bitnami/python,3.12.0,2023/12/04,429,93,49,6,0,577
onlyoffice/mailserver,1.6.75,2020/08/04,2184,3487,151,8,0,5830
docker/cluster,v1.3.0,2020/04/20,10,38,36,2,0,86
bitnami/php-fpm,8.2.12,2023/11/15,155,91,59,5,0,310
bitnami/argo-workflow-controller,3.5.1,2023/11/08,0,3,0,0,0,3
atlassian/clientside-extensions,v0.4,2020/09/30,308,761,62,4,0,1135
balenalib/beaglebone-green-wifi-golang,20230911,2023/09/12,446,124,78,10,0,658
okteto/udemy,vote,2019/09/17,5,22,17,1,0,45
airbyte/source-gainsight-px,0.1.0,2023/07/13,0,17,25,1,0,43
redis/redis-stack,7.2.0-RC3,2023/07/10,27,27,2,0,0,56
intel/oact-rpc,v2.0.0,2021/09/15,74,66,4,0,0,144
rancher/goharbor-harbor-db,v1.7.5,2019/04/01,15,82,131,39,0,267
rancher/haproxy-cadvisor,v0.0.1,2016/06/11,0,27,24,10,0,61
rancher/cis-operator,v1.0.12,2023/06/08,0,7,5,0,1,13
grafana/grafana-ci-windows-test,0.1.0,2023/04/13,null
docker/ucp-auth-store-s390x,3.1.0-beta3,2018/10/04,0,0,4,8,0,12
amazon/aws-iot-greengrass,2.5.3-0-deprecated,2022/01/13,24,233,241,16,0,514
rancher/fluentd-helper,v0.1.2,2018/04/10,43,85,10,0,0,138
vmware/clair-photon,v2.0.1,2017/10/30,10,75,106,67,0,258
balenalib/beaglebone-green,20230911,2023/09/11,121,45,42,6,0,214
google/apigee-diagnostics-collector,1.8.1,2022/09/20,7,24,19,3,5,58
airbyte/source-younium,0.3.0,2023/10/25,66,30,7,1,0,104
kasmweb/core-centos-7,1.14.0,2023/09/09,1362,1328,62,0,0,2752
intel/oact-mpsrouter,v2.3.0,2023/09/20,null
grafana/devtools-github-event-aggregator,4160534dbc93f1bec6669c5a97edbbbf83cc3c52,2019/04/03,55,35,67,15,10,182
airbyte/airbyte-base-java-python-image,1.0,2023/06/22,23,75,107,2,0,207
portainer/compose-unpacker,latest-windows-amd64,2023/08/31,0,16,15,0,0,31
docker/dtr-notary-server-s390x,2.5.0-beta3,2018/01/17,0,16,41,34,0,91
intel/intel-gpu-initcontainer,0.28.0,2023/09/22,null
airbyte/integration-singer-stripe-source,0.1.2,2020/10/07,10,39,63,13,0,125
balenalib/aarch64-node,20231106,2023/11/07,110,31,23,4,0,168
grafana/netlify-cms-oauth-provider-go,51188a4,2019/06/21,4,14,9,3,0,30
airbyte/destination-milvus,0.0.9,2023/11/13,65,29,10,4,0,108
continuumio/ci-image,v27,2019/09/12,1224,1843,423,19,1,3510
vmware/nginx,1.11.5-patched,2017/04/07,55,157,175,66,22,475
bitnami/harbor-notary-server-archived,2.8.4,2023/09/15,86,196,228,2,0,512
balenalib/beaglebone-green-alpine-python,20231106,2023/11/07,0,7,2,0,0,9
bitnami/oauth2-proxy,7.5.1,2023/12/07,77,21,9,2,0,109
balenalib/i386-nlp-debian,20210225,2021/04/19,192,128,142,43,10,515
redislabs/cloud-api-build,1.0.0,2020/01/05,256,1614,39,8,0,1917
airbyte/source-asana,0.6.1,2023/11/13,65,13,3,1,0,82
google/apigee-prom-prometheus,v2.33.5,2022/03/08,4,30,18,0,0,52
mongodb/atlas,v1.31.0,2023/08/14,84,56,10,0,0,150
balenalib/orangepi-plus2-debian-golang,20230911,2023/09/11,446,124,78,10,0,658
accurics/siac-auth,1.3.14,2021/05/07,2,17,40,4,0,63
balenalib/artik530,20220714,2022/07/22,127,77,76,18,0,298
balenalib/asus-tinker-board-s-alpine-golang,20231106,2023/11/07,0,6,2,0,0,8
airbyte/keycloak-setup,0.50.34,2023/11/09,20,71,58,2,0,151
balenalib/beaglebone-green-golang,20230911,2023/09/11,446,124,78,10,0,658
mattermost/mattermost-app-chaosengine,150a153,2022/01/14,0,23,42,1,0,66
rancher/eks-controller,v0.1.0-rc14,2020/07/16,257,418,29,3,0,707
portainer/agent,2102,2018/07/31,null
rancher/mirrored-longhornio-csi-attacher,v4.2.0,2023/02/01,0,3,3,0,0,6
rapidfort/consul,1.16.2,2023/10/24,43,11,3,0,0,57
vmware/photon-2.0-nginx-ingress,v1.1.1-20180619,2018/06/19,15,78,98,58,0,249
bellsoft/buildpacks.maven,6.13.0,1980/01/01,null
rancher/secrets-bridge-v2,v0.3.2,2018/03/09,63,91,12,0,0,166
airbyte/source-intercom,0.3.1,2023/10/15,65,28,7,1,0,101
newrelic/test-oracle-db,11.2.0.2-xe,2020/08/31,6,131,30,3,0,170
balenalib/generic-aarch64-ubuntu,20231103,2023/11/06,37,18,0,0,0,55
bitnami/harbor-registry,2.9.1,2023/12/06,77,16,7,2,0,102
balenalib/artik5-alpine,20220803,2022/08/03,7,43,33,10,0,93
balenalib/aarch64-fedora-golang,20231106,2023/11/06,null
okteto/payroll,0.1,2019/06/06,47,99,153,50,10,359
sysdig/onprem_migration,events,2017/03/03,103,318,365,181,30,997
rancher/configmap-reload,v0.3.0-rancher4-windows-2004,2021/01/28,null
objectscale/blob-service,0.71.3,2021/04/15,16,142,200,36,3,397
bitnami/ghost,5.73.2,2023/11/17,94,64,36,8,0,202
hashicorp/vagrant-website,714860103532a0bc72678aafdc6e9769dede77c2ceeb76bcc8a6fa601e69e562,2020/10/08,11,86,117,24,0,238
accurics/cli-kubescan,1.0.41,2022/09/26,0,31,28,1,0,60
mirantis/dtr-content-cache,3.0.0-alpha.2,2021/09/22,1,11,36,3,0,51
rancher/mirrored-sonobuoy-sonobuoy,v0.57.0,2023/10/19,null
amazon/aws-secrets-manager-secret-sidecar,v0.1.4,2021/03/08,18,241,194,23,0,476
datadog/agent-buildimages-windows_20h2_x64,v3686353-1e75137,2021/01/12,8,50,134,12,0,204
balenalib/orangepi-plus2-fedora-openjdk,30-20210825,2021/09/03,null
hashicorp/consul-website,76497883ab408fa8fde43d9c554e73565874a46feb4549fc6ea97b2b20b204b7,2021/01/14,12,77,105,18,0,212
mirantis/ucp-auth,3.7.1,2023/09/07,3,9,8,2,0,22
bitnami/ubuntu-base-buildpack,22-r1,2022/09/07,304,579,73,0,0,956
airbyte/source-intercom-singer,0.2.3,2021/07/03,559,326,284,40,8,1217
rancher/opni-monitoring-ui-build,80424898df491ba46d6ace27167fd1d333577167,2023/04/26,null
balenalib/i386-alpine-node,16.19.1-20230911,2023/09/11,2,7,6,2,0,17
balenalib/beaglebone-black-ubuntu-python,20230911,2023/09/12,42,20,4,0,0,66
redislabs/redisearch,2.10.0,2023/09/11,73,25,17,2,0,117
rancher/hardened-cilium-bpftool,4c18d06f1d545ed6fde810c2b97935dc8938ddc8-build20210521,2021/05/21,76,71,3,0,0,150
balenalib/beaglebone-black-alpine-python,20231106,2023/11/07,0,7,2,0,0,9
airbyte/source-file,0.3.15,2023/10/19,146,33,21,3,2,205
docker/ucp-secureoverlay-mgr,3.3.1,2020/06/26,2,8,9,1,0,20
onlyoffice/4testing-docspace-clear-events,2.0.0.33,2023/11/24,1024,156,211,13,0,1404
okteto/babel-maquetacion,0.1,2020/02/03,508,2250,1365,328,72,4523
rancher/k3s-upgrade,v1.28.3-k3s2-s390x,2023/11/08,0,16,4,0,0,20
rancher/banzaicloud-fluentd,v1.11.5-alpine-9,2021/01/19,12,46,107,15,0,180
docker/ucp-calico-node-s390x,3.1.0-beta3,2018/10/04,0,6,6,2,0,14
grafana/fluent-bit-plugin-loki,2.9.2,2023/10/25,27,32,21,2,0,82
okteto/remote-ssh,dev,2019/09/12,694,1020,73,0,0,1787
balena/amd64-supervisor,1299,2020/07/31,6,26,55,9,0,96
airbyte/source-primetric,0.1.0,2022/09/21,0,17,17,0,0,34
mattermost/perseus,v0.0.2,2023/01/12,0,1,1,0,0,2
balenalib/ts4900-debian,20220714,2022/07/20,127,77,76,18,0,298
balenalib/ts4900-ubuntu-openjdk,20210826,2021/09/04,136,435,10,0,0,581
kasmweb/ubuntu-jammy-dind-rootless,1.14.0,2023/09/14,308,482,44,0,0,834
balenalib/odroid-c1-alpine-node,20220714,2022/07/19,7,44,34,10,0,95
pachyderm/mnist_standalone,v1.0.0,2020/04/08,1484,1803,1435,185,40,4947
rancher/k8s-dns-node-cache,1.15.13,2020/05/09,83,42,46,17,2,190
mariadb/xpand-single,23.09.1,2023/09/18,558,520,32,3,0,1113
bitnami/grafana-mimir,2.10.3,2023/11/08,77,20,9,2,0,108
rancher/prom-node-exporter,v1.0.1,2020/06/16,0,6,10,0,0,16
hashicorp/packer-website,4620289a4b88df2b745e524720bb3a372978056f2f4ece0ec0bd790747fa42c1,2020/09/04,11,93,125,24,0,253
bitnami/keycloak,22.0.5,2023/12/07,94,29,17,4,0,144
balenalib/parallella-ubuntu-node,20230904,2023/09/09,43,20,5,0,0,68
airbyte/source-marketo-singer,0.2.3,2021/07/06,559,327,283,40,8,1217
balenalib/odroid-xu4-debian-node,20230911,2023/09/11,121,47,43,6,0,217
portainer/helper-reset-password,windowsltsc2022-amd64,2023/05/17,0,5,3,0,0,8
bitnami/node-exporter,1.7.0,2023/12/06,77,17,7,2,0,103
balenalib/spacely-tx2-ubuntu-golang,20231103,2023/11/06,141,137,1,0,0,279
mattermost/mattermost-build-server,5.6.0,2018/11/29,223,548,585,150,18,1524
mattermost/mm-mlh-hacktoberfest,0.0.1,2020/09/15,2,19,41,4,0,66
balenalib/qemux86-64-fedora-golang,20231103,2023/11/04,null
rapidfort/nats-official,2.9.22,2023/09/13,0,1,1,0,0,2
airbyte/source-ip2whois,0.1.0,2022/11/09,0,19,25,1,0,45
balenalib/colibri-imx6dl-debian-openjdk,20210602,2021/06/05,222,249,144,39,9,663
rancher/k3c-data,v0.0.1,2020/01/11,null
kasmweb/core-ubuntu-jammy,1.14.0,2023/09/09,187,286,12,0,0,485
grafana/cortex-configs,w37-0193e7b7,2018/09/11,0,0,0,2,0,2
cockroachdb/acceptance-gss-kdc,20230419-131103,2023/04/19,null
balenalib/parallella-ubuntu-openjdk,11-xenial-20230904,2023/09/09,null
balenalib/artik710-alpine-golang,3.16-20230904,2023/09/09,2,6,3,2,0,13
cimg/redis,7.2.3,2023/11/02,328,370,47,0,0,745
rancher/backup-restore-operator,v4.0.0,2023/10/30,0,6,4,1,0,11
bitnami/kubernetes-event-exporter,1.5.0,2023/11/18,77,18,8,2,0,105
mirantis/ucp-openstack-cinder-csi-plugin,3.5.3,2021/04/08,131,113,121,38,3,406
docker/dev-environments-ruby,5741e9ade3b31784a7a35d5a81f19d30e8f63c5e,2021/08/10,1130,752,867,90,29,2868
balenalib/artik5-alpine-openjdk,8-jre-20220803,2022/08/04,31,90,43,10,0,174
purestorage/ccm-service,3.2.13,2022/08/09,17,59,28,1,0,105
dynatrace/easytravel-mongodb,7.1,2018/05/11,0,2,2,3,0,7
continuumio/anaconda-pkg-build,2023.03.28,2023/03/28,579,577,43,3,0,1202
docker/ucp-kube-dns,3.2.7,2020/06/26,0,0,0,2,0,2
solaceiotteam/async-apim-server,0.4.1,2022/09/29,0,13,24,2,0,39
objectscale/decks-support-store,2.71.3,2021/04/14,6,71,77,3,6,163
balenalib/nitrogen6x-alpine-openjdk,8-3.14-20220112,2022/01/19,2,50,42,13,0,107
mirantis/ucp-cfssl,3.7.1,2023/09/26,2,9,6,2,0,19
balenalib/stem-x86-32-ubuntu-openjdk,11-xenial-20230904,2023/09/09,null
rancher/bad-ingress-scanner,319,2023/11/15,19,8,0,0,0,27
astronomerinc/ap-nats-streaming,0.25.5-1,2023/11/08,0,5,2,0,0,7
pachyderm/label-studio-ci-testing,92081111f606b30014cf163da9d26f19513dd987,2023/09/22,223,338,24,0,0,585
airbyte/source-db2,0.1.20,2023/06/20,25,172,191,6,0,394
docker/ucp-compose-s390x,3.1.0-beta3,2018/10/04,131,358,15,4,0,508
rancher/jetstack-cert-manager-controller,v0.8.1,2019/06/18,0,0,0,2,0,2
opensearchproject/opensearch-maps-server,1.0.0,2022/10/20,23,142,180,4,0,349
mariadb/maxscale,23.08.3,2023/11/07,1,0,0,0,0,1
okteto/python,3,2023/08/24,513,315,105,10,2,945
balenalib/orbitty-tx2-fedora-openjdk,8-20231106,2023/11/06,null
circleci/docker-gc,2.0.1254-7001717,2023/07/17,0,4,1,0,0,5
bellsoft/buildpacks.environment-variables,4.5.0,1980/01/01,null
intel/esp-uos-dyninit,v3.1.2,2023/08/16,2,9,7,2,0,20
balenalib/hummingboard-alpine-golang,20230904,2023/09/09,2,6,5,2,0,15
onlyoffice/4testing-ds-proxy,6.0.0,2020/10/21,621,686,43,3,0,1353
airbyte/source-chargify,0.4.0,2023/10/16,0,16,24,1,0,41
google/apigee-operators,1.8.1,2022/09/22,0,5,5,1,0,11
rancher/healthcheck,v0.3.8,2018/07/09,342,450,26,0,0,818
couchbase/sandbox,5.0.0-beta,2017/05/20,97,86,8,0,0,191
objectscale/space-reclaimer,0.71.3,2021/04/15,17,149,226,36,6,434
balenalib/artik5-alpine-golang,20220803,2022/08/04,8,45,38,12,0,103
pachyderm/datascience-notebook,fde4beb9ff1afb404f0e34828adc1f311f4bf2d7,2021/10/20,115,181,41,5,0,342
greenbone/greenbone-feed-sync,v23.10.0,2023/10/23,71,20,12,1,0,104
balenalib/nitrogen6x-debian-node,18.6-20220714,2022/07/21,127,79,77,18,0,301
opensearchproject/data-prepper,2.5.0,2023/10/11,69,81,12,1,0,163
balenalib/artik533s-fedora-golang,20220714,2022/07/23,null
onlyoffice/4testing-documentserver-ee-cl,6.4.2,2022/01/06,425,1342,66,0,0,1833
onlyoffice/docspace-doceditor,1.1.4.1,2023/10/23,1011,165,219,13,0,1408
grafana/ci-build-windows,0.3.4,2022/04/19,8,27,22,2,0,59
balenalib/artik10-golang,20220714,2022/07/22,471,278,225,29,1,1004
atlassian/docker-release-maker,test3,2022/03/09,7,60,65,16,0,148
grafana/jsonnet-build,1022b37,2020/03/18,0,0,0,2,0,2
percona/percona-server,8.0.34-26,2023/09/15,11,27,22,0,0,60
hashicorp/terraform-website,98965949466ebb9ac066eb14bf3118ca3230ec9e,2022/09/07,7,139,98,27,0,271
balenalib/artik710-fedora-node,20230712,2023/07/16,0,1,1,0,0,2
bitnami/kubeapps-tiller-proxy-archived,1.11.3,2020/10/21,9,29,18,1,0,57
mattermost/mm-te,97363046,2023/04/04,224,216,118,19,7,584
airbyte/destination-exasol,0.1.1,2023/02/22,29,192,239,21,0,481
bitnami/contour,1.26.1,2023/12/06,77,16,8,2,0,103
datadog/k8s-dns-exposer-controller,v0.0.1,2019/08/02,280,448,25,3,0,756
appdynamics/appdynamics-agent-config-client,23.10.0-1190,2023/10/27,0,2,2,0,0,4
tenable/terrascan_atlantis,1.18.3,2023/08/03,11,152,210,27,0,400
rancher/rancher,v2.8.0-rc3,2023/10/26,2,85,79,1,4,171
balenalib/orangepi-plus2-alpine-node,18.14.1-20231106,2023/11/07,0,7,3,0,0,10
airbyte/source-flexport,0.2.0,2023/08/23,0,17,24,1,0,42
okteto/outyet,0.0.5,2019/02/12,192,419,432,74,12,1129
nginx/docker-extension,0.0.3,2023/04/17,0,12,2,0,0,14
mariadb/columnstore,23.02.4,2023/08/03,4,26,42,0,0,72
vertica/verticadb-operator,1.11.2,2023/08/02,0,4,2,0,0,6
docker/ucp-kube-compose-api-s390x,3.1.0-beta3,2018/10/04,0,0,0,2,0,2
redislabs/fake-kubelet,arm-latest,2021/11/04,2,38,52,5,0,97
bitnami/deepspeed,0.12.3,2023/12/02,445,87,48,6,6,592
balenalib/armv7hf-debian-python,20230929,2023/10/02,114,46,34,6,0,200
launchdarkly/ld-find-code-refs,2.11.4,2023/10/16,0,5,2,0,0,7
balenalib/stem-x86-32-debian,20230904,2023/09/09,121,45,42,6,0,214
intel/esp-squid,v3.1.2,2023/07/25,null
bitnami/promtail,2.9.2,2023/12/06,77,19,8,2,0,106
onlyoffice/docs-docservice-de,7.5.1-1,2023/11/09,16,3,1,1,0,21
airbyte/source-quickbooks-singer,0.1.5,2022/02/17,0,22,51,8,0,81
balenalib/raspberry-pi2-alpine-golang,20231106,2023/11/07,0,6,2,0,0,8
balenalib/rpi-debian,20231106,2023/11/07,110,43,30,4,0,187
docker/ucp-etcd,3.3.1,2020/06/26,2,28,41,1,0,72
adobecoldfusion/apimanageraddons2021,2021.0.0,2021/09/16,106,176,8,3,0,293
balenalib/qemux86-64-openjdk,20231106,2023/11/06,128,52,33,4,0,217
balena/amd64-supervisor-node,1244-update-lock-weirdness,2020/03/31,716,621,604,77,10,2028
balenalib/generic-armv7ahf-golang,20230904,2023/09/09,446,124,78,10,0,658
mirantis/cnigenie,v1.0-124-ge4298f1,2018/05/28,null
airbyte/source-the-guardian-api,0.1.0,2022/11/09,0,19,25,1,0,45
mattermost/ops-tool,v0.0.3,2022/08/19,92,75,50,12,0,229
datadog/agent-dev-arm64,6.15.1,2019/11/26,96,71,85,20,7,279
balenalib/beaglebone-green-python,20230911,2023/09/11,121,46,42,6,0,215
rancher/cert-manager-webhook-arm64,v0.7.2-rio.1,2019/05/15,0,0,0,2,0,2
ubuntu/bind9,9.18-23.10_edge,2023/12/11,10,1,0,0,0,11
airbyte/source-faker,5.0.0,2023/08/09,0,17,24,1,0,42
mattermost/mattermost-cloud,9839667,2022/12/09,7,48,47,5,0,107
mattermost/calls-recorder,v0.5.3,2023/11/13,0,3,1,0,0,4
purestorage/pso-smartagent,v0.1.0,2020/12/02,10,24,48,6,0,88
balenalib/orangepi-plus2-openjdk,20230911,2023/09/11,132,73,46,6,0,257
google/apigee-istio-proxyv2,1.4.6,2020/02/22,648,1307,149,1,0,2105
intel/video-analytics-serving,0.7.0,2021/12/07,434,1417,66,0,0,1917
rancher/longhornio-csi-provisioner,v2.1.2,2021/04/13,0,6,13,0,5,24
bitnami/keycloak-gatekeeper-archived,10.0.0,2021/04/19,0,10,19,0,0,29
accurics/terrascan-action,1.4.1,2021/10/27,2,42,69,15,0,128
rancher/mirrored-openzipkin-zipkin,2.14.2,2019/06/15,5,43,84,31,6,169
objectscale/storageserver-manager,0.71.3,2021/04/15,14,96,126,14,6,256
couchbase/exporter,1.0.9,2023/01/27,0,1,0,0,0,1
bitnami/airflow,2.7.3,2023/12/14,230,101,51,5,0,387
kasmweb/forward-proxy,1.0.0,2023/08/08,2,7,6,2,0,17
redislabs/pcf-redis-enterprise-tester,100.0.999000971,2023/05/17,647,992,83,4,0,1726
rancher/os-debianconsole,v1.5.8,2021/02/05,60,70,226,12,8,376
balenalib/apalis-imx6q-fedora-golang,20220507,2022/05/12,null
airbyte/integration-singer-bigquery-destination,0.1.4,2020/10/07,18,64,85,16,0,183
solaceiotteam/apim-analytics-server,0.2.0,2022/06/02,2,29,30,5,0,66
rancher/external-lb,v0.3.7,2019/01/30,0,10,2,0,0,12
rancher/goharbor-clair-photon,v2.0.8-v1.7.5,2019/04/01,14,94,137,55,0,300
docker/ucp-auth-store,3.3.1,2020/06/26,2,8,7,1,0,18
rancher/webhookinator,v0.1.0,2019/05/15,4,14,6,2,0,26
balenalib/am571x-evm-openjdk,20210602,2021/06/05,222,249,144,39,9,663
jetbrains/upsource-psi,2017.1.1867,2017/04/05,106,392,512,228,30,1268
intel/inference-optimization,2023.2-py3.10,2023/09/20,158,189,24,2,0,373
puppet/puppet-agent,7.20.0,2022/12/02,30,26,2,0,0,58
balenalib/i386-nlp-openjdk,20210225,2021/04/19,235,257,157,48,11,708
balenalib/i386-ubuntu,20210705,2021/07/21,108,178,10,0,0,296
kong/blog,mockbin-traffic-mirror-v2,2022/11/11,2,19,23,4,0,48
balenalib/armv7hf-ubuntu-golang,20231026,2023/11/02,135,137,1,0,0,273
balenalib/armv7hf-ubuntu-node,20231026,2023/11/02,35,16,1,0,0,52
objectscale/objectscale-inventory,1.4.0-397.adb0726,2023/11/13,0,5,4,0,0,9
kasmweb/insomnia,1.14.0,2023/09/14,189,286,12,0,0,487
rancher/mirrored-longhornio-csi-resizer,v1.7.0,2022/12/28,0,3,3,0,0,6
rancher/mirrored-cloud-provider-vsphere-cpi-release-manager,v1.28.0,2023/08/25,0,3,4,0,0,7
balenalib/odroid-xu4-ubuntu-openjdk,11-xenial-20231026,2023/11/02,null
grafana/tanka,0.26,2023/08/08,1,16,9,1,0,27
airbyte/source-linnworks,0.1.5,2021/12/24,0,21,50,8,0,79
docker/for-desktop-kernel,41ab3c5d630f455776be4b7bbe57dcb796b5b0a2-amd64,2020/02/12,null
mirantis/kubeadm-dind-cluster,v1.12,2018/12/10,269,646,710,109,23,1757
balenalib/asus-tinker-board-s-alpine-openjdk,8-20231106,2023/11/07,0,6,2,0,0,8
balenalib/armv7hf-ubuntu,20231026,2023/11/02,34,15,0,0,0,49
onlyoffice/4testing-docspace-files,2.0.0.33,2023/11/24,1024,156,211,13,0,1404
balenalib/apalis-imx6q-fedora-node,36-build-20220714,2022/07/22,0,1,1,0,0,2
balenalib/artik530-alpine-golang,20220803,2022/08/04,8,45,38,12,0,103
accurics/siac-comms,1.3.14,2021/05/07,2,10,32,4,0,48
balenalib/beaglebone-black-alpine-node,18.14.1-20231106,2023/11/07,0,7,3,0,0,10
docker/ucp-dsinfo,3.3.1,2020/06/26,4,6,2,0,0,12
okteto/telemetry,1.5.45,2020/03/03,3,19,42,4,0,68
bitnami/mlflow,2.8.0,2023/11/15,100,22,36,13,0,171
bitnami/bitnami-shell-archived,11,2023/07/15,89,35,24,6,0,154
okteto/golang-ci,2.3.3,2023/10/26,488,221,156,15,2,882
mattermost/bifrost,5204093,2023/08/30,0,8,1,0,0,9
intel/ai-workflows,1.0-vision-tlt-disease-prediction,2023/07/11,26,48,7,2,0,83
balenalib/qemux86-64-alpine-python,20231106,2023/11/07,0,7,2,0,0,9
okteto/custom-error-pages,0.2.0,2020/02/08,2,10,29,4,0,45
objectscale/objectstore-post-upgrade,0.78.0-59.f3aae99,2021/07/20,2,17,21,0,0,40
intel/qat-crypto-base,v.0.1.0,2023/01/06,null
vmware/nsx-container-plugin-operator,v4.1.2,2023/11/28,154,36,2,0,0,192
grafana/grafana-dev,10.3.0-146415,2023/11/15,0,8,2,0,0,10
grafana/devtools-github-archive-parser,4160534dbc93f1bec6669c5a97edbbbf83cc3c52,2019/03/31,55,35,67,15,10,182
airbyte/source-adjust,0.1.0,2022/09/21,0,19,25,1,0,45
couchbase/couchbase-training,1.6,2022/08/04,49,34,2,0,0,85
balenalib/stem-x86-32,20230904,2023/09/09,121,45,42,6,0,214
balenalib/orbitty-tx2-fedora-golang,20231106,2023/11/06,null
objectscale/dks-testapp,2.71.3,2021/04/14,4,55,73,3,3,138
mattermost/mattermost-build-docker,20201023_19.03.12,2020/10/23,14,53,150,16,0,233
cockroachdb/cockroach-premier,v1.1.4-early,2017/12/12,42,55,67,11,19,194
rancher/mirrored-paketobuildpacks-builder,0.2.443-full,1980/01/01,0,266,98,0,0,364
balenalib/odroid-c1-fedora-openjdk,30-20210825,2021/09/03,null
balenalib/artik10-debian-golang,20220714,2022/07/22,471,278,225,29,1,1004
intel/pmem-csi-driver-test,v1.1.0,2022/12/19,89,40,48,3,4,184
pachyderm/object-detection,fix4,2017/09/07,581,968,203,17,0,1769
bitnami/kubectl,1.28.3,2023/11/08,97,19,25,3,0,144
pachyderm/grpc-proxy,0.4.10,2019/10/04,536,1453,1163,241,14,3407
airbyte/source-lever-hiring,0.2.0,2023/05/29,0,17,25,1,0,43
intel/intel-ethernet-operator-bundle,v1.0.0,2023/07/26,null
astronomerinc/ap-fluentd,1.16.2-2,2023/11/08,12,6,0,0,0,18
balenalib/i386-debian-python,20231106,2023/11/06,110,30,22,4,0,166
rancher/longhorn-engine,6482810,2019/03/20,138,262,18,0,0,418
balenalib/artik533s-alpine,20220803,2022/08/03,7,43,33,10,0,93
airbyte/source-coingecko-coins,0.1.0,2022/11/18,0,19,25,1,0,45
couchbase/qe-mobile-greenboard,cbl_dev,2020/12/09,3,43,46,11,0,103
balenalib/via-vab820-quad-debian-openjdk,20210602,2021/06/05,222,249,144,39,9,663
intel/intel-optimized-tensorflow-avx512,2.11.0,2023/01/19,66,78,10,0,0,154
datadog/dd-apm-demo,ruby-2.7,2021/01/07,1796,1485,1360,162,46,4849
appdynamics/java-agent,23.10.0.35234,2023/10/30,0,2,2,0,0,4
bitnami/mediawiki,1.40.1,2023/12/02,152,85,56,4,0,297
rancher/cert-manager-cainjector,v0.11.0-rio.1,2019/10/22,0,0,0,0,6,6
onlyoffice/4testing-docspace-wait-bin-share,2.0.0.33,2023/11/24,null
datadog/agent-buildimages-suse_x64,v20433308-6861270,2023/09/25,3,25,21,1,0,50
balenalib/beaglebone-green-ubuntu-openjdk,11-xenial-20230911,2023/09/12,null
balenalib/artik10-fedora-node,36-build-20220803,2022/08/04,0,1,1,0,0,2
portainer/portainer-k8s-beta,linux-arm,2020/06/18,5,22,20,0,0,47
circleci/cci-demo-rails,711886c622bcf505c20c7f4148f4e5108297eb74,2016/12/21,504,2530,1614,395,72,5115
kasmweb/chrome,1.14.0,2023/09/14,217,442,0,0,0,659
mirantis/ucp-csi-provisioner,3.5.3,2022/04/05,0,0,0,0,6,6
bitnami/metrics-server,0.6.4,2023/12/07,77,20,11,2,0,110
rapidfort/postgresql,16.0,2023/11/09,34,12,3,1,0,50
airbyte/source-zendesk-sell,0.2.0,2023/10/24,0,15,24,1,0,40
pachyderm/postgresql,13.3.0,2022/02/11,180,115,106,32,7,440
ambassador/telepresence-docker-desktop-runtime,0.0.8-alpha.2,2022/04/13,16,102,76,10,0,204
balenalib/qemux86-64-golang,20231103,2023/11/05,440,97,56,6,0,599
mathworks/polyspace-deps,R2023b-ubuntu22.04,2023/12/18,29,5,0,0,0,34
balenalib/beaglebone-black-debian,20230911,2023/09/11,121,45,42,6,0,214
intel/power-operator_ocp-4.13,v2.3.1,2023/08/29,27,37,8,0,0,72
bitnami/google-cloud-sdk,0.455.0,2023/11/23,80,18,9,2,0,109
balenalib/apalis-imx6q-ubuntu,20220714,2022/08/02,87,91,11,0,0,189
airbyte/source-public-apis,0.2.0,2023/08/29,0,17,24,1,0,42
onlyoffice/docspace-clear-events,1.1.4.1,2023/10/23,1024,157,214,13,0,1408
intel/ai-tools,tlt-0.5.0,2023/07/06,26,48,6,2,0,82
mongodb/mongodb-atlas-search,preview-20231024T105931Z,2023/10/24,23,165,286,16,0,490
apachepinot/eks-nvme-ssd-provisioner,v1.0.1,2023/02/01,0,4,11,0,0,15
objectscale/objectscale-manager-pre-update-debug,0.61.0-7.da2bf03,2020/12/15,0,7,10,0,0,17
rancher/rio,v0.0.4-r6,2019/02/21,0,0,0,2,0,2
atlassian/pipelines-kubernetes-namespace-expiry,stg-stable,2019/11/07,111,135,137,38,9,430
balenalib/colibri-imx6dl-alpine-openjdk,8-3.14-20220112,2022/01/19,2,50,42,13,0,107
balenalib/fincm3,20230904,2023/09/09,121,45,42,6,0,214
bitnami/fluentd-exporter-archived,0.2.0,2022/06/19,97,71,56,18,0,242
airbyte/source-pardot,0.1.1,2022/12/15,0,18,25,1,0,44
bitnami/codeigniter,4.4.3,2023/12/02,157,90,58,5,0,310
jetbrains/upsource-proxy,2020.1.1992,2022/03/11,140,492,423,84,56,1195
balenalib/parallella-alpine,20230904,2023/09/09,2,6,5,2,0,15
mattermost/testwick,test2,2022/10/14,1,22,16,1,0,40
airbyte/source-rocket-chat,0.1.0,2022/11/13,0,19,25,1,0,45
grafana/grafana-oss,10.2.1,2023/11/14,0,8,3,0,0,11
vmware/photon-2.0-calico-node,v2.6.7-20180619,2018/06/19,17,87,106,59,0,269
vmware/dch-photon,18.06,2021/10/18,7,35,50,24,0,116
okteto/docker-desktop-extension,0.3.3,2022/11/09,80,93,87,6,0,266
greenbone/gsad,22.8,2023/11/14,97,23,16,2,0,138
kasmweb/kasm-guac,1.14.0,2023/08/19,127,233,19,1,0,380
couchbase/server,7.2.3,2023/11/09,21,6,0,0,0,27
docker/tilt-ctlptl,v0.8.22,2023/09/01,87,36,12,3,0,138
balenalib/bananapi-m1-plus-ubuntu-python,20231026,2023/11/02,37,19,0,0,0,56
docker/ucp-interlock-extension,3.3.1,2020/06/26,2,14,19,1,0,36
intel/intel-ethernet-operator-manager,v1.0.0,2023/07/26,4,18,5,0,0,27
bitnami/flink,1.18.0,2023/12/02,87,26,14,4,0,131
rancher/opni-payload-receiver-service,v0.5.4,2022/07/26,8,74,76,4,14,176
airbyte/source-ashby,0.1.0,2022/10/28,0,19,25,1,0,45
okteto/agent,1.0,2018/07/04,0,1,4,3,0,8
intel/intel-optimized-nginx,qatsw-src,2023/03/22,78,124,5,0,0,207
airbyte/source-azure-table,0.1.3,2022/10/18,0,19,25,1,0,45
appdynamics/dynamic-agent-ma,20.5.1.1,2020/06/01,821,144,387,30,7,1389
portainer/portainer-ce,2.19.2,2023/11/12,0,21,12,0,0,33
balenalib/orbitty-tx2-ubuntu,20231103,2023/11/06,37,18,0,0,0,55
balenalib/beaglebone-green-wifi-alpine-node,18.14.1-20231106,2023/11/07,0,7,3,0,0,10
objectscale/fedsvc,0.71.3,2021/04/14,9,102,123,20,3,257
airbyte/destination-redpanda,0.1.0,2022/11/14,24,173,205,6,0,408
balena/386-balena-multibuild-scripts,0.1.0,2019/10/01,4,14,9,1,0,28
docker/ucp-kube-gmsa-webhook,3.3.1,2019/07/17,null
bitnami/pushgateway,1.6.2,2023/12/07,77,19,8,2,0,106
balenalib/orbitty-tx2-debian-golang,20231106,2023/11/07,440,96,56,6,0,598
rancher/terraform-controller,v0.0.13-alpha1,2020/11/19,10,40,80,13,0,143
dynatrace/easytravel-headless-loadgen,2.0.0.3599,2023/08/04,205,123,100,15,1,444
balenalib/odroid-c1-fedora-python,20220622,2022/07/12,0,1,1,0,0,2
vmware/labs-service-bindings-manager,0.9.0,0001/01/01,null
jetbrains/datalore-postgres,2023.5.1,1970/01/01,113,46,39,2,0,200
balenalib/beaglebone-green-fedora-python,20220928,2022/10/04,0,1,1,0,0,2
objectscale/provision,0.71.3,2021/04/08,0,6,4,0,0,10
percona/percona-everest,v0.4.0,2023/11/01,0,3,2,0,0,5
puppet/kubetool,8.0.0,2023/07/13,3,39,41,1,0,84
adobecoldfusion/apimanager2023,2023.0.0,2023/05/17,40,98,100,40,0,278
onlyoffice/box-auth,1.0.1,2023/09/12,0,7,6,0,0,13
intel/sigopt-controller,2022-11-09a,2022/11/09,3,28,23,1,0,55
rancher/ecm-distro-tools,v0.23.0,2023/10/03,3,46,35,0,5,89
ddosify/selfhosted_frontend,2.4.1,2023/11/01,2,31,38,6,0,77
rancher/rke2-cloud-provider,v1.28.2-build20231016-s390x,2023/10/17,0,10,14,0,5,29
grafana/cortex-distributor,w37-0193e7b7,2018/09/11,0,0,0,2,0,2
airbyte/destination-vertica,0.1.0,2023/05/31,29,190,236,21,0,476
appdynamics/machine-agent-arm64,23.10.0,2023/10/30,97,33,8,1,0,139
balenalib/qemux86-64-ubuntu-golang,20230911,2023/09/11,149,152,23,0,0,324
grafana/cortex-lite,w37-0193e7b7,2018/09/11,0,0,0,2,0,2
rancher/haproxy-tomcat,v0.0.1,2016/06/17,0,27,24,10,0,61
rancher/mirrored-prom-alertmanager,v0.21.0,2020/06/17,0,14,26,0,0,40
balenalib/amd64-fedora-node,20231103,2023/11/04,0,1,1,0,0,2
docker/dtr-api-s390x,2.5.0-beta3,2018/01/17,3,56,103,50,0,212
balenalib/i386-alpine-golang,20230911,2023/09/11,2,6,5,2,0,15
bitnami/kiam,4.2.0,2023/12/07,81,22,19,2,0,124
launchdarkly/ld-relay,8.2.0,2023/10/24,0,4,3,0,0,7
mathworks/matlab-deep-learning,r2023b,2023/10/27,196,238,11,0,0,445
mirantis/phpldapadmin,v0.6.12-1,2018/04/10,67,219,256,125,35,702
rancher/drone-images,runner-amd64-2004,2020/07/13,3,17,18,0,0,38
okteto/movies-api,okteto,2020/04/15,512,1386,1101,223,12,3234
google/apigee-hybrid-cassandra-client,1.8.1,2022/07/07,9,31,44,4,5,93
docker/ucp-istio-proxyv2,3.3.1,2020/06/26,471,1159,140,1,0,1771
okteto/statuspage,dev,2020/03/31,514,1480,1224,247,12,3477
balena/armv7hf-supervisor-node,1244-update-lock-weirdness,2020/04/02,716,616,594,77,10,2013
okteto/helm-chart-manager,1.1.1,2020/01/08,13,44,65,9,0,131
rancher/systemd-node,v0.0.5-rc2,2023/06/08,6,35,37,0,2,80
airbyte/destination-e2e-test,0.3.0,2023/05/15,25,171,190,6,0,392
amazon/amazon-eks-pod-identity-webhook,4580826,2023/05/18,0,2,4,0,0,6
rancher/mirrored-kube-vip-kube-vip-iptables,v0.6.0,2023/05/15,0,16,10,0,0,26
objectscale/objectscale-license-usage,1.4.0-397.adb0726,2023/11/13,0,5,4,0,0,9
rancher/gke-operator,v2.0.1-rc2,2021/05/20,94,191,31,0,0,316
circleci/cci-demo-docker,0.1.68,2017/05/15,0,1,5,2,0,8
bitnami/mxnet,1.9.1,2023/10/11,610,207,95,11,0,923
okteto/clean,0.1.6,2021/02/16,0,1,0,0,0,1
redislabs/service-broker,968fa1a,2018/03/20,205,489,515,126,15,1350
airbyte/source-getlago,0.3.0,2023/10/17,0,16,24,1,0,41
dynatrace/dynatrace-codemodules,1.277.165.20231024-150054,2023/10/25,null
kasmweb/centos-7-desktop,1.14.0,2023/09/14,1388,1443,107,4,2,2944
objectscale/metering,0.71.3,2021/04/15,17,149,226,36,6,434
docker/ucp-auth-s390x,3.1.0-beta3,2018/10/04,0,2,6,16,0,24
airbyte/normalization-duckdb,0.4.3,2023/05/12,486,394,335,50,4,1269
balenalib/armv7hf-ubuntu-openjdk,11-xenial-20231026,2023/11/02,null
jetbrains/upsource-psi-agent,2020.1.1992,2022/03/11,80,152,245,97,0,574
airbyte/source-stripe-singer,0.2.1,2021/04/03,140,101,113,34,8,396
solaceiotteam/apim-demo-portal,0.1.20,2021/11/03,139,235,36,4,0,414
grafana/grafana-plugin-ci-e2e,1.9.7,2023/11/07,766,211,172,9,3,1161
circleci/clojure,tools-deps-1.11.1.1113-buster-node,2022/05/01,667,230,309,63,16,1285
rancher/mirrored-istio-proxyv2,1.19.0,2023/09/01,29,20,6,0,0,55
dynatrace/oneagent,1.129.145,2017/10/17,747,755,76,3,0,1581
appdynamics/ad-air-web-api,java,2021/01/15,94,115,95,32,0,336
greenbone/pheme,21.8.1,2023/11/14,108,42,42,6,0,198
objectscale/kahm-testapp,v2.74.0,2021/05/25,4,54,72,3,3,136
balenalib/up-board-alpine-node,20231106,2023/11/07,0,7,3,0,0,10
jetbrains/upsource-analyzer,2020.1.1992,2022/03/11,143,206,322,115,3,789
hashicorp/consul-api-gateway,0.5.5,2023/09/07,1,16,14,0,0,31
airbyte/source-postgres-strict-encrypt,3.1.13,2023/10/13,9,48,63,17,0,137
balenalib/jetson-tx2-python,20231106,2023/11/07,117,30,31,4,0,182
okteto/ruby,2,2023/08/24,775,481,319,22,2,1599
newrelic/synthetics-node-browser-runtime,2.0.35,2023/10/02,136,199,10,0,0,345
cimg/mariadb,11.2.1,2023/10/12,328,384,47,0,0,759
okteto/golang-middleware-template,0.1.1,2020/06/01,705,548,509,65,12,1839
google/apigee-connect-agent,1.8.1,2022/07/20,0,4,6,0,0,10
rancher/image-build-crictl,v1.17.0-amd64,2020/08/19,259,428,37,3,0,727
intel/oneapi-runtime,2023.2-devel-ubuntu22.04,2023/07/14,188,194,38,0,0,420
vmware/vke-imagetest,1.1,2019/01/26,850,1336,86,3,0,2275
balenalib/aarch64-debian-python,20231106,2023/11/07,110,30,22,4,0,166
cimg/azure,2023.09.1,2023/09/25,328,387,50,0,0,765
vmware/sources-for-knative-controller,v0.29.0,1970/01/01,0,4,7,0,0,11
docker/ucp-kube-dns-sidecar-s390x,3.1.0-beta3,2018/10/04,0,0,0,2,0,2
intel/image-recognition,tf-2.7.0-resnet101-int8-inference,2021/12/15,89,162,12,0,0,263
rancher/opa-gatekeeper,v3.1.0-rc.1,2020/08/14,0,9,14,0,6,29
docker/ucp-azure-ip-allocator-s390x,3.1.0-beta3,2018/10/04,0,0,6,16,0,22
balenalib/artik530-python,20220714,2022/07/22,127,78,78,18,0,301
solaceiotteam/solace-axway-agent,0.0.21,2022/05/10,0,15,9,1,0,25
objectscale/chunk-manager,0.71.3,2021/04/15,17,149,226,36,6,434
okteto/desk,0.1.6,2019/09/06,694,1020,73,0,0,1787
airbyte/source-amplitude,0.3.6,2023/10/24,65,28,7,1,0,101
balenalib/odroid-c1-fedora-golang,20220507,2022/05/12,null
airbyte/custom-transformation-prep,1.0,2023/05/12,486,394,335,50,4,1269
kasmweb/core-fedora-38,1.14.0,2023/09/09,null
bitnami/suitecrm,8.4.2,2023/12/17,155,118,67,7,0,347
rancher/hardened-sriov-network-operator,14bd335c17c1b4c6cb7d37c2972c05cc62cadeeb-build20211119,2021/11/19,239,331,29,3,0,602
balenalib/via-vab820-quad-fedora-node,36-build-20220714,2022/07/22,0,1,1,0,0,2
balenalib/zynq-xz702-fedora-openjdk,30-20210825,2021/09/03,null
airbyte/source-oracle-strict-encrypt,0.4.0,2023/06/29,25,172,191,6,0,394
pachyderm/splitcombine,0.0.2,2023/03/28,null
kasmweb/tracelabs,1.14.0,2023/09/14,4,74,82,16,0,176
balenalib/orangepi-plus2-fedora-golang,20221210,2022/12/13,null
circleci/logging-collector,3.0,2023/12/08,0,1,0,0,0,1
mattermost/webrtc,4.4,2017/11/30,458,713,56,1,0,1228
balenalib/odroid-xu4-fedora,20221210,2022/12/12,null
objectscale/decks-pre-update,2.78.0-221.79a9cc6,2021/07/20,2,17,21,0,0,40
intel/intel-ethernet-operator-flowconfig-daemon,v1.0.0,2023/07/19,4,17,5,0,0,26
rancher/directxman12-k8s-prometheus-adapter-amd64,v0.7.0,2020/04/17,null
intel/intel-optimized-ffmpeg,avx3-src,2023/08/31,158,166,21,0,0,345
lacework/azure-cfg-cli,v1.0,2018/12/03,877,1729,96,1,0,2703
kasmweb/doom,1.14.0,2023/09/14,217,444,0,0,0,661
amazon/aws-sam-cli-emulation-image-nodejs14.x,20220125,2022/01/25,3,52,24,3,0,82
docker/dtr-notary-server,2.8.1,2020/06/17,2,9,8,1,0,20
balenalib/intel-nuc-fedora-openjdk,8-20231103,2023/11/04,null
balenalib/artik533s-alpine-python,20220803,2022/08/04,7,44,35,10,0,96
balenalib/orbitty-tx2-node,20231106,2023/11/07,117,31,32,4,0,184
onlyoffice/docs-utils,7.5.1-1,2023/11/09,0,10,5,0,0,15
dynatrace/dynatrace-gcp-function,v1-latest,2023/02/02,100,57,47,3,4,211
balenalib/armv7hf,20230929,2023/10/02,114,45,34,6,0,199
bitnami/pymilvus,2.3.3,2023/11/16,80,16,8,2,0,106
balenalib/am571x-evm-ubuntu-golang,20220523,2022/06/03,221,534,46,0,0,801
intel/object-detection,tf-2.7.0-ssd-resnet34-int8-inference,2021/12/15,294,759,75,2,0,1130
cockroachdb/movr,21.1.1,2021/05/26,1442,1329,927,143,40,3881
balenalib/apalis-imx6q-openjdk,20210602,2021/06/05,222,249,144,39,9,663
balenalib/intel-nuc-ubuntu-python,20230911,2023/09/11,42,20,4,0,0,66
kasmweb/oracle-9-desktop,1.14.0,2023/09/14,24,151,966,0,0,1141
rancher/os-dind,18.03.1,2018/12/12,0,23,0,2,0,25
hashicorp/http-echo,1.0,2023/10/10,null
bitnami/mariadb,11.1.3,2023/12/18,77,19,8,2,0,106
pachyderm/example-wordcount,2.0.3,2022/02/18,494,375,321,61,4,1255
circleci/vm-service-lite,1.0.117-440460b,2023/01/26,1,10,17,1,0,29
rancher/harvester-node-disk-manager,v0.5.2,2023/12/07,0,6,0,0,1,7
circleci/jruby,9.3.3.0,2022/02/22,304,398,370,67,4,1143
docker/desktop-kubernetes,v1.15.4,2019/09/23,null
vmware/photon-build,rpm-ostree-3.0,2019/08/27,26,158,181,64,0,429
docker/ucp-calico-node,3.3.1,2020/06/26,134,314,37,0,0,485
rancher/hardened-k8s-metrics-server,v0.3.7,2020/09/25,256,407,18,3,0,684
balenalib/odroid-c1-alpine-golang,20220714,2022/07/27,8,45,38,12,0,103
balenalib/hummingboard-alpine-node,18.14.1-20230904,2023/09/09,2,7,6,2,0,17
docker/cnab-app-base,v0.9.1-beta3,2020/04/24,2,10,29,4,0,45
airbyte/source-zapier-supported-storage,0.1.0,2022/11/07,0,19,25,1,0,45
docker/ucp-calico-kube-controllers,3.3.1,2020/05/28,null
airbyte/source-courier,0.1.0,2022/10/19,0,19,25,1,0,45
balenalib/imx6ul-var-dart-debian-golang,20230911,2023/09/12,446,124,78,10,0,658
lacework/lacework-inline-scanner,0.23.2,2023/11/10,0,12,10,0,0,22
rancher/os-base,3929481,2017/02/03,null
kumahq/kuma-cni,2.4.4,2023/11/06,7,3,1,0,0,11
jetbrains/datalore-sql-session,2023.3.1,1970/01/01,64,116,9,0,0,189
balena/i386-nlp-supervisor-node,1244-update-lock-weirdness,2020/03/31,122,188,178,22,2,512
astronomerinc/ap-commander,0.33.6,2023/11/09,0,19,0,0,0,19
bitnami/jsonnet,0.20.0,2023/12/15,75,15,7,2,0,99
airbyte/destination-firestore,0.1.1,2021/11/21,0,22,53,8,0,83
docker/for-desktop-qemu,39146321ff4b36f97116053ff277fc87eb664aee-arm64,2021/05/04,null
ubuntu/dotnet-runtime,7.0_beta,2023/11/01,null
balenalib/generic-armv7ahf-fedora,20221210,2022/12/12,null
okteto/deno,1.9,2021/04/19,91,39,53,16,7,206
airbyte/source-coin-api,0.1.1,2023/01/05,0,18,25,1,0,44
okteto/golang,2,2020/04/28,707,573,534,66,12,1892
rancher/swarm-agent,v0.1.3,2016/07/13,49,14,4,0,0,67
airbyte/source-paypal-transaction,2.2.0,2023/10/26,65,28,7,1,0,101
bitnami/percona-xtrabackup,8.0.34-29,2023/11/15,82,18,13,3,0,116
bellsoft/buildpacks.java,1.0.0,1980/01/01,0,4,2,0,0,6
kong/ubi-kumactl,2.4.4,2023/11/06,28,35,8,0,0,71
balenalib/i386-nlp-ubuntu,20210225,2021/03/11,121,246,16,0,0,383
graphcore/pytorch-early-access,3.3.0-EA.1-ubuntu-20.04-20230504,2023/05/04,179,307,35,0,0,521
snyk/snyk-operator-index,1.40.3-pre6,2021/01/22,5,25,55,4,0,89
cockroachdb/cockroach-operator-unstable,v1.0.0-alpha.2,1970/01/01,null
newrelic/synthetics-job-manager,release-310,2023/11/02,34,21,3,1,0,59
rancher/os-qemuguestagent,v2.8.1-2,2019/01/22,77,62,71,11,11,232
vmware/restreview-db,V1,2017/10/31,101,225,318,118,13,775
puppet/puppet-bolt,3.27.4,2023/10/06,26,20,2,0,0,48
balenalib/kitra520-ubuntu-python,20220715,2022/08/02,87,92,13,0,0,192
balenalib/aarch64-debian,20231106,2023/11/07,110,29,22,4,0,165
kong/gateway-operator,20231115,2023/11/15,0,1,0,0,0,1
rancher/mirrored-minio-minio,RELEASE.2023-07-07T07-13-57Z-s390x,2023/07/07,80,52,7,0,0,139
objectscale/atlas-operator,0.69.0,2021/02/23,0,5,12,0,0,17
rancher/mirrored-flannel-flannel,v0.23.0,2023/10/30,0,5,0,0,0,5
balenalib/artik10-debian,20220714,2022/07/22,127,77,76,18,0,298
airbyte/source-configcat,0.1.0,2022/11/10,0,19,25,1,0,45
rancher/nginx-ingress-controller-defaultbackend,1.4,2017/10/24,null
grafana/grafana-enterprise-dev,10.3.0-63461,2023/11/15,0,8,2,0,0,10
balenalib/parallella-alpine-openjdk,8-20230904,2023/09/09,8,14,6,2,0,30
rancher/hardened-sriov-network-webhook,14bd335c17c1b4c6cb7d37c2972c05cc62cadeeb-build20211119,2021/11/19,239,330,27,3,0,599
grafana/fake-data-gen,1167815,2022/06/28,2,40,27,7,0,76
balenalib/raspberrypi3-debian-golang,20230530,2023/06/27,382,68,50,8,0,508
pingidentity/pingdirectoryproxy,2310,2023/11/01,3,14,9,0,0,26
mirantis/python-operations-api,comment-auth,2018/10/31,60,62,104,29,11,266
ambassador/telepresence-docker-runtime,1.0.19,2023/11/14,0,6,2,0,0,8
airbyte/source-search-metrics,0.1.1,2021/12/22,0,21,50,8,0,79
balenalib/kitra710-debian-openjdk,20230502,2023/05/06,146,89,52,6,0,293
rancher/grafana-grafana-image-renderer,2.0.0,2020/05/16,7,251,349,39,3,649
okteto/bin,1.24-rc1,2020/08/24,0,9,15,0,0,24
rancher/pipeline-kube-apply,v0.2.0,2018/07/23,0,2,1,0,0,3
objectscale/crunchy-upgrade,ubi8-5.1.2-0,2022/07/05,260,183,42,0,0,485
pingidentity/pingfederate,2310,2023/11/01,3,44,46,4,0,97
balenalib/aarch64-debian-node,20231106,2023/11/07,110,31,23,4,0,168
vmware/photon-2.0-kube-scheduler-amd64,v1.10.2-20180619,2018/06/19,15,81,98,70,0,264
kumahq/kuma-demo,latest-arm64,2022/05/26,0,15,10,1,0,26
kasmweb/ubuntu-focal-desktop-vpn,x86_64-develop,2023/12/14,259,386,0,0,0,645
pachyderm/split-loadtest-pipeline,20191119.0802,2019/11/19,null
balenalib/stem-x86-32-ubuntu-golang,1.20.1-xenial-20230904,2023/09/09,null
airbyte/source-open-exchange-rates,0.2.0,2023/10/23,0,15,24,1,0,40
cockroachdb/interop-demo,1.1,2017/04/24,null
tenable/tcs,2.7.0,2023/10/25,165,70,32,3,0,270
bitnami/gitlab-runner-helper,16.5.0,2023/11/08,112,31,32,5,2,182
kumahq/kumactl,2.4.4,2023/11/06,7,3,2,0,0,12
balenalib/beaglebone-black,20230911,2023/09/11,121,45,42,6,0,214
onlyoffice/4testing-docs-example,99.99.99.2945,2022/05/15,1400,1097,739,74,38,3348
kasmweb/minetest,1.14.0,2023/09/14,219,448,0,0,0,667
datadog/agent-dev-amd64,6.15.1,2019/11/27,96,71,85,20,7,279
bitnami/wavefront-hpa-adapter-archived,0.9.10,2023/05/21,0,4,5,0,0,9
okteto/example-react-api,devops,2019/02/27,405,1134,814,210,50,2613
appdynamics/appdynamics-smartagent,23.10.0-1190,2023/10/27,0,7,4,0,0,11
balenalib/i386-nlp-debian-golang,1.11.13-20200529,2021/04/12,655,414,359,54,10,1492
balenalib/nitrogen6x-fedora-golang,20220507,2022/05/12,null
ubuntu/zookeeper,3.1-22.04_edge,2023/07/06,33,43,11,5,0,92
balenalib/odroid-xu4-debian,20230911,2023/09/11,121,45,42,6,0,214
astronomerinc/ap-auth-sidecar,1.25.2-2,2023/11/07,0,6,0,0,0,6
rancher/longhornio-csi-node-driver-registrar,v2.5.0,2022/02/03,0,4,6,0,0,10
bitnami/wavefront-kubernetes-collector,1.13.0,2023/05/21,0,3,4,0,0,7
airbyte/source-gcs,0.3.1,2023/11/13,132,47,12,2,0,193
bitnami/vault-csi-provider,1.4.1,2023/12/07,87,23,13,4,0,127
grafana/promtail,2.9.2,2023/10/25,79,19,12,2,0,112
balenalib/beaglebone-green-wifi-openjdk,20230911,2023/09/12,132,73,46,6,0,257
balenalib/artik530-debian-python,20220714,2022/07/22,127,78,78,18,0,301
docker/desktop-vpnkit-controller,v2.0,2021/05/05,0,12,16,1,0,29
rancher/istio-sidecar_injector,1.5.9,2020/08/07,405,1085,142,0,0,1632
nginxinc/nginmesh_proxy_debug,0.7.1,2018/07/24,103,144,347,68,18,680
jetbrains/youtrack,2023.2.20316,2023/11/02,84,63,43,13,0,203
airbyte/source-mailjet-sms,0.1.0,2022/10/28,0,19,25,1,0,45
rancher/etcd,v3.4.13,2020/08/26,256,425,50,3,0,734
balenalib/rpi-alpine-node,18.14.1-20231026,2023/11/01,0,7,3,0,0,10
vmware/vsphere-block-csi-driver,v1.0.0,2019/08/16,14,63,70,30,0,177
okteto/grafana,0.1.3,2018/10/31,77,85,155,42,12,371
intel/gpu-extender,0.5.4,2023/08/14,0,1,1,0,0,2
objectscale/pgpool,4.2.2-debian-10-r38,2021/03/29,138,101,112,27,7,385
rancher/runc,v1.0.0-rc10,2020/08/11,256,407,18,3,0,684
pachyderm/gpt-2-example,v7,2020/06/19,703,1019,163,7,0,1892
vmware/dind-sshuttle-ci,dev,2018/06/12,3,61,26,30,0,120
kasmweb/brave,1.14.0,2023/09/14,217,442,0,0,0,659
vmware/lightwave-photon-testware,2.0.5,2018/12/20,64,389,487,144,0,1084
rancher/pod-setup,v0.1.0,2017/09/22,null
bitnami/kubeapps-chartsvc-archived,1.10.0,2020/04/01,null
vmware/veba-event-router,76088920,2020/10/20,74,60,12,0,0,146
balenalib/stem-x86-32-ubuntu-node,10.23.1-20210201,2021/07/27,106,185,26,3,0,320
intel/oneapi-vtune,2023.2-devel-ubuntu22.04,2023/07/14,188,194,38,0,0,420
balenalib/spacely-tx2-openjdk,20231106,2023/11/07,128,52,33,4,0,217
airbyte/source-bigquery,0.3.0,2023/06/29,25,171,190,6,0,392
pachyderm/ide-user,2.0.0-b6,2021/11/01,115,182,43,5,0,345
qualys/qcs-sensor,1.29.0-0,2023/09/29,2,30,10,0,0,42
mattermost/chaos-mesh,v0.0.5,2021/10/20,1,22,43,2,0,68
balenalib/orbitty-tx2-alpine-python,20231106,2023/11/06,0,7,2,0,0,9
balenalib/aarch64-alpine-golang,20231106,2023/11/06,0,6,2,0,0,8
cockroachdb/cockroach-operator,v2.12.0,2023/10/23,78,41,12,0,0,131
rancher/cluster-proportional-autoscaler,1.8.1,2020/06/11,0,0,0,0,6,6
pachyderm/dash,1.9.0,2019/06/11,69,66,106,39,9,289
objectscale/fluent-bit,0.33.0,2018/11/10,59,57,77,17,5,215
balenalib/apalis-imx6q-fedora-openjdk,30-20210825,2021/09/03,null
couchbase/centos-72-java-sdk,20170613,2017/07/06,714,896,133,14,0,1757
bitnami/dataplatform-emitter-archived,1.0.1,2022/05/04,4,23,16,0,0,43
balenalib/aarch64-alpine-node,20231106,2023/11/06,0,7,3,0,0,10
balenalib/colibri-imx6dl-ubuntu-golang,20220523,2022/06/03,221,534,46,0,0,801
circleci/ruby,3.0.3,2021/12/18,847,1056,804,102,5,2814
objectscale/csi-provisioner,v3.1.0,2022/01/12,0,5,9,0,0,14
rancher/longhornio-longhorn-manager,v1.3.1,2022/08/11,9,76,78,3,15,181
balenalib/raspberry-pi2-alpine-openjdk,8-20231106,2023/11/07,0,6,2,0,0,8
balenalib/beaglebone-green-alpine-node,18.14.1-20231106,2023/11/07,0,7,3,0,0,10
adobecoldfusion/coldfusionaddons2018,2018.0.1,2022/12/02,313,666,195,84,0,1258
onlyoffice/telegram_bugzilla_notifications,v0.3.0-244-g6a39b37,2023/11/09,0,3,2,0,0,5
rapidfort/ghost,5.52,2023/06/20,58,53,25,7,0,143
airbyte/source-onesignal,1.1.0,2023/08/31,0,17,24,1,0,42
balenalib/bananapi-m1-plus-debian-openjdk,20230904,2023/09/09,132,73,46,6,0,257
bitnami/apisix-ingress-controller,1.7.0,2023/11/08,77,20,10,2,0,109
intel/smart-city_grafana,2021.4.2,2021/12/14,5,33,66,9,0,113
balenalib/odroid-xu4-alpine-python,20231106,2023/11/07,0,7,2,0,0,9
balenalib/beaglebone-green-wifi-debian-openjdk,20230911,2023/09/12,132,73,46,6,0,257
pachyderm/worker,2.8.0-rc.2,2023/11/13,1,10,8,0,0,19
rapidfort/yugabyte,2.17.3.0-b152,2023/05/04,1,10,18,1,0,30
balenalib/rpi-debian-openjdk,8-20190705,2019/07/06,143,203,171,34,12,563
rancher/nginx,1.14.2,2019/03/26,43,55,81,31,7,217
objectscale/kahm-pre-update,2.78.0-167.d216af1,2021/07/20,2,17,21,0,0,40
grafana/kubernetes-diff-logger,0.0.5,2021/06/28,0,13,40,4,0,57
bitnami/harbor-adapter-trivy,2.9.1,2023/12/06,77,19,7,2,0,105
vmware/photon,1.0-20180621,2018/06/21,8,55,68,40,0,171
vmware/notary-server-photon,v0.5.1-v1.5.2,2018/07/18,8,54,72,36,0,170
balenalib/raspberrypi3-fedora-openjdk,8-20221031,2022/11/04,null
balenalib/orbitty-tx2-fedora-python,20231106,2023/11/06,null
bitnami/contour-operator-archived,1.24.0,2023/05/15,0,2,3,0,0,5
rancher/external-dns,v0.7.12,2018/08/09,0,7,0,0,0,7
balenalib/artik533s-ubuntu-python,20220715,2022/08/02,87,92,13,0,0,192
grafana/cortex-jsonnet-build-image,3527936,2021/06/22,3,30,59,17,0,109
airbyte/source-microsoft-teams,0.2.5,2021/12/16,3,23,52,8,0,86
portainer/portainer-updater,latest-windows-amd64,2023/03/26,0,12,7,0,0,19
balena/balena-mdns-publisher,1.27.35,2023/11/13,373,122,65,7,6,573
grafana/tempo-query,2.3.0,2023/10/30,0,5,4,0,0,9
ubuntu/mimir,2.6.0-22.04,2023/10/05,22,30,14,0,0,66
astronomerinc/ap-dogstatsd,9,2023/04/03,0,0,0,1,0,1
intel/intel-sgx-initcontainer,0.28.0,2023/09/22,null
pachyderm/retail-allocation,viz-fix2,2018/02/12,0,26,19,10,0,55
balenalib/generic-aarch64-ubuntu-openjdk,11-xenial-20231103,2023/11/06,null
redislabs/olm-bundle,100.0.7-1207,2023/02/26,null
mattermost/mattermost-operator,9981920,2020/12/03,0,6,11,1,5,23
bitnami/tomcat,10.1.16,2023/12/07,78,19,8,2,0,107
onlyoffice/4testing-docs-converter-de,7.5.1-1-saas,2023/11/08,16,3,0,0,0,19
okteto/php-getting-started,1.0.1,2023/02/27,430,180,118,8,0,736
onlyoffice/confluence-cloud,1.0.1,2023/05/23,1,19,5,1,0,26
balenalib/artik710-debian-golang,20230904,2023/09/09,446,127,78,10,0,661
vmware/rsyslog-photon,8.15.0-6,2017/10/23,10,81,101,57,0,249
intel/intel-optimized-pytorch,1.12.100,2022/10/19,44,70,8,1,0,123
rancher/rancher.github.io,2018-05-01,2018/04/17,69,67,109,41,9,295
continuumio/miniconda3,23.9.0-0,2023/10/23,126,49,60,7,2,244
redislabs/redis-di-cli,v0.117.0,2023/11/02,67,22,0,0,0,89
continuumio/anaconda,2019.10,2019/10/15,216,257,330,72,13,888
balenalib/raspberry-pi2,20230911,2023/09/11,121,45,42,6,0,214
balenalib/hummingboard-fedora-python,20221109,2022/11/16,0,1,0,0,0,1
balenalib/colibri-imx6dl-fedora-node,36-build-20220714,2022/07/22,0,1,1,0,0,2
dynatrace/easytravel-backend,7.1,2018/05/11,8,44,91,67,0,210
docker/ucp-kube-compose,3.3.1,2019/11/07,4,14,9,1,0,28
cockroachdb/locality-checker,0.1,2020/04/30,6,38,86,9,0,139
kasmweb/core-remnux-bionic,1.12.0,2022/12/01,260,1060,152,26,0,1498
balenalib/colibri-imx6dl-debian,20220714,2022/07/20,127,77,76,18,0,298
airbyte/destination-xata,0.1.1,2023/06/21,0,17,25,1,0,43
balenalib/raspberry-pi2-fedora-python,20221109,2022/12/02,0,1,0,0,0,1
rancher/kine,v0.10.3,2023/09/08,0,6,7,0,0,13
adobecoldfusion/coldfusionaddons2021,2021.0.3,2022/12/02,312,667,196,84,0,1259
newrelic/k8s-events-forwarder,1.48.1,2023/11/02,0,10,0,0,0,10
airbyte/destination-dev-null,0.3.0,2023/05/16,25,171,190,6,0,392
intel/language-modeling,tf-2.7.0-bert-large-fp32-training,2021/12/15,318,813,73,0,0,1204
intel/edge_video_analytics_microservice,0.7.2,2022/07/19,294,846,46,0,0,1186
bitnami/supabase-realtime,2.25.29,2023/11/14,77,16,7,2,0,102
balenalib/artik533s-golang,20220714,2022/07/22,471,278,225,29,1,1004
objectscale/ciq-upload,webdav,2020/08/03,0,10,15,0,0,25
balenalib/kitra710-python,20230829,2023/09/02,121,46,42,6,0,215
mirantis/ucp-coredns,3.7.1,2023/08/09,0,4,2,0,0,6
apachepinot/pinot-base-runtime,21-openjdk,2023/10/15,217,70,60,1,0,348
docker/dtr-etcd,v2.2.4,2016/01/13,null
kasmweb/inkscape,1.14.0,2023/09/14,222,475,0,0,0,697
astronomerinc/ap-base,3.18.4-1,2023/11/02,0,4,0,0,0,4
hashicorp/vault-benchmark,0.2,2023/08/21,0,6,4,0,0,10
balenalib/jetson-tx2-debian-node,20231106,2023/11/07,117,31,32,4,0,184
airbyte/destination-mssql,0.2.0,2023/07/27,32,186,244,21,0,483
purestorage/k8s,v6.2.3,2022/07/22,0,25,35,0,0,60
portainer/helper-templates,linux-arm64,2020/08/26,null
balenalib/orangepi-plus2-golang,20230911,2023/09/11,446,124,78,10,0,658
vmware/lightwave-toolchain-photon,2.0.4,2018/08/14,49,266,243,76,0,634
balenalib/i386-openjdk,20231106,2023/11/06,121,52,24,4,0,201
bitnami/grafana-tempo-query,2.3.0,2023/11/15,77,19,11,2,0,109
docker/dtr-nginx,2.8.1,2020/06/17,2,10,9,1,0,22
airbyte/source-emailoctopus,0.1.0,2022/11/09,0,19,25,1,0,45
objectscale/transitionsvc,3.8.1.0-25.f6d9f2a,2022/12/12,12,64,55,3,3,137
rancher/pstauffer-curl,v1.0.3,2018/07/11,0,0,6,18,0,24
bitnami/wavefront-kubernetes-collector-archived,1.13.0,2023/05/21,0,3,4,0,0,7
vertica/vertica-logger,1.0.0,2021/12/15,0,14,14,1,0,29
adobecoldfusion/apimanageraddons2023,2023.0.0,2023/05/17,37,32,8,3,0,80
airbyte/destination-keen,0.2.4,2022/08/04,77,83,65,19,0,244
balenalib/hummingboard-alpine-openjdk,8-20230904,2023/09/09,8,14,6,2,0,30
circleci/golang,1.17.5,2021/12/18,541,458,398,70,4,1471
airbyte/source-oracle,0.4.0,2023/06/29,25,172,191,6,0,394
airbyte/source-todoist,0.1.0,2023/03/23,0,16,17,0,0,33
datadog/docker-dd-agent-build-rpm-x64,20180821,2018/07/27,0,3,10,3,0,16
balenalib/armv7hf-alpine-node,18.14.1-20231106,2023/11/07,0,7,3,0,0,10
bitnami/apache,2.4.58,2023/12/07,82,19,9,2,0,112
onlyoffice/docspace-zoom-router,1.0.0,2023/09/21,85,51,22,3,0,161
rancher/scheduler,v0.8.6,2019/01/22,306,388,24,0,0,718
balenalib/bananapi-m1-plus-python,20230904,2023/09/09,121,46,42,6,0,215
balenalib/raspberry-pi2-ubuntu,20231026,2023/11/02,37,18,0,0,0,55
docker/logs-explorer-extension,0.2.5,2023/10/30,0,2,2,0,0,4
mattermost/actions-runner,2.310.2-0,2023/10/18,193,231,29,0,0,453
intel/crypto-perf,0.28.0,2023/09/22,null
mirantis/salt,saltstack-ubuntu-xenial-salt-2018.3,2018/05/11,453,660,43,0,0,1156
grafana/agentctl,v0.37.4,2023/11/06,14,9,1,0,0,24
cockroachdb/cockroach-unstable-arm64v8,v2.0.0,2018/04/05,42,53,66,11,16,188
airbyte/source-salesforce,20211201-1,2021/12/02,0,21,50,8,0,79
rancher/k3k,v0.0.0-alpha7,2023/07/03,0,12,6,3,0,21
astronomerinc/ap-pgbouncer-krb,1.17.0-9,2023/06/12,0,9,0,0,0,9
balenalib/imx6ul-var-dart-alpine-golang,20231106,2023/11/07,0,6,2,0,0,8
balenalib/colibri-imx6dl-fedora-golang,20220507,2022/05/12,null
atlassian/artifactory-sidekick,staging-linux-arm64v8,0001/01/01,0,0,2,0,0,2
mongodb/mongodb-atlas-kubernetes-operator-prerelease,1.9.1-rc0,2023/10/19,3,4,0,0,0,7
astronomerinc/ap-po-pgbouncer,22.0,2022/07/18,0,0,0,1,0,1
mirantis/ucp-compose,3.7.1,2023/09/26,32,45,11,0,0,88
bitnami/notation,1.0.1,2023/12/07,77,17,7,2,0,103
balenalib/beaglebone-green-debian-openjdk,20230911,2023/09/11,132,73,46,6,0,257
balenalib/generic-armv7ahf-debian-golang,20230904,2023/09/09,446,124,78,10,0,658
onlyoffice/docs-example-de,6.2.2.17,2021/04/27,544,498,32,3,0,1077
objectscale/qualification-tool,1.4.0-110.4493033,2023/11/06,1,24,20,1,0,46
datadog/dd-lib-java-init,v1.23.0,2023/11/09,0,2,2,0,0,4
docker/dtr-postgres,2.8.1,2020/06/17,5,30,39,4,0,78
mattermost/mattermost-cloud-database-factory,9079426,2022/07/27,1,19,24,3,0,47
amazon/aws-codebuild-local,aarch64,2023/02/10,26,133,173,5,0,337
onlyoffice/trello-server,1.0.7,2023/11/15,0,2,2,0,0,4
docker/oscalkit,0.2.0,2019/02/07,0,0,0,2,0,2
airbyte/destination-cassandra,0.1.4,2022/08/26,77,80,65,19,0,241
puppet/pipelines,527601,2019/03/25,70,108,100,29,0,307
onlyoffice/4testing-docspace-bin-share,2.0.0.33,2023/11/24,null
balenalib/orbitty-tx2-ubuntu-node,20231103,2023/11/06,38,19,1,0,0,58
mirantis/dtr-postgres,2.9.14,2023/09/28,0,17,9,0,0,26
newrelic/infrastructure-k8s-unprivileged,1.8.0-beta,2019/04/12,0,0,0,2,0,2
pachyderm/kubeflow_worker,fix7,2018/03/07,0,2,2,2,0,6
balenalib/up-board-debian,20210825,2021/09/03,174,108,99,24,7,412
bitnami/logstash-exporter-archived,7.3.0,2022/05/16,129,83,79,23,7,321
balenalib/spacely-tx2-debian-golang,20231106,2023/11/07,440,96,56,6,0,598
rapidfort/cassandra-official,4.0.11,2023/12/17,10,13,8,0,0,31
docker/scout-sbom-indexer,974152c,2023/09/27,0,5,2,0,0,7
bitnami/kapacitor,1.7.1,2023/12/07,77,20,9,2,0,108
balenalib/am571x-evm-python,20220604,2022/06/12,127,90,78,20,0,315
balenalib/generic-armv7ahf-alpine-python,20230904,2023/09/09,2,7,5,2,0,16
objectscale/targetcfg,3.9.0.0-139102.b4b5064355c,2023/05/03,2,16,11,0,0,29
balenalib/kitra520-ubuntu-node,20220715,2022/08/02,88,92,12,0,0,192
nginx/nginx-prometheus-exporter,0.11,2022/09/07,null
bitnami/wildfly,30.0.0,2023/11/20,77,19,7,2,0,105
airbyte/source-unleash,0.1.0,2023/03/08,0,18,25,1,0,44
nginxinc/nginx-s3-gateway,unprivileged-oss-20231102,2023/11/02,83,31,14,1,0,129
datadog/agent-buildimages-windows_1809_x64,v3686353-1e75137,2021/01/12,8,48,132,12,0,200
balenalib/revpi-core-3-fedora,20221031,2022/11/04,null
rancher/drone-docker-image-digests,v0.0.13,2022/01/05,4,17,46,4,0,71
onlyoffice/4testing-docspace-api-system,2.0.0.33,2023/11/24,1024,156,211,13,0,1404
ddosify/ddosify,v1.0.5,2023/07/17,0,16,9,1,0,26
snyk/driftctl,v0.40.0,2023/11/06,0,5,6,0,0,11
balenalib/jetson-tx1-alpine,20230530,2023/06/06,2,16,6,2,0,26
airbyte/source-wrike,0.2.0,2023/10/24,0,15,24,1,0,40
rancher/externalip-webhook,v1.0.1,2021/12/17,0,7,9,0,0,16
intel/user-oob-server-app-for-azure,v0.7,2022/09/06,179,457,43,0,0,679
pachyderm/example-group,2.1.0,2022/02/10,829,982,743,96,5,2655
kumahq/kuma-init,2.4.4,2023/11/06,22,12,3,0,0,37
kasmweb/core-nvidia-focal,develop-rolling,2022/05/13,521,1702,3,0,0,2226
bitnami/influxdb,2.7.4,2023/12/07,87,24,14,4,0,129
balenalib/imx6ul-var-dart-debian-python,20230911,2023/09/12,121,46,42,6,0,215
balenalib/am571x-evm-node,18.6-20220714,2022/07/21,127,79,77,18,0,301
docker/vpnkit-expose-port,07953236583a8938ef2681984c2b1441ac0a1656,2020/07/27,null
mirantis/ucp-calico-kube-controllers,3.7.1,2023/09/26,0,8,5,0,0,13
okteto/weaver,0.1.10,2023/01/17,0,6,13,0,0,19
okteto/kubelet-configurator,0.0.1,2021/03/03,127,90,88,31,8,344
kasmweb/core-kali-rolling,1.14.0,2023/09/09,null
primekey/signserver-ce,6.0.0.1,2023/12/18,10,70,37,6,0,123
puppet/lumogon,0.6.0,2018/05/23,null
vmware/vsan-prometheus-setup,v20210717,2021/07/17,14,97,108,45,0,264
ddosify/curlubuntutestapp,23.10,2023/10/12,18,14,4,0,0,36
balenalib/raspberry-pi2-ubuntu-python,20231026,2023/11/02,37,19,0,0,0,56
bitnami/joomla,5.0.0,2023/10/23,152,90,59,4,0,305
intel/rpbs_pipeline_application_web_service,1.0,2023/08/21,5,14,12,3,2,36
google/apigee-synchronizer,1.8.0-preview.2,2022/02/18,9,28,27,3,5,72
bitnami/elasticsearch,8.11.1,2023/12/02,174,82,39,6,0,301
grafana/grafana-enterprise,10.2.1,2023/11/14,0,8,3,0,0,11
kasmweb/vivaldi,1.14.0,2023/09/14,217,442,0,0,0,659
balenalib/spacely-tx2-ubuntu,20231103,2023/11/06,37,18,0,0,0,55
ngrok/ngrok-docker-extension,0.1.5,2023/03/21,0,22,7,0,0,29
mirantis/ucp-csi-snapshotter,3.5.3,2022/04/05,0,0,0,0,6,6
kong/ubi-kuma-cp,2.4.4,2023/11/06,28,36,8,0,0,72
rancher/mirrored-istio-citadel,1.5.9,2020/08/07,406,1088,142,0,0,1636
redislabs/redisai,1.2.5,2021/10/28,230,286,30,0,1,547
newrelic/k8s-nri-jmx,2.4.3,2020/01/22,81,54,17,0,0,152
rapidfort/wordpress,6.3.1,2023/10/17,102,70,44,3,0,219
balenalib/orbitty-tx2-alpine-golang,20231106,2023/11/06,0,6,2,0,0,8
balenalib/artik10-openjdk,20220714,2022/07/22,160,136,87,18,0,401
pachyderm/mnist_pipeline,v1.0.4,2022/01/14,832,1021,752,96,5,2706
bitnami/nginx-ingress-controller,1.9.4,2023/12/07,89,27,19,4,0,139
vmware/powerclicore,13.1,2023/05/05,169,294,33,0,0,496
mirantis/ucp-gatekeeper,3.7.1,2023/04/14,0,3,3,0,0,6
ubuntu/chiselled-jre,8-22.04_31,2023/06/19,null
astronomerinc/ap-pgbouncer-exporter,0.15.0-3,2023/11/02,0,4,0,0,0,4
appdynamics/appdynamics-cloud-db-collector,23.6.0-780,2023/06/26,0,4,9,0,0,13
rancher/mirrored-cilium-certgen,v0.1.9,2023/08/02,0,2,1,0,0,3
airbyte/source-pinterest,0.7.1,2023/11/01,65,28,7,1,0,101
purestorage/docker-plugin,v3.10,0001/01/01,null
airbyte/source-plausible,0.1.0,2022/11/17,0,19,25,1,0,45
docker/cruise-user-shell,17.06,2018/01/25,233,404,18,0,0,655
balenalib/zynq-xz702-debian-golang,20220714,2022/07/28,471,275,219,29,1,995
rancher/gitjob,v0.1.108,2023/11/13,0,8,8,0,3,19
bitnami/metallb-controller,0.13.12,2023/12/07,77,16,7,2,0,102
ngrok/ngrok-ingress-controller,0.2.0,2022/12/27,0,3,3,0,0,6
intel/intel-gpu-plugin,0.28.0,2023/09/22,null
balenalib/asus-tinker-board-alpine-node,18.14.1-20231106,2023/11/07,0,7,3,0,0,10
airbyte/source-kyriba,0.1.0,2022/07/13,0,21,51,8,0,80
balenalib/nitrogen6x-golang,20220714,2022/07/28,471,275,219,29,1,995
balenalib/up-board,20210825,2021/09/03,174,108,99,24,7,412
rancher/mirrored-calico-typha,v3.26.3,2023/10/06,0,3,2,0,0,5
airbyte/octavia-cli,0.50.7,2023/07/11,153,96,65,10,0,324
rancher/mirrored-kiali-kiali,v1.76.0,2023/10/30,37,7,4,0,0,48
docker/ucp-cfssl,3.3.1,2020/06/26,2,8,9,1,0,20
balenalib/intel-nuc-ubuntu-golang,20230911,2023/09/11,149,152,23,0,0,324
mirantis/ucp-kube-dns,3.2.15,2021/06/29,0,0,0,2,0,2
kumahq/kuma-prometheus-sd,1.8.8,2023/07/28,0,15,10,0,0,25
onlyoffice/4testing-docspace-migration-runner,2.0.0.33,2023/11/24,74,16,12,2,0,104
balenalib/rpi,20231106,2023/11/07,110,43,30,4,0,187
docker/ucp-secureoverlay-agent,3.3.1,2020/06/26,2,8,9,1,0,20
airbyte/source-marketo,1.2.2,2023/10/15,65,28,7,1,0,101
balenalib/up-board-fedora-python,20231103,2023/11/04,null
docker/ucp-kube-dns-dnsmasq-nanny-s390x,3.1.0-beta3,2018/10/04,null
mirantis/ucp-istio-node-agent-k8s,3.4.15,2020/06/17,472,1165,149,0,0,1786
onlyoffice/box-builder,1.0.1,2023/09/12,0,7,6,0,0,13
circleci/mongo,5.0.6,2022/02/22,106,178,7,0,0,291
amazon/aws-glue-streaming-libs,glue_streaming_libs_4.0.0_image_01,2023/09/21,87,253,396,95,0,831
snyk/code-agent,1.20.9,2023/12/07,0,0,0,1,0,1
pingidentity/pingtoolkit,2310,2023/11/01,0,8,8,0,0,16
portainer/gosec,v2.6.1-5-g1a0acdf,2021/02/01,6,22,56,15,0,99
datadog/serverless-buildpack,beta8,1980/01/01,0,3,4,0,0,7
google/apigee-stackdriver-logging-agent,1.8.9-2,2021/11/01,1,11,26,2,5,45
bitnami/kubeapps-apprepository-controller,2.9.0,2023/12/06,0,5,2,0,0,7
rancher/metadata,v1.0.7,2017/09/26,306,388,24,0,0,718
airbyte/source-snowflake,0.2.2,2023/10/24,9,48,63,17,0,137
rapidfort/curl,7.88.1,2023/06/02,0,10,6,0,0,16
vertica/kafka-scheduler,23.4.0,2023/11/08,null
hashicorp/envoy-fips,v1.26.4,2023/08/21,7,2,1,0,0,10
ddosify/alaz,v0.2.2,2023/10/30,0,5,3,0,0,8
rapidfort/wordpress-ib,6.2.2,2023/09/28,61,58,4,0,0,123
balenalib/beaglebone-green-wifi-ubuntu-python,20230911,2023/09/11,42,20,4,0,0,66
circleci/rust,1.57.0,2021/12/18,847,1054,801,102,5,2809
balenalib/bananapi-m1-plus-fedora-python,20221109,2022/11/16,0,1,0,0,0,1
balenalib/beaglebone-green-wifi-ubuntu-golang,20230911,2023/09/11,143,152,23,0,0,318
rancher/opni-opensearch-fetcher,v0.5.4,2022/07/26,8,74,76,4,14,176
balenalib/artik533s-alpine-golang,20220803,2022/08/04,8,45,38,12,0,103
solace/solace-pubsub-connector-ibmmq,1.1.1,2023/11/08,75,43,3,1,0,122
mattermost/playbooks-circleci,v2022-12-23,2022/12/23,510,1340,51,0,0,1901
balenalib/i386,20231106,2023/11/06,110,29,22,4,0,165
grafana/k6-grpcbin,v0.3.1,2023/08/23,0,4,6,0,0,10
couchbase/admission-controller,2.5.0,2023/08/14,0,2,1,0,0,3
balenalib/zynq-xz702-debian,20220714,2022/07/20,127,77,76,18,0,298
rancher/migration-agent,v0.1.0-rc8,2021/08/30,0,10,32,1,0,43
airbyte/source-dv-360,0.1.0,2022/09/27,0,21,51,8,0,80
balenalib/orbitty-tx2-ubuntu-golang,20231103,2023/11/06,141,137,1,0,0,279
grafana/drone,write-access-approve,2023/10/25,3,13,14,1,0,31
balenalib/via-vab820-quad-ubuntu,20220714,2022/08/02,87,91,11,0,0,189
okteto/cloud-proxy,0.2,2018/10/16,0,1,3,0,0,4
newrelic/k8s-nri-rabbitmq,2.2.1,2020/01/29,2,11,29,4,0,46
rancher/terraform-operator-executor,v0.0.5,2019/03/26,8,14,31,7,0,60
nginx/nginx-ingress,3.3.2,2023/11/22,83,33,15,1,0,132
hashicorp/consul-aws,0.1.2,2020/04/07,6,21,53,6,0,86
bellsoft/liberica-openjre-alpine,21.0.1-12,2023/11/14,0,2,2,0,0,4
intel/oact-mps,v2.12.5,2023/11/01,0,2,0,0,0,2
airbyte/normalization-redshift,0.4.3,2023/05/12,486,394,335,50,4,1269
kong/koko,v0.1.0,2022/09/27,0,16,16,0,0,32
balenalib/ts4900-alpine,20220714,2022/07/19,7,43,33,10,0,93
intel/mcss_covid19_grafana,2021.4.2,2021/12/16,5,33,66,9,0,113
puppet/iac_release,2.3.0-pre7,2021/09/16,1420,1354,961,146,40,3921
rancher/os2,v0.1.0-alpha13,2021/12/01,15,75,50,1,0,141
docker/ucp-swarm,3.3.1,2020/06/26,2,8,9,1,0,20
rancher/kubectl,v1.28.3,2023/10/23,null
mirantis/ucp-kube-ingress-controller,3.7.1,2023/09/08,2,8,7,2,0,19
balenalib/revpi-core-3-debian-node,20230530,2023/07/02,121,47,43,6,0,217
adobecoldfusion/apimanageraddons2018,2018.0.0,2021/09/16,106,176,8,3,0,293
bitnami/fluxcd-image-reflector-controller,0.30.0,2023/12/06,77,19,8,2,0,106
balenalib/zynq-xz702,20220714,2022/07/20,127,77,76,18,0,298
balenalib/hummingboard-python,20230904,2023/09/09,121,46,42,6,0,215
balenalib/raspberrypi3-ubuntu-python,20231026,2023/11/02,37,19,0,0,0,56
bitnami/spring-cloud-skipper-shell,2.11.1,2023/12/15,77,18,15,4,0,114
rancher/log-aggregator,v0.1.8,2021/08/04,56,26,0,0,0,82
mirantis/k8s-appcontroller,v0.4,2017/01/10,0,12,22,5,0,39
kong/kuma-init,2.4.4,2023/11/06,22,12,4,0,0,38
astronomerinc/ap-astro-ui,0.33.6,2023/11/14,0,4,0,0,0,4
onlyoffice/docspace-studio,1.1.4.1,2023/10/23,1024,157,214,13,0,1408
balenalib/i386-ubuntu-python,20210826,2021/09/21,105,168,8,0,0,281
airbyte/source-facebook-pages,0.3.0,2023/06/26,0,17,25,1,0,43
kumahq/install-cni,0.0.10,2022/05/19,6,20,21,0,0,47
balenalib/beaglebone-black-debian-golang,20230911,2023/09/12,446,124,78,10,0,658
balenalib/parallella-ubuntu-golang,20230904,2023/09/09,143,152,23,0,0,318
balenalib/parallella-python,20230904,2023/09/09,121,46,42,6,0,215
airbyte/source-gutendex,0.1.0,2022/10/20,0,19,25,1,0,45
airbyte/source-hubspot,1.7.0,2023/11/01,65,28,7,1,0,101
docker/ucp-controller-s390x,3.1.0-beta3,2018/10/04,0,2,6,16,0,24
airbyte/source-aircall,0.2.0,2023/07/27,0,17,24,1,0,42
newrelic/newrelic-k8s-operator,0.5.0,2023/11/13,0,5,2,0,0,7
bitnami/argo-workflow-cli,3.5.1,2023/11/08,0,2,1,0,0,3
mirantis/rethinkdb,2.4.3-mirantis-44-5296d3f,2023/05/10,4,21,13,2,0,40
intel/esp-uos-kernel,v3.1.2,2023/07/25,null
balenalib/colibri-imx6dl,20220714,2022/07/20,127,77,76,18,0,298
balenalib/intel-nuc-debian-node,20231106,2023/11/06,117,31,32,4,0,184
vmware/lightwave-sts,1.3.1,2017/10/26,34,188,247,119,0,588
grafana/loki,2.9.2,2023/10/25,0,4,3,0,0,7
airbyte/destination-local-json,0.2.11,2022/07/12,77,80,63,19,0,239
objectscale/pravega-operator,0.5.7-309-5fc87406,2023/07/20,2,20,22,0,0,44
intel/intel-ethernet-operator-daemon,v1.0.0,2023/07/26,30,42,7,0,0,79
sysdig/agent-kmodule,12.17.1,2023/10/24,155,38,0,0,0,193
rancher/rio-website,build,2018/08/09,55,31,59,15,9,169
airbyte/source-google-sheets,0.3.11,2023/10/15,65,28,7,1,0,101
docker/transfused,8599be9b5485e04530a593e23095a4726f67970b,2017/07/04,null
appdynamics/dotnet-agent,20.6.0-micro,2020/07/20,0,4,3,2,0,9
rancher/mirrored-flannelcni-flannel-cni-plugin,v1.2.0,2022/12/05,null
solace/pubsubplus-prometheus-exporter,1.0.1,2023/11/10,16,15,0,0,0,31
grafana/metaconvert,2.10.4,2023/11/13,0,3,2,0,0,5
airbyte/source-zenefits,0.2.0,2023/10/31,0,15,24,1,0,40
airbyte/destination-mariadb-columnstore,0.1.7,2022/09/09,81,101,107,34,0,323
intel/esp-core,v3.1.4,2023/08/23,null
intel/intel-qat-initcontainer,0.28.0,2023/09/22,null
airbyte/source-azure-blob-storage,0.2.3,2023/11/13,132,47,12,2,0,193
rancher/secrets-flexvol,855c1d5,2016/09/15,97,122,23,0,0,242
rancher/mirrored-istio-sidecar_injector,1.5.9,2020/08/07,405,1085,142,0,0,1632
kasmweb/core-alpine-318,1.14.0,2023/09/09,4,35,28,2,9,78
grafana/fluent-plugin-loki,2.9.2-amd64,2023/10/25,201,313,251,35,7,807
percona/percona-backup-mongodb,2.3.0,2023/11/02,75,31,3,0,0,109
docker/demo,v1.2.2,2018/10/02,0,0,0,2,0,2
onlyoffice/4testing-appserver-backup-background,test-2022081607,2022/08/16,1045,346,362,25,1,1779
balenalib/asus-tinker-board-alpine,20231106,2023/11/07,0,6,2,0,0,8
rapidfort/mongodb,7.0.2,2023/10/20,35,18,9,2,0,64
objectscale/postgres-operator-upgrade,ubi8-5.1.2-0,2022/07/05,71,89,16,0,0,176
balenalib/jetson-tx1-fedora-openjdk,8-20230530,2023/06/08,null
greenbone/openvas-smb-build,v22.5.4,2023/10/17,250,73,35,2,0,360
circleci/buildpack-deps,21.04,2021/02/20,38,488,26,0,0,552
kong/kumactl,2.4.4,2023/11/06,7,3,3,0,0,13
intel/envoy,1.19.0-intel.0,2023/11/13,17,4,0,0,0,21
rancher/hardened-etcd,v3.5.9-k3s1-build20231009-s390x,2023/10/10,2,16,18,0,5,41
datadog/dd-lib-ruby-init,v1.16.2,2023/11/10,0,2,2,0,0,4
airbyte/postgres-singer-source-abprotocol,0.1.0,2020/10/20,586,419,394,43,12,1454
bellsoft/buildpacks.alpaquita-base,musl,2023/04/04,null
docker/ucp-hrm-s390x,2.2.22,2019/10/07,2,11,9,1,0,23
bitnami/natscli,0.1.1,2023/12/07,77,18,11,2,0,108
rancher/cluster-proportional-autoscaler-amd64,1.3.0,2018/10/01,null
kasmweb/core-parrotos-5,1.14.0,2023/09/09,null
balenalib/raspberrypi3-debian,20230911,2023/09/11,121,45,42,6,0,214
docker/scout-cli,8832496,2023/09/05,0,7,4,0,0,11
balenalib/ts4900-ubuntu,20220714,2022/08/02,87,91,11,0,0,189
airbyte/destination-bigquery-denormalized,2.0.0,2023/07/15,29,180,235,21,0,465
balenalib/artik710-alpine-openjdk,8-20230904,2023/09/09,8,14,6,2,0,30
okteto/gitlab,0.1,2020/03/19,15,65,73,9,0,162
airbyte/source-declarative-manifest,0.53.6,2023/11/14,0,3,3,0,0,6
vmware/lightwave-toolchain-photon2,1.0.4,2019/10/09,57,329,393,123,0,902
bitnami/user-broker-archived,0.3.1,2022/01/16,129,90,91,23,7,340
rancher/mirrored-longhornio-csi-node-driver-registrar,v2.7.0,2022/12/28,0,3,3,0,0,6
balenalib/amd64-debian,20231106,2023/11/06,110,29,22,4,0,165
balenalib/amd64-alpine,20231106,2023/11/07,0,6,2,0,0,8
atlassian/crucible,4.8.13,2023/12/17,129,155,27,6,0,317
balenalib/beaglebone-green-ubuntu-node,20230911,2023/09/12,43,20,5,0,0,68
rancher/k8s-dns-dnsmasq-nanny,1.15.10,2020/03/05,16,17,19,8,1,61
balenalib/artik5-debian-openjdk,20220714,2022/07/22,160,136,87,18,0,401
balenalib/apalis-imx6q-alpine-openjdk,8-3.14-20220112,2022/01/19,2,50,42,13,0,107
rancher/hardened-runc,v1.0.0-rc92,2020/09/24,256,409,18,3,0,686
rancher/harvester-network-webhook,v0.3.5,2023/12/07,1,4,4,0,0,9
airbyte/source-mysql-strict-encrypt,3.1.5,2023/11/01,7,43,61,17,0,128
redislabs/k8s-controller,7.2.4-7,2023/09/19,65,34,4,0,0,103
objectscale/csi-baremetal-halmgr,0.69.0,2021/03/07,7,80,98,5,2,192
balenalib/asus-tinker-board-s-node,20230911,2023/09/12,121,47,43,6,0,217
airbyte/source-greenhouse,0.4.3,2023/09/27,65,29,7,1,0,102
bitnami/metallb-speaker,0.13.12,2023/12/07,77,16,7,2,0,102
rancher/thanos,v0.10.1,2020/01/24,2,14,16,0,0,32
balenalib/orangepi-plus2-fedora-python,20221109,2022/11/16,0,1,0,0,0,1
docker/pipeline_unpacker,0.2.0-alpha,2017/04/04,0,1,5,2,0,8
continuumio/anaconda3,2023.09-0,2023/09/29,128,75,79,11,2,295
onlyoffice/4testing-appserver-doceditor,test-2022081607,2022/08/16,1001,373,500,46,8,1928
appdynamics/ad-nite-nodejs-services,2019-03-13-1552509464,2019/03/13,88,105,206,45,12,456
intel/tadk-waf,v23.03.0,2023/05/25,86,112,40,0,0,238
rancher/longhorn-orc,1135b84,2017/04/12,251,343,20,0,0,614
objectscale/manager-pre-update,0.60.0,2020/12/12,0,7,10,0,0,17
pingidentity/pingdataconsole,2310,2023/11/01,1,8,7,3,0,19
balenalib/artik710-fedora-openjdk,8-20230530,2023/06/08,null
rancher/mirrored-jaegertracing-all-in-one,1.49.0,2023/09/07,0,5,4,0,0,9
nginxinc/mra-fakes3,1.2.1,2018/01/16,0,9,24,7,0,40
airbyte/source-coinmarketcap,0.1.1,2022/11/01,0,19,25,1,0,45
bitnami/elasticsearch-curator-archived,5.8.4,2022/07/03,114,80,64,16,0,274
rapidfort/couchdb-official,3.2.3,2023/12/19,23,7,1,1,0,32
bitnami/concourse,7.11.0,2023/12/15,94,34,18,4,0,150
kong/kuma-prometheus-sd,1.9.8,2023/07/28,0,15,13,0,0,28
pachyderm/nvidia_driver_install,1870632b4853800ea8f4b0756c2033cab93e60f3,2017/05/10,0,1,5,2,0,8
atlassian/escalator,v1.13.2,2023/07/13,0,8,2,0,0,10
balenalib/rpi-python,20231106,2023/11/07,110,44,30,4,0,188
docker/for-desktop-kernel-grpcfuse,05437be5d71eb91706b1073d42b9a24851c6f6ff,2021/11/15,null
okteto/falco-renovator,0.5,2021/06/17,199,168,240,51,17,675
balenalib/beaglebone-black-debian-node,20230911,2023/09/12,121,47,43,6,0,217
rancher/storage-ebs,v0.9.8,2019/10/02,192,249,16,2,0,459
balenalib/am571x-evm,20220714,2022/07/20,127,77,76,18,0,298
grafana/doc-validator,7770886,1970/01/01,0,6,8,0,0,14
objectscale/objectscale-service-tools,2.71.3,2021/04/14,18,136,169,6,7,336
docker/dtr-garant-s390x,2.5.0-beta3,2018/01/17,0,16,41,34,0,91
airbyte/tool-link-checker,0.1.0,2020/11/03,3,19,45,8,0,75
couchbase/operator-backup,6.6.0-102,2021/02/09,13,11,7,0,0,31
newrelic/k8s-metadata-injection,1.22.0,2023/11/13,0,2,2,0,0,4
objectscale/objectscale-insideiq,1.4.0-397.adb0726,2023/11/13,0,5,4,0,0,9
redhat/ubi9-micro,9.3-6,2023/11/01,3,2,0,0,0,5
datadog/ci,v2.23.1,2023/11/10,0,4,2,0,0,6
purestorage/realtime-metrics,1.0.21,2023/11/13,0,2,0,0,0,2
balenalib/generic-armv7ahf-alpine-golang,20230904,2023/09/09,2,6,5,2,0,15
balenalib/orangepi-plus2-python,20230911,2023/09/11,121,46,42,6,0,215
onlyoffice/docspace-urlshortener,test,2022/09/08,997,372,504,47,8,1928
rancher/mirrored-k8scsi-csi-provisioner,v2.1.0,2020/12/18,0,6,13,0,5,24
ubuntu/grafana,10.0.3-22.04,2023/12/01,16,10,5,0,0,31
balenalib/jetson-tx2-fedora-openjdk,8-20231106,2023/11/06,null
airbyte/destination-chroma,0.0.5,2023/10/27,65,14,7,4,0,90
google/dart-hello,2.16-beta,2021/12/13,187,114,125,39,12,477
grafana/drone-git,2023-01-12-windows-amd64,2019/08/06,0,5,4,2,0,11
airbyte/source-plaid,0.4.0,2023/08/17,0,17,24,1,0,42
airbyte/config,0.39.0-alpha,2022/05/11,0,6,8,1,0,15
rancher/longhornio-longhorn-share-manager,v1_20220808-s390x,2022/08/08,7,59,37,3,14,120
rancher/shell,v0.1.22,2023/10/20,0,26,20,0,5,51
rancher/coredns-coredns,1.8.3,2021/02/24,1,7,11,0,0,19
graphcore/pytorch,3.3.0,2023/07/03,139,202,27,0,0,368
datadog/cluster-agent-dev,1.0.1,2018/11/14,null
balenalib/beaglebone-black-alpine,20231106,2023/11/07,0,6,2,0,0,8
balenalib/kitra710-fedora-node,20230712,2023/07/16,0,1,1,0,0,2
airbyte/source-openweather,0.2.0,2023/08/31,0,17,24,1,0,42
balenalib/raspberry-pi2-debian-python,20230911,2023/09/12,121,46,42,6,0,215
pachyderm/imap_spout,1.11,2020/09/03,1474,1467,1085,154,40,4220
bitnami/acmesolver,1.13.2,2023/12/06,77,16,7,2,0,102
vmware/vke-mutentca-plugin-toolchain-photon2,1.0.2,2018/12/13,62,353,460,153,0,1028
balenalib/stem-x86-32-alpine-golang,20221109,2022/11/17,6,36,33,11,0,86
mirantis/ucp-rethinkdb-exporter,3.7.1,2023/09/26,2,8,6,2,0,18
balenalib/artik710,20230904,2023/09/09,121,45,42,6,0,214
balenalib/artik10-fedora-openjdk,8-20220224,2022/03/05,null
couchbase/service-broker,1.2.1,2022/04/09,0,3,5,0,0,8
balenalib/kitra710-alpine,20230904,2023/09/09,2,6,5,2,0,15
bellsoft/buildpacks.builder,musl,1980/01/01,2,32,14,0,0,48
rancher/system-agent-installer-rke2,v1.28.3-rke2r2-windows-1809-amd64,2023/11/08,null
rancher/heapster-amd64,v1.6.0-beta.1,2018/08/06,null
rancher/mirrored-prom-node-exporter,v1.0.1,2020/06/16,0,6,10,0,0,16
rancher/openpolicyagent-gatekeeper,v3.3.0,2021/01/28,0,8,14,0,4,26
docker/dockerfile-copy,v0.1.9,2018/10/31,null
okteto/docker-proxy,0.1.1,2019/08/27,2,27,10,5,0,44
airbyte/source-rss,0.1.0,2022/11/10,0,17,17,0,0,34
balenalib/generic-armv7ahf-openjdk,20230904,2023/09/09,132,73,46,6,0,257
rancher/coreos-prometheus-config-reloader,v0.43.0,2020/10/27,0,1,1,0,0,2
datadog/dev-dd-agent,5202rc1,2017/12/05,50,127,106,41,20,344
sysdig/agent-kmodule-thin,12.17.1,2023/10/24,155,38,0,0,0,193
rancher/os-xfce,v0.8.2,2017/02/23,47,67,7,0,0,121
newrelic/k8s-nri-nagios,2.6.0,2020/01/20,null
balenalib/rpi-node,16.19.1-20231106,2023/11/07,110,45,31,4,0,190
rancher/goharbor-harbor-registryctl,v1.7.5,2019/04/01,14,63,88,37,0,202
grafana/agent-build-image,0.30.3,2023/10/16,809,281,205,14,2,1311
atlassian/pipelines-awscli,1.29.35,2023/08/28,1,6,2,1,0,10
hashicorp/boundary-enterprise,0.14.2-ent,2023/10/31,0,9,0,0,0,9
docker/ucp-calico-cni-s390x,3.1.0-beta3,2018/10/04,null
rancher/library-nginx,1.19.2-alpine-s390x,2020/08/14,10,32,60,7,0,109
jetbrains/teamcity-minimal-agent,2023.05.4,2023/09/19,32,79,84,9,0,204
objectscale/logging-injector,3.9.0.0-1588.729cf194,2023/04/25,4,38,33,0,0,75
rancher/cert-manager-controller,v0.11.0-rio.1,2019/10/22,0,0,0,0,6,6
rancher/harvester-support-bundle-utils,master-head,2021/05/28,4,25,39,8,0,76
rapidfort/fluentd,1.16.2,2023/11/15,31,10,2,1,0,44
bitnami/owncloud-archived,10.11.0,2022/12/22,156,210,105,10,0,481
airbyte/source-gnews,0.1.3,2023/01/17,0,18,25,1,0,44
airbyte/source-serpstat,0.1.0,2023/08/22,0,17,24,1,0,42
circleci/redis,7.0-rc1,2022/02/22,74,35,37,15,0,161
intel/intel-extension-for-pytorch,2.1.0-pip-mulitnode,2023/10/23,124,159,5,0,0,288
airbyte/destination-kafka,0.1.10,2022/08/04,77,83,65,19,0,244
pachyderm/seldon-pachyderm-rsi-trainer,0.1.2,2021/02/10,101,74,81,31,8,295
bitnami/ejbca,8.0.20230531,2023/09/23,82,67,56,14,0,219
purestorage/ccm-go,1.2.0,2023/11/14,0,3,2,0,0,5
balenalib/i386-debian,20231106,2023/11/06,110,29,22,4,0,165
kasmweb/unityhub,1.14.0,2023/09/14,219,444,3,0,0,666
balenalib/i386-nlp-golang,1.11.13-20200529,2021/04/12,655,414,359,54,10,1492
bitnami/fluxcd-notification-controller,1.1.0,2023/11/08,77,20,10,2,0,109
airbyte/source-insightly,0.2.0,2023/11/14,0,15,24,1,0,40
kasmweb/ubuntu-bionic-dind,develop-rolling,2022/03/18,272,879,21,0,0,1172
pachyderm/example-spout101,2.0.2,2023/02/17,803,629,362,26,2,1822
vmware/restreview-appserver,V2,2017/12/31,221,865,632,149,57,1924
airbyte/source-sonar-cloud,0.1.1,2023/02/27,0,18,25,1,0,44
balenalib/artik10-alpine-openjdk,8-jre-20220803,2022/08/04,31,90,43,10,0,174
rancher/minio-minio,RELEASE.2020-07-13T18-09-56Z,2020/07/13,11,36,74,8,0,129
grafana/snyk_exporter,v1.12,2023/02/06,0,1,1,0,0,2
balenalib/i386-debian-golang,20231106,2023/11/06,439,95,56,6,0,596
newrelic/es-operator,dev,2019/04/03,4,14,8,2,0,28
mirantis/ucp-secureoverlay-agent,3.7.1,2023/09/26,2,8,6,2,0,18
rancher/os-console,3929481,2017/02/09,null
intel/ctk_loadkey,v2.4,2023/10/15,37,28,0,0,0,65
objectscale/crunchy-pgadmin4,ubi8-4.30-2,2022/07/05,278,250,50,0,0,578
bitnami/java,21.37.0,2023/10/01,195,106,55,8,0,364
bitnami/multus-cni,4.0.2,2023/12/07,77,25,13,2,0,117
kasmweb/core-alpine-317,1.14.0,2023/09/09,8,67,38,11,2,126
rancher/confd-base,v0.1.0,2015/09/15,null
continuumio/anaconda2,2019.10,2019/10/15,216,257,330,72,13,888
google/apigee-mint-task-scheduler,1.10.0,2023/05/09,5,17,12,0,5,39
balenalib/colibri-imx6dl-ubuntu-node,20220715,2022/07/19,88,113,12,0,0,213
lacework/perf-test,lw-jmeter-docker,2022/11/18,475,917,92,3,0,1487
balenalib/beaglebone-black-ubuntu-golang,20230530,2023/07/02,175,181,38,0,0,394
balenalib/i386-nlp-ubuntu-node,6.17.1-20190503,2021/04/10,109,240,49,2,0,400
objectscale/crunchy-pgbouncer,ubi8-1.16-4,2022/07/05,255,178,40,0,0,473
intel/oneapi-dlfdkit,2023.1.0-devel-ubuntu22.04,2023/04/03,224,297,47,0,0,568
airbyte/source-clickhouse,0.1.17,2023/03/22,25,175,193,6,0,399
docker/ucp-metrics,3.3.1,2020/06/26,2,8,9,1,0,20
balenalib/asus-tinker-board-fedora-openjdk,30-20210825,2021/09/03,null
balenalib/via-vab820-quad-alpine-openjdk,8-3.14-20220112,2022/01/19,2,50,42,13,0,107
onlyoffice/4testing-docs-docservice,lt,2020/11/26,544,498,32,3,0,1077
rancher/istio-coredns-plugin,0.2-istio-1.1,2019/03/06,331,452,37,0,0,820
grafana/enterprise-metrics,v2.10.4,2023/11/14,0,4,2,0,0,6
rancher/mirrored-sig-storage-csi-provisioner,v3.6.2,2023/11/09,null
appdynamics/infraagent-cnao,23.10.0-4872-ecs-amd64,2023/10/20,0,4,1,0,0,5
balenalib/apalis-imx6q-fedora-python,20220622,2022/07/12,0,1,1,0,0,2
rancher/mirrored-sig-storage-livenessprobe,v2.11.0,2023/09/13,0,2,2,0,0,4
rancher/kubernetes-auth,v0.0.8,2017/08/17,312,392,24,0,0,728
mirantis/ucp-blackbox-exporter,3.7.1,2023/09/26,2,10,5,2,0,19
google/drone-firebase,0.1,2016/07/01,26,170,155,42,0,393
balena/balena-base-ui,10.0.1,2023/09/11,424,239,169,17,6,855
grafana/enterprise-logs-boringcrypto,v1.8.4,2023/10/18,0,5,3,0,0,8
docker/ucp-etcd-s390x,3.1.0-beta3,2018/10/04,0,2,6,16,0,24
hashicorp/counting-service,0.0.2,2018/11/14,0,0,0,2,0,2
pachyderm/pachctl-amd64,97276071e371d5b1ea221437e99cfd87b5599ddf,2023/11/03,92,27,32,2,1,154
rapidfort/consul-ib,1.14.9,2023/08/27,29,22,6,0,0,57
bitnami/jmx-exporter,0.20.0,2023/12/10,75,15,7,2,0,99
amazon/amazon-lightsail,hello-world,2020/11/19,23,404,324,25,0,776
balenalib/qemux86-64-ubuntu-openjdk,11-xenial-20230911,2023/09/11,null
bitnami/minio,2023.11.11,2023/11/11,87,24,14,4,0,129
pachyderm/tf_job_s3_gateway_minio,1.9.2,2019/07/31,462,741,176,18,0,1397
solace/solace-pubsub-connector-gcppubsub,1.1.0,2023/09/27,75,56,9,1,0,141
balenalib/i386-ubuntu-node,12.16.3-20200518,2020/05/29,162,255,34,3,0,454
balenalib/beaglebone-green-ubuntu-golang,20230911,2023/09/12,143,152,23,0,0,318
grafana/automatic-aliases,7770886,1970/01/01,0,2,2,0,0,4
ubuntu/memcached,1.6-23.10_edge,2023/12/11,10,1,0,0,0,11
rancher/istio-proxyv2,1.8.3,2021/02/05,302,919,127,2,0,1350
kasmweb/slack,1.10.0,2021/11/16,308,898,21,0,0,1227
balenalib/stem-x86-32-alpine-openjdk,8-20230712,2023/08/01,10,22,7,2,0,41
airbyte/destination-snowflake-bulk,3.2.3-dev.cc832795bb,2023/11/14,9,48,63,17,0,137
kasmweb/super-tux-kart,1.14.0,2023/09/14,217,443,0,0,0,660
pachyderm/config-pod,0.6,2022/02/10,0,7,10,0,0,17
onlyoffice/ffvideo,6.0,2023/04/13,37,12,0,0,0,49
intel/intel-dlb-plugin,0.28.0,2023/09/22,null
objectscale/objectscale-telemetry,vinod,2020/08/12,0,8,11,0,0,19
airbyte/source-pivotal-tracker,0.1.1,2023/10/25,0,15,24,1,0,40
airbyte/source-webflow,0.1.2,2022/07/14,0,20,25,1,0,46
appdynamics/appdynamics-cloud-otel-collector,23.10.0-1163,2023/10/19,0,3,2,0,0,5
hashicorp/consul-dataplane-fips,1.3,2023/12/15,26,28,5,0,0,59
balenalib/raspberrypi3-ubuntu-golang,20231026,2023/11/02,135,137,1,0,0,273
bitnami/harbor-notary-signer,2.8.4,2023/09/15,86,196,228,2,0,512
intel/reconfigurable-ri-viewer,4.0,2022/12/21,56,55,96,23,10,240
rancher/mirrored-calico-node,v3.26.3,2023/10/06,32,7,3,0,0,42
objectscale/csi-baremetal-node,0.69.0,2021/03/07,99,179,30,0,0,308
balenalib/hummingboard-debian,20230904,2023/09/09,121,45,42,6,0,214
appdynamics/machine-agent,23.10.0,2023/10/30,133,34,8,1,0,176
docker/dev-environments-javascript,639923ad2c5ce6f29a24ca8d11c8f38f9206c462,2021/06/21,1117,757,882,90,29,2875
balenalib/armv7hf-python,20230929,2023/10/02,114,46,34,6,0,200
airbyte/source-zuora,0.1.3,2021/10/22,0,21,50,8,0,79
balena/open-balena-base,16.0.13,2023/11/02,362,108,64,6,6,546
airbyte/source-google-drive,0.0.2,2023/11/14,132,47,12,2,0,193
cimg/python,3.12.0,2023/12/05,316,370,44,0,0,730
airbyte/destination-azure-blob-storage,0.2.1,2023/09/21,10,57,86,17,0,170
airbyte/cloud-workers,no-check-3,2023/11/15,20,74,62,2,0,158
graphcore/tensorflow-minimal,2-intel-3.3.0-ubuntu-20.04-20230703,2023/07/03,134,287,50,1,0,472
intel/intelligent_traffic_management_cloud_connector_dev,2.0,2022/12/06,61,102,13,0,0,176
balenalib/via-vab820-quad-openjdk,20210602,2021/06/05,222,249,144,39,9,663
intel/intel-fpga-initcontainer,0.28.0,2023/09/22,null
balenalib/apalis-imx6q-debian-openjdk,20210602,2021/06/05,222,249,144,39,9,663
kong/cloudtrail-integration,1.0.0,2023/02/06,1,98,62,1,0,162
kasmweb/ubuntu-focal-dind,1.14.0,2023/09/14,249,559,2,0,0,810
redislabs/operator,804_c4987427,2019/06/05,null
bitnami/redis,7.2.3,2023/12/09,78,17,7,2,0,104
vmware/photon-controller-ui,1.0.0,2016/11/08,80,215,219,104,23,641
purestorage/telemetry-envoy,1.1.10,2023/11/14,0,4,1,0,0,5
rancher/agent-instance,v0.8.3,2016/06/14,419,519,58,1,0,997
okteto/godev,1,2021/07/05,693,462,420,64,12,1651
airbyte/temporal-auto-setup,1.13.0,2021/10/20,4,56,162,5,0,227
docker/engine-community,18.09.9,2019/09/04,null
rancher/mirrored-prometheus-node-exporter,v1.3.1,2021/12/05,0,5,8,0,0,13
apachepinot/pinot,1.0.0,2023/10/15,46,62,104,25,0,237
balenalib/qemux86-64-fedora-node,20231103,2023/11/04,0,1,1,0,0,2
balenalib/ts4900-fedora,20220604,2022/06/12,null
rancher/hello-world,v0.1.2,2018/06/29,0,4,8,22,0,34
kasmweb/alpine-318-desktop,1.14.0,2023/09/14,10,97,89,13,9,218
balena/aarch64-supervisor,1299,2020/07/31,6,26,55,9,0,96
balenalib/armv7hf-alpine,20231106,2023/11/07,0,6,2,0,0,8
airbyte/destination-teradata,0.1.3,2023/09/25,9,51,84,17,0,161
rancher/opni-kibana-dashboard,v0.1.3,2021/09/14,0,2,25,4,0,31
lacework/k8scollector,6.10.0,2023/11/10,64,20,0,0,0,84
bitnami/couchdb,3.3.2,2023/11/15,87,22,14,4,0,127
airbyte/source-zendesk-support,20211125-1,2021/11/25,0,21,50,8,0,79
astronomerinc/ap-statsd-exporter,0.24.0,2023/09/25,0,3,1,0,0,4
balenalib/up-board-ubuntu,20230911,2023/09/11,42,19,4,0,0,65
airbyte/source-recreation,0.1.0,2022/11/17,0,19,25,1,0,45
mirantis/terratrain,tt-54,2023/05/30,64,139,145,6,0,354
airbyte/source-mongodb,0.3.3,2021/07/20,0,14,46,5,0,65
airbyte/destination-weaviate,0.2.9,2023/11/13,65,29,10,4,0,108
airbyte/source-redshift,0.4.0,2023/06/29,25,173,202,9,0,409
greenbone/gsa,22.9,2023/11/24,97,23,16,2,0,138
continuumio/conda_builder_linux,5.11-5.2-1-4,2016/12/02,0,4,7,4,0,15
solaceiotteam/apim-connector-server,0.10.1,2023/05/09,775,486,319,25,2,1607
redhat/ubi8-micro,8.8-7,2023/09/13,21,12,3,0,0,36
datadog/cluster-agent,7.50.0-rc.2,2023/11/14,12,9,1,0,0,22
graphcore/tensorflow-paperspace,3.3.0,2023/07/03,246,474,51,1,0,772
balenalib/aarch64-python,20231106,2023/11/07,110,30,22,4,0,166
rancher/rancher-runtime,v2.7.1,2023/01/24,12,77,82,3,0,174
airbyte/airbyte-postgres-destination-abprotocol,0.1.0,2020/10/20,98,81,83,24,7,293
balenalib/asus-tinker-board-ubuntu,20231026,2023/11/02,37,18,0,0,0,55
pachyderm/mnist_klflow_example,1.9.3,2019/08/27,753,1086,170,9,0,2018
objectscale/statefuldaemonset-operator,3.9.0.0-1588.729cf194,2023/04/25,4,38,36,0,0,78
airbyte/init,0.50.34,2023/11/09,null
balenalib/artik710-ubuntu-golang,20230904,2023/09/09,149,152,23,0,0,324
pachyderm/script_to_pipeline,v0.1.0,2022/04/13,829,982,743,96,5,2655
rancher/k3c,v0.3.0-alpha.0,2021/01/22,3,13,15,0,0,31
grafana/grafana,9799770991,2023/03/02,0,14,9,0,0,23
vmware/restreview-ui,V2,2018/01/08,57,179,187,66,22,511
rancher/hardened-crictl,v1.19.0,2020/09/25,259,425,36,3,0,723
rancher/rancher-ecr-credentials-windows,v3.0.0,2018/03/08,null
kong/kuma-cni,2.4.4,2023/11/06,7,3,3,0,0,13
rancher/mirrored-amazon-aws-cli,2.9.14,2023/01/11,26,82,117,2,0,227
kasmweb/vlc,1.14.0,2023/09/14,247,546,0,0,0,793
airbyte/source-whisky-hunter,0.1.0,2022/10/21,0,19,25,1,0,45
kasmweb/core-ubuntu-focal,1.14.0,2023/09/09,217,443,0,0,0,660
grafana/test-exporter,log-span-e1ab5495e-WIP5,2019/06/28,0,0,0,2,0,2
grafana/drone-runner-docker,1.0.0,2021/04/08,3,15,14,0,0,32
bitnami/jenkins-exporter-archived,0.20171225.0,2022/03/30,134,87,83,24,7,335
mattermost/mm-te-test,9729641,2023/04/18,224,214,118,19,7,582
grafana/build-container,1.7.7,2023/09/18,938,273,203,18,8,1440
balenalib/stem-x86-32-debian-golang,20230904,2023/09/09,446,126,78,10,0,660
opensearchproject/opensearch-dashboards,2.11.0,2023/11/09,1,4,0,2,0,7
rancher/harvester-upgrade,v1.2.1,2023/10/26,0,19,19,0,1,39
balenalib/zynq-xz702-alpine,20220714,2022/07/19,7,43,33,10,0,93
datadog/dogstatsd-socat-proxy,beta,2017/07/03,0,19,15,6,0,40
grafana/openshift-cloud-log-forwarder-bundle,v1.0.2,2022/03/08,null
airbyte/source-railz,0.1.1,2023/02/23,0,18,25,1,0,44
balenalib/armv7hf-node,20230929,2023/10/02,114,47,35,6,0,202
datadog/dd-trace-java-docker-build,17,2023/02/06,458,765,68,0,0,1291
docker/labs-debug-tools-kubeservice,dev,2023/09/14,13,44,22,4,0,83
mattermost/ops-tool-daily,v0.0.10,2022/06/27,4,27,6,0,0,37
astronomerinc/ap-keda-metrics-apiserver,2.3.0,2021/06/30,0,6,12,1,5,24
cockroachdb/ccloud-builder,20220523-223313,2022/05/23,398,951,66,0,0,1415
balenalib/parallella-ubuntu-python,20230904,2023/09/09,42,20,4,0,0,66
nginxinc/ngx-rust-tool,1.26.0,2018/05/14,391,548,37,0,0,976
intel/language-translation,tf-2.7.0-transformer-mlperf-fp32-training,2021/12/15,318,813,73,0,0,1204
kong/jenkins,1.2.31,2023/06/05,138,58,57,10,2,265
balenalib/kitra520-openjdk,20220714,2022/07/22,160,136,87,18,0,401
balenalib/generic-aarch64-fedora-golang,20231106,2023/11/06,null
bitnami/rmq-messaging-topology-operator,1.12.1,2023/12/06,0,2,0,0,0,2
airbyte/source-iterable,0.1.30,2023/07/20,153,96,65,10,0,324
rapidfort/prometheus,2.47.1,2023/10/17,19,14,6,0,0,39
pachyderm/pachctl-arm64,97276071e371d5b1ea221437e99cfd87b5599ddf,2023/11/03,92,27,32,2,1,154
grafana/grafana-oss-dev,10.3.0-146415,2023/11/15,0,8,2,0,0,10
balenalib/stem-x86-32-alpine-python,20230712,2023/07/25,2,13,6,2,0,23
bitnami/gradle,8.4.0,2023/11/15,87,24,16,4,0,131
solaceiotteam/platform-api-server,0.0.12,2021/04/12,226,405,425,91,8,1155
bitnami/debian-base-buildpack,stretch-r4,2022/01/11,108,101,147,20,3,379
balena/balena-rethinkdb,0.0.3,2019/01/22,139,286,204,38,15,682
airbyte/destination-pubsub,0.2.0,2022/12/02,24,172,205,6,0,407
pachyderm/python-evaluate,sigmoid,2018/02/19,0,26,19,10,0,55
bitnami/cert-manager,1.13.2,2023/12/06,77,18,8,2,0,105
bitnami/airflow-worker,2.7.3,2023/12/02,230,101,51,5,0,387
pachyderm/cert-manager-controller,v0.15.1,2020/05/27,0,0,0,0,6,6
balenalib/beaglebone-black-ubuntu,20231026,2023/11/02,37,18,0,0,0,55
intel/intel-extension-for-tensorflow,2.13.0.0-xpu,2023/07/31,46,44,5,0,0,95
rancher/rancher-webhook,v0.4.0,2023/10/23,0,4,8,0,0,12
bitnami/rclone,1.64.2,2023/11/09,77,18,8,2,0,105
datadog/dd-trace-php,7.4-buster-debug-asan,2019/08/26,1123,803,932,155,15,3028
amazon/aws-sam-cli-emulation-image-java8.al2,20220125,2022/01/25,3,47,16,0,0,66
rapidfort/traefik-ib,v2.10.5,2023/11/27,12,9,1,0,0,22
airbyte/normalization-mssql,0.4.3,2023/05/12,515,411,340,54,4,1324
pingidentity/pingdirectory,2310,2023/11/01,3,14,9,0,0,26
bitnami/harbor-portal,2.9.1,2023/12/15,77,16,7,2,0,102
newrelic/k8s-webhook,0.0.3,2019/09/09,6,20,12,1,0,39
airbyte/source-mailgun,0.2.1,2023/10/31,0,15,24,1,0,40
balenalib/intel-nuc-alpine-node,20231106,2023/11/07,0,7,3,0,0,10
vmware/chartmuseum-photon,dev,2018/08/10,8,70,104,51,0,233
onlyoffice/docspace-telegram-service,test,2022/09/08,1045,346,362,23,1,1777
mattermost/pillar,test,2021/03/02,2,19,39,5,0,65
intel/its-search-image-by-image,master-ae213cd97d6931b1d44fc7689867cf5701e0f15d,2023/09/23,71,37,23,5,0,136
balenalib/bananapi-m1-plus-alpine,20231106,2023/11/07,0,6,2,0,0,8
rancher/mirrored-appscode-kubed,v0.13.2,2023/01/11,0,6,10,1,0,17
cockroachdb/bazel,20231114-194628,2023/11/14,171,200,6,0,0,377
balenalib/armv7hf-alpine-openjdk,8-20231106,2023/11/07,0,6,2,0,0,8
balenalib/beaglebone-green-wifi-python,20230911,2023/09/12,121,46,42,6,0,215
balenalib/artik10-debian-node,20220714,2022/07/20,127,79,77,18,0,301
snyk/snyk-pipe,1.0.0,2023/09/15,489,334,121,16,2,962
kong/ubi-kuma-dp,2.4.4,2023/11/06,28,38,10,0,0,76
airbyte/destination-pulsar,0.1.3,2022/08/05,78,94,72,19,0,263
airbyte/source-exchange-rates,1.3.0,2023/08/25,0,17,24,1,0,42
continuumio/concourse-rsync-resource,master,2023/07/13,0,8,2,0,0,10
hashicorp/consul-enterprise,1.10.4,2021/11/11,3,30,45,3,0,81
ubuntu/dotnet-aspnet,7.0_beta,2023/11/01,null
docker/labs-debug-tools-service,0.0.44,2023/11/14,13,44,20,4,0,81
bitnami/symfony,6.3.8,2023/11/10,154,92,59,4,0,309
newrelic/cli,v0.76.3,2023/11/15,0,4,3,0,0,7
grafana/plugin-build-report-service,0.0.6,2022/03/23,2,25,49,6,0,82
rancher/coreos-flannel,v0.12.0,2020/03/13,5,15,16,3,0,39
rancher/pipeline-tools,v0.1.16,2021/06/28,6,31,72,19,0,128
couchbase/server-sandbox,7.2.3,2023/11/10,21,6,0,0,0,27
intel/intel-dsa-plugin,0.28.0,2023/09/22,null
netdata/package-builders,ubuntu23.10-v1,2023/12/20,79,60,1,0,0,140
redhat/ubi9,9.3-1361,2023/11/01,128,42,2,0,0,172
airbyte/source-shopify-oauth,0.1.0,2023/07/20,0,17,25,1,0,43
rancher/cert-manager-webhook,v0.11.0-rio.1,2019/10/22,0,0,0,0,6,6
intel/intel-xpumanager-sidecar,0.28.0,2023/09/22,null
bitnami/clickhouse,23.10.3,2023/11/11,78,19,8,2,0,107
mattermost/notice-file-generator,v0.0.5,2023/04/12,0,2,4,0,0,6
rancher/alertmanager-helper,v0.0.2,2018/02/13,43,94,10,0,0,147
airbyte/normalization-snowflake,0.4.3,2023/05/12,486,394,335,50,4,1269
rapidfort/elasticsearch,8.10.3,2023/10/17,35,14,6,2,0,57
onlyoffice/docs-example,7.5.1-1,2023/11/09,1067,353,213,8,3,1644
rancher/longhornio-csi-attacher,v3.4.0,2021/12/21,0,4,7,0,0,11
jetbrains/correttowrapper,17.0.5,2023/01/06,29,102,129,2,0,262
rancher/prometheus-federator,v0.3.4,2023/07/13,0,8,5,0,1,14
airbyte/source-tplcentral,0.1.1,2022/11/29,0,19,25,1,0,45
greenbone/data-objects,202311150504,2023/11/15,null
airbyte/source-typeform,1.1.2,2023/10/27,65,28,7,1,0,101
google/apigee-fluent-bit,1.9.9,2022/09/28,27,32,21,2,0,82
lacework/lacework-proxy-scanner,0.23.2,2023/11/10,0,4,9,0,0,13
redislabs/redis-connect-gemfire,0.5.0-139,2022/01/22,3,30,34,12,0,79
datadog/dogstatsd-dev,7.46.0-devel.git.33.79ca82b.pipeline.15281127,2023/04/26,0,12,2,0,0,14
intel/generative-ai,tf-flex-gpu-stable-diffusion-inference,2023/08/31,46,44,7,0,0,97
pachyderm/pachd-arm64,97276071e371d5b1ea221437e99cfd87b5599ddf,2023/11/03,0,8,4,0,0,12
balenalib/orangepi-plus2-alpine-golang,20231106,2023/11/07,0,6,2,0,0,8
intel/intelligent_traffic_management_dashboard,2.0,2022/11/15,62,103,15,0,0,180
intel/intelligent_traffic_management_rule_engine,2.0,2022/11/09,61,98,12,0,0,171
grafana/cortex-grafanacloud,v0.6.0,2020/07/23,6,38,51,4,0,99
airbyte/destination-cumulio,0.1.0,2023/04/20,828,964,712,82,3,2589
jetbrains/qodana-dotnet,2023.2,2023/12/01,146,74,111,15,0,346
pachyderm/estimate-pi-spark,0.3,2018/07/20,122,447,591,257,39,1456
balenalib/artik530-ubuntu-openjdk,20210826,2021/09/21,136,435,10,0,0,581
rancher/longhorn-test,version-test.2-2.1-1.1-1,2018/06/18,58,97,13,0,0,168
airbyte/source-looker,0.2.8,2023/01/06,0,18,25,1,0,44
vmware/postgresql-photon,v1.5.2,2018/07/18,11,70,117,36,0,234
rapidfort/postgresql-official,15.2,2023/03/01,47,28,17,1,0,93
airbyte/source-mixpanel-singer,0.2.4,2021/07/06,559,326,284,40,8,1217
balenalib/odroid-c1-alpine-openjdk,8-3.14-20220112,2022/01/19,2,50,42,13,0,107
balena/open-balena-haproxy,4.3.1,2023/06/28,2,16,6,5,0,29
balenalib/qemux86-64-alpine,20231106,2023/11/07,0,6,2,0,0,8
rancher/k3os,v0.19.5-rc.1,2021/01/05,null
grafana/docker-slack-message,9834170,2023/09/03,0,2,2,0,0,4
kong/release-script,1.28.0,2023/11/14,0,2,2,0,0,4
balenalib/colibri-imx6dl-debian-node,18.6-20220714,2022/07/21,127,79,77,18,0,301
airbyte/source-qualaroo,0.3.0,2023/10/25,0,15,24,1,0,40
kasmweb/redirector,1.0.0,2019/06/02,135,190,2,0,0,327
formio/uswds-viewer,5.3.4,2023/11/08,209,206,2,0,0,417
docker/proxyv2,1.1.2,2019/04/12,446,623,51,0,0,1120
datadog/envoy-apm-experimental,1962f1461148b4c1a6a072740b877708deeb2051,2018/10/01,54,72,12,0,0,138
grafana/alertmanager-webhook-logger,0.3,2021/07/16,0,2,1,0,0,3
grafana/agent-crow,v0.22.0,2022/01/20,91,42,56,13,7,209
rancher/coreos-flannel-cni,v0.3.0,2017/09/12,null
bitnami/prometheus-operator,0.69.1,2023/11/09,77,18,7,2,0,104
nginx/unit,1.29.1-ruby3.1,2023/02/28,780,620,357,24,2,1783
objectscale/objectscale-manager-pre-update,0.71.3,2021/04/07,2,18,22,0,0,42
rapidfort/airflow-ib,2.6.3,2023/09/20,0,1,0,0,0,1
intel/rpbs_pipeline_management_service,1.1,2023/08/30,845,1250,62,0,0,2157
vmware/tern,testimage,2020/02/08,null
balenalib/artik530-alpine-openjdk,8-jre-20220803,2022/08/04,31,90,43,10,0,174
kong/pulp-resource-manager,1.1.38,2022/08/24,4,14,10,4,0,32
bitnami/harbor-jobservice,2.9.1,2023/12/06,87,23,13,4,0,127
atlassian/jira-performance-tests,4748205,2021/05/13,163,353,29,0,0,545
rancher/plugins-docker,18.09,2020/04/16,0,9,0,2,0,11
rancher/longhorn-ui,5528110,2017/04/13,180,740,697,228,56,1901
greenbone/gvm-libs-build,v23.3.0,2023/03/30,504,221,156,14,0,895
rancher/metadata-windows,v0.10.0,2017/12/11,null
balenalib/bananapi-m1-plus-debian-python,20230904,2023/09/09,121,46,42,6,0,215
greenbone/gsad-build,22.8,2023/11/14,484,130,81,10,0,705
rancher/os-zfs,v1.5.8,2021/02/05,1503,1941,1471,207,40,5162
rancher/istio-install-cni,1.8.3,2021/02/05,301,937,154,0,0,1392
airbyte/source-senseforce,0.1.1,2023/03/02,0,18,25,1,0,44
balenalib/jetson-tx2-fedora-python,20231106,2023/11/06,null
balenalib/artik5-alpine-python,20220803,2022/08/04,7,44,35,10,0,96
airbyte/source-stripe,4.5.3,2023/11/14,65,28,7,1,0,101
airbyte/gitx,90f68c3,2023/02/20,3,28,20,1,0,52
bitnami/jenkins,2.414.3,2023/11/02,116,29,36,7,2,190
mirantis/ucp-node-feature-discovery,3.7.1,2023/09/26,32,53,22,0,0,107
balenalib/beaglebone-green-openjdk,20230911,2023/09/11,132,73,46,6,0,257
bitnami/cosign,2.2.1,2023/11/08,77,18,7,2,0,104
appdynamics/ad-air-mysql-db,java,2021/01/15,135,81,108,27,7,358
airbyte/normalization-mysql,0.4.3,2023/05/12,486,394,335,50,4,1269
grafana/rollout-operator,v0.9.0,2023/11/14,0,2,2,0,0,4
rancher/pause-amd64,3.1,2017/12/20,null
intel/intel-optimized-tensorflow,2.9.1,2023/01/06,66,78,10,0,0,154
balenalib/imx6ul-var-dart-alpine-python,20231106,2023/11/07,0,7,2,0,0,9
ambassador/aes-eg-ext,v4.0.0-preview.2.dev.1,2023/10/27,0,1,1,0,0,2
rancher/calico-kube-controllers,v3.18.1,2021/03/10,0,10,16,0,0,26
rancher/os-udev,v0.7.1,2016/11/11,null
balenalib/raspberry-pi2-fedora,20221031,2022/11/04,null
atlassian/ssh-ubuntu,0.2.2,2019/09/16,265,386,39,0,0,690
bitnami/argo-workflow-exec,3.5.1,2023/11/08,77,18,9,2,0,106
grafana/docs-base,20231115,2023/11/15,0,19,4,3,0,26
balenalib/odroid-xu4-debian-python,20230911,2023/09/11,121,46,42,6,0,215
balenalib/intel-nuc-debian,20231106,2023/11/06,117,29,31,4,0,181
appdynamics/machine-agent-netviz,23.5.0,2023/06/30,81,184,4,0,0,269
balenalib/via-vab820-quad-fedora-openjdk,30-20210825,2021/09/03,null
balenalib/amd64-fedora,20231103,2023/11/04,null
rancher/mirrored-longhornio-csi-snapshotter,v6.2.1,2023/01/04,0,3,3,0,0,6
rapidfort/haproxy24-ib,v2.4.24,2023/12/15,8,7,0,0,0,15
dynatrace/easytravel-pluginservice,2.0.0.3599,2023/08/04,31,19,49,12,0,111
intel/intel-fpga-plugin,0.28.0,2023/09/22,null
onlyoffice/4testing-docs-proxy-de,7.5.1-1-saas,2023/11/08,16,5,1,1,0,23
google/dart-runtime-base,2.16-beta,2021/12/13,187,114,125,39,12,477
astronomerinc/ap-init,3.18.4-2,2023/11/06,0,8,0,0,0,8
rancher/os-autoformat,v0.7.1,2016/11/11,null
rancher/pipeline-docker-publish,v0.2.0,2018/07/23,0,8,3,3,0,14
rancher/cli,v2.0.4,2018/08/10,0,8,0,2,0,10
bitnami/harbor-adapter-clair-archived,2.5.1,2022/06/20,100,75,59,18,0,252
bitnami/airflow-scheduler,2.7.3,2023/11/27,221,98,44,4,0,367
vmware/photon-2.0-kube-apiserver-amd64,v1.10.2-20180619,2018/06/19,15,81,98,70,0,264
mirantis/ucp-alertmanager,3.7.1,2023/09/26,2,9,4,2,0,17
mattermost/mattermost-build-redux,20210125_node-11.3-1,2018/12/08,609,1687,1395,322,16,4029
newrelic/k8s-nri-mysql,1.4.0,2019/11/25,null
balenalib/kitra520-ubuntu-openjdk,20210826,2021/09/21,136,435,10,0,0,581
balenalib/zynq-xz702-ubuntu-golang,20220523,2022/06/03,221,534,46,0,0,801
grafana/alpine,3.15.4,2022/04/05,0,14,8,1,0,23
objectscale/csi-attacher,v1.0.1,2018/12/05,0,0,0,2,0,2
dynatrace/easytravel-nginx,7.1,2018/05/11,62,136,141,48,23,410
grafana/grafana-ci-deploy,1.3.3,2022/07/20,17,55,36,3,0,111
onlyoffice/documentserver-integration,4.4.3.7,2017/08/11,323,467,31,1,0,822
grafana/query-tee,2.10.4,2023/11/13,0,3,2,0,0,5
airbyte/source-okta,0.1.16,2023/07/07,153,96,65,10,0,324
airbyte/source-amazon-seller-partner,1.6.2,2023/11/14,65,28,7,1,0,101
objectscale/csi-node-driver-registrar,v2.5.0,2022/02/03,0,4,6,0,0,10
rancher/mirrored-prometheus-alertmanager,v0.25.0,2022/12/22,0,6,4,0,0,10
airbyte/source-smartsheets,1.1.1,2023/06/07,78,31,21,2,0,132
airbyte/source-hellobaton,0.2.0,2023/08/24,0,17,24,1,0,42
appdynamics/db-agent,23.9.0-3436,2023/09/29,0,2,3,0,0,5
bitnami/gotrue,1.0.1,2023/12/06,77,22,18,2,0,119
bitnami/matomo,4.15.1,2023/10/11,159,94,64,5,0,322
kasmweb/oracle-7-desktop,1.14.0,2023/09/14,2,15,47,0,0,64
kasmweb/core-almalinux-9,1.14.0,2023/09/09,7,118,866,0,0,991
bitnami/jax,0.4.20,2023/11/16,80,16,8,2,0,106
balenalib/artik5-alpine-node,20220803,2022/08/04,7,44,34,10,0,95
balenalib/asus-tinker-board-alpine-python,20231106,2023/11/07,0,7,2,0,0,9
balenalib/raspberrypi3-alpine-python,20231106,2023/11/07,0,7,2,0,0,9
rancher/hardened-build-base,v1.21.3b1,2023/10/13,0,13,4,0,0,17
grafana/cortex-query-frontend,w37-0193e7b7,2018/09/11,0,0,0,2,0,2
redislabs/rcp-kubectl,4719504c7e53b421448a2f2e329a9c19,2020/04/02,181,337,45,1,0,564
objectscale/crunchy-postgres,ubi8-14.4-0,2023/08/30,273,101,16,0,0,390
appdynamics/machine-agent-analytics-arm64,23.10.0,2023/10/30,97,33,8,1,0,139
datadog/agent-buildimages-circleci-runner_test_only,v23305348-a2473651,2023/11/14,119,190,3,0,0,312
balenalib/via-vab820-quad-ubuntu-python,20220622,2022/06/23,87,122,13,0,0,222
rancher/mirrored-openpolicyagent-gatekeeper-crds,v3.13.0,2023/08/08,0,2,2,0,0,4
balenalib/orbitty-tx2-alpine-node,20231106,2023/11/06,0,7,3,0,0,10
newrelic/amazon-k8s-cni,246b3c71,2019/05/25,32,399,252,23,0,706
airbyte/source-snapchat-marketing,0.3.0,2023/06/13,0,18,25,1,0,44
rapidfort/vault,1.12.0,2023/11/20,0,7,7,0,0,14
balenalib/aarch64-debian-golang,20231106,2023/11/07,439,96,56,6,0,597
balenalib/artik710-fedora-python,20230712,2023/07/16,0,1,0,0,0,1
onlyoffice/4testing-docspace-webhooks-service,test-2022112110,2022/11/21,1041,321,333,20,0,1715
docker/github-actions,v1.1.0,2020/04/22,2,10,31,4,0,47
airbyte/source-firebolt,1.0.0,2023/08/23,1,18,24,1,0,44
grafana/grafana-enterprise-arm32v7-linux,7.0.6,2020/07/09,4,32,54,9,0,99
balenalib/stem-x86-32-ubuntu-python,20210826,2021/09/22,105,174,8,0,0,287
balenalib/intel-nuc,20231106,2023/11/06,117,29,31,4,0,181
docker/telemetry-tgz,1.0.0.linux-x86_64-test,2017/08/01,null
pachyderm/seldon-pachyderm-rsi-server,0.1.2,2021/02/10,102,83,89,32,8,314
rancher/k3d-proxy,5.3,2022/02/03,8,55,79,9,0,151
onlyoffice/docs-proxy-ee,7.5.1-1,2023/11/09,16,5,1,1,0,23
rancher/mirrored-cilium-hubble-relay,v1.14.4,2023/11/13,null
dynatrace/easytravel-angular-frontend,2.0.0.3599,2023/08/04,31,32,61,17,0,141
rancher/10-openvmtools,v0.8.0-rc9,2017/02/09,3,28,2,0,0,33
dynatrace/dynatrace-gcp-monitor,v1-latest,2023/12/08,65,13,3,1,0,82
balenalib/artik5-fedora,20220714,2022/07/23,null
intel/flexran_vdu,v22.07,2022/12/07,145,288,54,0,0,487
okteto/hello-world,1.0.0,2020/03/26,2,10,29,4,0,45
balenalib/nitrogen6x-debian,20220714,2022/07/20,127,77,76,18,0,298
bitnami/kong,3.4.2,2023/10/12,164,65,43,4,0,276
google/apigee-istio-citadel,1.4.6,2020/02/22,649,1309,152,0,0,2110
balenalib/zynq-xz702-alpine-python,20220714,2022/07/19,7,44,35,10,0,96
rancher/harvester-node-manager,v0.1.8,2023/12/06,0,5,0,0,1,6
airbyte/source-file-secure,0.3.13,2023/10/13,66,33,8,2,0,109
onlyoffice/documentserver-ee-ucs,7.5.1.1,2023/11/08,113,128,4,1,0,246
balenalib/amd64-alpine-node,20231106,2023/11/07,0,7,3,0,0,10
balenalib/spacely-tx2-fedora-node,20231106,2023/11/06,0,1,1,0,0,2
portainer/volume-browser,develop,2018/07/16,null
balenalib/kitra710-alpine-openjdk,8-20230904,2023/09/09,8,14,6,2,0,30
cockroachdb/bazel-fips,20230815-175543,2023/08/15,149,221,19,0,0,389
kong/nightly-ingress-controller,2023-11-15,2023/11/15,null
balenalib/generic-aarch64-ubuntu-node,20231103,2023/11/06,38,19,1,0,0,58
onlyoffice/4testing-docspace-proxy-runtime,v1.0.0,2023/09/04,183,277,19,0,0,479
pachyderm/rrt-modeling,sort,2018/02/20,0,26,19,10,0,55
bitnami/cluster-autoscaler,1.28.0,2023/11/08,77,19,14,2,0,112
airbyte/source-pokeapi,0.2.0,2023/10/11,0,16,24,1,0,41
onlyoffice/docspace-api,1.1.4.1,2023/10/23,1024,157,214,13,0,1408
rancher/k8s-codegen,1.11,2018/11/27,310,494,31,0,0,835
bitnami/jenkins-agent,0.3192.0,2023/12/02,87,22,13,4,0,126
rancher/opdom,v0.1.0,2022/12/07,4,62,39,0,13,118
airbyte/source-cockroachdb-strict-encrypt,0.1.22,2023/03/22,25,174,193,6,0,398
okteto/crontab,0.0.6,2020/10/10,2,10,32,4,0,48
newrelic/k8s-nri-consul,2.0.3,2019/10/25,null
airbyte/source-coda,1.2.0,2023/08/25,0,17,24,1,0,42
airbyte/integration-singer-exchangeratesapi_io-source,0.1.3,2020/10/07,2,26,48,11,0,87
cockroachdb/cockroach-django-builder,20211210,2021/12/10,342,991,65,0,0,1398
vmware/vke-infra-toolchain,1.0.1,2018/09/21,17,136,210,102,0,465
balenalib/aarch64-fedora,20231106,2023/11/06,null
okteto/rails,6,2020/07/22,1391,1144,1077,121,20,3753
docker/ucp-dsinfo-s390x,3.1.0-beta3,2018/10/04,131,358,15,4,0,508
docker/kube-compose-controller,v0.5.0,2022/02/14,0,6,14,1,0,21
docker/kube-compose-installer,v0.5.0,2022/02/14,0,6,14,1,0,21
atlassian/bitbucket-mesh,2.2.0,2023/12/16,47,53,9,0,0,109
bitnami/harbor-registryctl,2.9.1,2023/12/06,77,17,7,2,0,103
docker/ucp-auth,3.3.1,2020/06/26,2,8,9,1,0,20
rancher/mirrored-cluster-proportional-autoscaler,1.8.6,2022/07/27,0,3,5,1,0,9
rancher/os-vboxtools,v5.2.26-5,2019/08/13,34,21,36,6,7,104
balenalib/apalis-imx6q-ubuntu-node,20220715,2022/07/19,88,113,12,0,0,213
balenalib/amd64-ubuntu-python,20230929,2023/10/07,39,17,4,0,0,60
bitnami/mongodb-sharded,7.0.3,2023/11/17,87,30,14,4,0,135
balenalib/artik530-ubuntu-python,20220715,2022/08/02,87,92,13,0,0,192
rancher/support-bundle-kit,v0.0.29,2023/10/30,0,8,11,0,1,20
hashicorp/envconsul,0.13.2,2023/05/22,0,13,3,3,0,19
rancher/mirrored-bci-micro,15.4.14.3,2022/09/26,0,7,4,0,2,13
docker/getting-started,vscode,2020/07/08,6,22,48,6,0,82
airbyte/source-retently,0.2.0,2023/08/08,0,17,24,1,0,42
ubuntu/prometheus,2.46.0-22.04,2023/12/12,12,14,6,0,0,32
rancher/os-openvmtools,10.3.10-2,2019/05/10,47,46,44,7,7,151
balenalib/odroid-xu4-ubuntu-python,20231026,2023/11/02,37,19,0,0,0,56
nginxinc/amplify-agent,1.8.1,2023/02/02,120,128,77,6,0,331
mattermost/backup-restore-tool,8005000,2023/03/28,0,27,13,0,0,40
puppet/tlser,1.3.2,2021/06/30,0,3,7,0,0,10
objectscale/objectscale-portal,1.4.0-337.edaba629,2023/11/14,0,6,4,0,0,10
bitnami/harbor-notary-signer-archived,2.8.4,2023/09/15,86,196,228,2,0,512
onlyoffice/4testing-ds-example-de,6.2.0-eu-r2,2021/03/04,544,498,32,3,0,1077
balenalib/fincm3-node,20230530,2023/07/02,121,47,43,6,0,217
balenalib/artik530-debian-node,20220714,2022/07/20,127,79,77,18,0,301
jetbrains/qodana-php,2023.2,2023/09/06,491,177,143,17,0,828
airbyte/source-prestashop,1.0.0,2023/06/27,153,96,65,10,0,324
balenalib/odroid-c1-debian,20220714,2022/07/20,127,77,76,18,0,298
datadog/chaos-controller,8.3.0,2023/10/26,11,5,1,0,0,17
mirantis/ucp-controller,3.7.1,2023/09/26,4,13,8,2,0,27
balenalib/asus-tinker-board-fedora-golang,20221210,2022/12/13,null
docker/ucp-hyperkube-s390x,3.1.0-beta3,2018/10/04,173,435,12,0,0,620
kasmweb/rockylinux-8-desktop,1.14.0,2023/09/14,1,74,811,0,0,886
mirantis/mysql,5.6,2018/09/19,39,51,49,11,15,165
balenalib/apalis-imx6q-node,18.6-20220714,2022/07/21,127,79,77,18,0,301
mirantis/ucp-agent,3.7.1,2023/09/26,4,13,8,2,0,27
docker/dtr-rethink,2.8.1,2020/06/17,3,10,15,1,0,29
rapidfort/telegraf,1.28.2,2023/10/17,19,7,4,0,0,30
balenalib/am571x-evm-debian,20220714,2022/07/20,127,77,76,18,0,298
mirantis/dtr-api,3.0.0-alpha.2,2021/09/22,5,34,53,5,0,97
airbyte/source-xero,0.2.3,2023/06/19,0,15,17,0,0,32
vmware/photon-2.0-pause-amd64,v1.10.2-20180619,2018/06/19,null
balenalib/i386-ubuntu-golang,1.20.1-xenial-20230911,2023/09/11,null
balenalib/spacely-tx2-alpine-openjdk,8-20231106,2023/11/06,6,12,2,0,0,20
balenalib/qemux86-64-alpine-golang,20231106,2023/11/07,0,6,2,0,0,8
rapidfort/mariadb-official,10.10.5,2023/06/09,1,4,1,0,0,6
kasmweb/almalinux-9-desktop,1.14.0,2023/09/14,7,144,910,0,0,1061
grafana/beyla,1.0.0,2023/11/14,56,11,3,1,0,71
vmware/photon-2.0-kubernetes-dashboard-amd64,v1.8.3-20180619,2018/06/19,null
intel/power-operator,v2.3.1,2023/08/28,0,3,2,0,0,5
balenalib/odroid-c1-fedora,20220604,2022/06/12,null
grafana/grafana-dev-arm64v8-linux,master-91219227-4f9f-465a-8ea0-70670344aaaa-ubuntu,2020/05/15,130,280,40,4,0,454
redislabs/ng-ci-runner,626671509cd9430c7dac72b85cd223f2,2022/08/15,518,337,293,31,3,1182
rancher/hardened-ib-sriov-cni,v1.0.0,2021/03/02,239,333,20,3,0,595
bitnami/percona-mysql,8.0.34-26,2023/12/18,164,74,31,4,0,273
rancher/etc-host-updater,v0.0.3,2017/07/21,306,388,24,0,0,718
airbyte/source-us-census,0.1.2,2021/12/28,101,65,75,27,8,276
atlassian/crowd,5.2.0,2023/12/16,29,50,107,66,0,252
balenalib/beaglebone-green-wifi-debian-python,20230911,2023/09/12,121,46,42,6,0,215
balenalib/bananapi-m1-plus-ubuntu-openjdk,11-xenial-20231026,2023/11/02,null
rancher/mirrored-coreos-kube-state-metrics,v1.9.7,2020/06/03,0,9,14,0,6,29
astronomerinc/ap-registry,3.18.4-1,2023/11/06,0,4,0,0,0,4
portainer/greengrass-components-examples,sub,2022/08/12,23,136,177,4,0,340
balenalib/kitra710-fedora-python,20230712,2023/07/16,0,1,0,0,0,1
couchbase/fluent-bit,1.2.6,2023/06/05,76,24,19,2,0,121
amazon/aws-sam-cli-emulation-image-java11,20220125,2022/01/25,3,47,16,0,0,66
kasmweb/core-oracle-7,1.14.0,2023/09/09,2,11,5,0,0,18
ubuntu/traefik,2.10.4-22.04,2023/12/12,12,12,3,0,0,27
rapidfort/mariadb-ib,10.5.20,2023/11/08,87,279,8,0,0,374
circleci/shutdown-hook-poller,0.1,2020/11/16,100,86,81,24,7,298
docker/ucp-interlock-extension-s390x,3.1.0-beta3,2018/10/04,0,2,6,16,0,24
kasmweb/kali-rolling-desktop,1.14.0,2023/09/14,null
amazon/cloudwatch-agent,1.300031.1b317,2023/11/10,0,12,12,0,0,24
grafana/drone-autoscaler,1.7.5-grafana9,2021/11/19,4,18,19,0,0,41
formio/pdf-libs,5.0.2-rc.1,2023/04/17,0,6,0,0,0,6
balenalib/spacely-tx2-debian-openjdk,20231106,2023/11/07,128,52,33,4,0,217
rancher/coredns,v1.6.9,2020/09/12,258,420,32,3,0,713
balenalib/odroid-xu4-debian-openjdk,20230911,2023/09/11,132,73,46,6,0,257
intel/cri-resmgr-webhook,v0.8.4,2023/08/25,0,2,1,0,0,3
balenalib/qemux86-64,20231106,2023/11/06,117,29,31,4,0,181
cockroachdb/activerecord_test_container,20210914,2021/09/14,945,1076,958,184,29,3192
balenalib/spacely-tx2-alpine-node,20231106,2023/11/06,0,7,3,0,0,10
pachyderm/kube-event-tail,v0.0.7,2022/10/27,0,5,8,0,5,18
objectscale/decks,2.71.3,2021/04/14,2,19,23,0,0,44
rancher/terraform-operator,v0.0.5,2019/03/26,6,14,27,5,0,52
rancher/kubernetes,v1.18.4,2020/08/11,257,407,18,3,0,685
onlyoffice/4testing-ds-spellchecker,6.0.0,2020/10/21,563,574,32,3,0,1172
grafana/logcli,2.9.2-arm64,2023/10/25,0,4,3,0,0,7
objectscale/cmf-switch,0.71.3,2021/04/14,2,20,24,0,0,46
airbyte/source-recharge,1.1.2,2023/11/03,65,28,7,1,0,101
rancher/hyperkube,v1.27.7-rancher1-linux-arm64,2023/11/10,41,66,22,0,0,129
okteto/terminal,0.4,2021/03/11,19,80,81,13,0,193
intel/intel-qat-plugin,0.28.0,2023/09/22,null
objectscale/crunchy-postgres-exporter,ubi8-5.1.2-0,2022/07/05,81,116,12,0,0,209
greenbone/boreas-build,v22.5.0,2023/05/02,493,184,136,15,0,828
bitnami/grafana-operator,5.4.2,2023/11/08,77,16,7,2,0,102
grafana/agent-boringcrypto,v0.37.4,2023/11/06,14,9,1,0,0,24
rancher/mirrored-coredns-coredns,1.10.1,2023/02/06,0,4,3,0,0,7
balenalib/ts4900-fedora-python,20220622,2022/07/12,0,1,1,0,0,2
continuumio/sourceclear,v2,2018/11/02,203,471,13,0,0,687
hashicorp/nomad-driver-podman,0.2.0,2020/12/18,6,26,49,7,0,88
circleci/k8s-release-agent,0.1.206,2023/11/10,0,5,4,0,0,9
balenalib/bananapi-m1-plus-ubuntu-golang,20231026,2023/11/02,135,137,1,0,0,273
bitnami/jupyter-base-notebook,4.0.2,2023/12/02,86,28,13,3,0,130
lacework/code-security-gitlab,690c3699,2023/09/26,2,18,3,2,0,25
continuumio/planet-gpu,5.1.2-1907,2018/06/06,394,1972,1683,229,30,4308
airbyte/source-files-abstract,0.1.0,2022/04/11,101,66,76,28,8,279
balenalib/kitra520,20220714,2022/07/22,127,77,76,18,0,298
rancher/harvester-os,29221228,2022/12/28,11,92,63,2,0,168
airbyte/source-kustomer-singer,0.1.2,2021/12/25,0,21,51,8,0,80
jetbrains/upsource-file-clustering,2020.1.1992,2022/03/11,80,152,245,97,0,574
rancher/mirrored-directxman12-k8s-prometheus-adapter,v0.8.4,2021/03/31,null
bitnami/kube-state-metrics,2.10.1,2023/12/06,77,17,7,2,0,103
balenalib/artik10-node,20220714,2022/07/20,127,79,77,18,0,301
greenbone/notus-data,community,2023/12/19,null
onlyoffice/4testing-docspace-backup-background,2.0.0.33,2023/11/24,1024,156,211,13,0,1404
atlassian/confluence-server,8.6.1,2023/12/16,16,26,22,7,0,71
rancher/jaegertracing-all-in-one,1.20.0,2020/09/29,0,8,12,0,0,20
docker/dtr-garant,2.8.1,2020/06/17,2,9,8,1,0,20
objectscale/vnest,3.9.0.0-139102.b4b5064355c,2023/05/03,11,50,46,2,0,109
datadog/agent-buildimages-rpm_x64,v20433308-6861270,2023/09/25,1636,2014,195,6,0,3851
onlyoffice/4testing-appserver-migration-runner,test-2022081607,2022/08/16,74,88,122,7,0,291
balenalib/parallella-alpine-golang,20230904,2023/09/09,2,6,5,2,0,15
balenalib/orbitty-tx2-python,20231106,2023/11/07,117,30,31,4,0,182
redislabs/rebloom,2.6.8,2023/10/23,73,18,12,2,0,105
bitnami/fluent-bit,2.2.0,2023/12/08,77,16,7,2,0,102
balenalib/artik10-ubuntu-python,20220715,2022/08/02,87,92,13,0,0,192
grafana/query-frontend,r56-04edcb97f-WIP,2019/07/11,0,0,0,2,0,2
onlyoffice/4testing-appserver-webhooks-service,test-2022081607,2022/08/16,1045,346,362,25,1,1779
intel/openfl,1.5.1,2023/10/24,30,30,0,0,0,60
balenalib/intel-nuc-alpine-openjdk,8-20231106,2023/11/07,0,6,2,0,0,8
balenalib/intel-nuc-fedora-node,20231103,2023/11/04,0,1,1,0,0,2
rancher/local-path-provisioner,v0.0.24,2023/03/23,0,20,6,0,0,26
graphcore/ipu-operator-vipu-proxy,1.2.0,2023/05/30,31,16,2,0,0,49
rapidfort/redis-cluster,7.2.1,2023/11/17,29,6,1,0,0,36
datadog/agent-buildimages-circleci-runner,v22941763-c6364642,2023/11/07,121,190,3,0,0,314
pachyderm/jupyterhub-pachyderm-hub,1.1.0,2020/04/16,653,996,87,2,0,1738
balenalib/beaglebone-green-ubuntu-python,20230911,2023/09/12,42,20,4,0,0,66
netdata/builder,v2,2023/12/20,251,79,33,2,0,365
mattermost/oncall-notifier,v0.1.0,2020/10/27,2,20,41,4,0,67
balenalib/qemux86-64-fedora-openjdk,8-20231103,2023/11/04,null
circleci/openjdk,11.0.8,2020/10/05,939,839,858,136,22,2794
airbyte/source-woocommerce,0.2.3,2023/06/02,0,17,25,1,0,43
bitnami/solr,9.4.0,2023/12/02,92,34,29,6,0,161
balenalib/fincm3-ubuntu,20230904,2023/09/09,42,19,4,0,0,65
airbyte/destination-qdrant,0.0.7,2023/11/13,65,14,5,4,0,88
rancher/coreos-kube-state-metrics,v1.9.7,2020/06/03,0,9,14,0,6,29
kumahq/kuma-net-ebpf,0.8.10,2022/12/14,null
rancher/mirrored-prometheus-adapter-prometheus-adapter,v0.10.0,2022/08/12,0,4,8,0,0,12
grafana/plugin-validator-cli,v1,2021/04/27,0,9,31,4,0,44
balenalib/spacely-tx2-alpine-golang,20231106,2023/11/06,0,6,2,0,0,8
rancher/os-headers,v0.7.1,2016/10/19,null
datadog/docker-filter,1.2.1,2019/01/04,2,6,7,8,0,23
rancher/rke-cert-deployer,v0.1.1,2018/01/15,0,10,5,0,0,15
grafana/tns-db,842bd3b,2021/10/31,2,14,13,0,0,29
balenalib/odroid-c1-ubuntu-python,20220622,2022/06/23,87,122,13,0,0,222
rancher/goharbor-notary-server-photon,v0.6.1-v1.7.5,2019/04/01,14,63,88,37,0,202
balenalib/beaglebone-black-golang,20230911,2023/09/12,446,124,78,10,0,658
redislabs/redis-connect-oracle,0.6.2-3,2022/01/22,4,28,40,13,0,85
rancher/prometheus,v2.5.0,2018/11/06,null
pachyderm/notebooks-user-transformers,3ed85e7bffe50b2fb5293ab74d5c5c7f06946b26,2023/08/04,211,648,62,7,0,928
balenalib/i386-nlp,20210225,2021/04/19,192,128,142,43,10,515
circleci/circle-admin-cli,0.1,2020/01/13,2,38,73,6,0,119
dynatrace/dynatrace-synthetic-vuc-worker,1.277.53.20231106-153656,2023/10/10,21,12,3,0,0,36
rancher/k3s,v1.28.3-k3s2-s390x,2023/11/08,0,8,7,0,0,15
balenalib/revpi-core-3-debian,20230911,2023/09/11,121,45,42,6,0,214
intel/intelligent_traffic_management_analytics,2.0,2022/11/15,100,226,15,0,0,341
bitnami/supabase-storage,0.43.11,2023/11/16,80,20,8,6,0,114
airbyte/source-smartengage,0.1.0,2022/11/13,0,19,25,1,0,45
balenalib/bananapi-m1-plus-alpine-python,20231106,2023/11/07,0,7,2,0,0,9
rancher/istio-mixer,1.7.6,2020/12/08,1,10,15,1,5,32
newrelic/newrelic-pixie-integration,2.1.4,2023/06/22,0,12,4,3,0,19
rancher/harvester,v1.2.1,2023/10/26,0,7,10,0,1,18
grafana/containerized-systemd,debian-10,2022/06/27,118,67,59,12,7,263
balenalib/aarch64-ubuntu,20231103,2023/11/06,34,15,0,0,0,49
rancher/mirrored-neuvector-controller,5.2.3,2023/11/10,0,2,0,0,0,2
rancher/terraform-controller-appliance,v0.0.13-alpha1,2020/11/19,null
airbyte/source-talkdesk-explore,0.1.0,2022/05/26,0,21,51,8,0,80
balenalib/raspberry-pi2-alpine,20231106,2023/11/07,0,6,2,0,0,8
google/apigee-cert-manager-webhook,v0.12.0,2019/11/28,0,0,0,0,6,6
rancher/jenkins-swarm,v0.3.0,2016/08/09,119,458,479,214,35,1305
balenalib/orangepi-plus2-ubuntu-golang,20231026,2023/11/02,135,137,1,0,0,273
circleci/exim,0.2,2022/02/23,109,99,175,26,1,410
balenalib/colibri-imx6dl-node,18.6-20220714,2022/07/21,127,79,77,18,0,301
airbyte/destination-listen-and-echo,dev,2021/05/21,96,50,59,19,7,231
circleci/testing-cli,1.0.0,2018/05/01,442,1391,974,250,72,3129
bitnami/apisix,3.6.0,2023/11/04,99,34,11,2,0,146
rancher/istio-node-agent-k8s,1.5.9,2020/08/07,405,1085,143,0,0,1633
balenalib/zynq-xz702-alpine-golang,20220714,2022/07/27,8,45,38,12,0,103
docker/extension-npm-installer,0.2.14,2022/11/16,0,13,9,0,0,22
rancher/kubernetes-dashboard-amd64,v1.10.1,2018/12/17,null
portainer/agent-k8s-beta,linux-arm,2020/03/30,null
balenalib/orbitty-tx2-debian-openjdk,20231106,2023/11/07,128,52,33,4,0,217
vmware/mariadb-photon,10.2.10,2017/11/21,11,110,119,59,0,299
airbyte/source-freshdesk,3.0.4,2023/06/23,0,18,25,1,0,44
balenalib/artik5-debian-golang,20220714,2022/07/22,471,278,225,29,1,1004
redislabs/redisedgevision-bionic,0.1.1,2019/06/11,235,517,41,6,0,799
balenalib/hummingboard-fedora-golang,20221210,2022/12/13,null
redislabs/redis-connect-db2,0.7.0-18,2022/01/22,4,28,38,13,0,83
rancher/mirrored-s3gw-s3gw,v0.14.0,2023/03/30,5,42,19,0,1,67
balenalib/nitrogen6x-openjdk,20210602,2021/06/05,222,249,144,39,9,663
rapidfort/mysql8-ib,8.0.31,2023/10/25,105,48,0,0,0,153
sysdig/agent-s390x,0.78.1,2018/03/15,null
rancher/mirrored-cilium-operator-aws,v1.14.4,2023/11/13,0,2,0,0,0,2
kasmweb/core-oracle-8,1.14.0,2023/09/09,13,87,911,0,0,1011
bitnami/kubewatch-archived,0.1.0,2022/03/23,129,89,87,23,7,335
intel/flexran_l1_spree,v23.07,2023/10/12,113,143,10,0,0,266
airbyte/source-yandex-metrica,1.0.0,2023/03/20,0,18,25,1,0,44
vmware/vsan-prometheus-operator,v20210225,2021/02/26,14,102,109,45,0,270
rancher/strato,0.0.3,2018/01/16,null
kasmweb/manager,1.14.0,2023/09/14,28,15,1,0,0,44
vmware/photon-2.0-wavefront-proxy,v4.26-20180619,2018/06/19,41,146,204,89,0,480
balenalib/nitrogen6x-fedora-node,36-build-20220714,2022/07/22,0,1,1,0,0,2
balenalib/rpi-debian-golang,20231106,2023/11/07,375,62,46,5,0,488
airbyte/source-everhour,0.1.0,2023/03/23,0,18,25,1,0,44
balenalib/parallella-debian-python,20230904,2023/09/09,121,46,42,6,0,215
lacework/datacollector,6.10.0,2023/11/10,19,11,0,0,0,30
mattermost/channel-spammer,0.0.4,2021/05/07,2,23,40,4,0,69
atlassian/proforma-jre-with-fonts,8u121-jre-alpine,2020/04/27,9,25,17,13,0,64
balenalib/generic-aarch64-fedora,20231106,2023/11/06,null
vmware/lightwave-sts-photon2,1.3.1-35,2018/08/24,37,165,311,101,0,614
docker/runc,v1.0.0-rc5,2018/08/07,null
objectscale/kahm,v2.74.0,2021/05/25,2,19,24,0,0,45
balenalib/kitra710-ubuntu-python,20230904,2023/09/09,42,20,4,0,0,66
pingidentity/pingdelegator,2310,2023/11/01,0,3,1,0,0,4
rancher/vm-rancheros,1.4.2,2018/11/27,null
atlassian/bamboo-specs-runner,9.4.1,2023/11/07,72,93,9,13,0,187
bitnami/keycloak-config-cli,5.9.0,2023/12/15,77,18,13,2,0,110
balenalib/amd64-alpine-python,20231106,2023/11/07,0,7,2,0,0,9
kumahq/kuma-dp,2.4.4,2023/11/06,7,6,4,0,0,17
rancher/goharbor-notary-signer-photon,v0.6.1-v1.7.5,2019/04/01,14,63,88,37,0,202
balenalib/amd64-debian-openjdk,20231106,2023/11/06,121,52,24,4,0,201
vmware/photon-2.0-k8s-dns-dnsmasq-nanny-amd64,1.14.10-20180619,2018/06/19,19,75,92,57,0,243
kasmweb/debian-bullseye-desktop,1.14.0,2023/09/14,993,423,456,90,4,1966
airbyte/source-orbit,0.3.0,2023/10/25,0,15,24,1,0,40
rancher/longhorn-driver,88639e7,2017/12/12,89,230,14,0,0,333
airbyte/integration-base-python,20230210,2023/02/10,0,11,7,0,0,18
balenalib/beaglebone-green-alpine,20231106,2023/11/07,0,6,2,0,0,8
bitnami/testlink-archived,1.9.20,2022/03/23,296,287,168,24,12,787
bitnami/wavefront-adapter-for-istio-archived,0.1.5,2022/07/09,97,76,75,16,0,264
balenalib/amd64-node,20231106,2023/11/06,110,31,23,4,0,168
hashicorp/consul,1.17,2023/12/12,0,1,0,0,0,1
objectscale/rep,0.71.3,2021/04/15,13,89,100,14,3,219
rancher/grafana,5.3.0,2018/10/10,55,45,77,24,10,211
airbyte/source-googleanalytics-singer,0.2.6,2021/06/25,565,322,281,40,8,1216
pingidentity/pingcentral,2310,2023/11/01,7,22,14,2,0,45
objectscale/csi-baremetal-controller,0.69.0,2021/03/07,2,18,26,1,0,47
bitnami/geode-archived,1.15.1,2022/11/30,80,64,56,16,0,216
vmware/dind-sshuttle-bosh-ci,dev,2018/09/26,3,51,14,19,0,87
purestorage/psctl,v1.1.2,2022/07/07,0,3,6,0,0,9
docker/hub-explorer-extension,0.0.5,2022/03/09,0,18,20,1,0,39
mirantis/ucp-csi-node-driver-registrar,3.5.3,2022/04/05,0,0,0,0,6,6
docker/desktop-kubernetes-controller-manager,v1.28.2,2023/09/13,0,4,4,0,0,8
docker/ucp-swarm-s390x,3.1.0-beta3,2018/10/04,0,1,7,8,0,16
rancher/mirrored-idealista-prom2teams,4.2.1,2022/12/21,1,27,26,0,0,54
balenalib/beaglebone-green-alpine-openjdk,8-20231106,2023/11/07,0,6,2,0,0,8
lacework/container-auto-scan,1.1.2,2023/03/28,78,39,25,2,0,144
objectscale/objectscale-component-pre-update,1.4.0-397.adb0726,2023/11/13,0,5,4,0,0,9
redislabs/redismod,feature-search-json,2021/04/19,148,104,142,42,12,448
bitnami/drupal,10.1.6,2023/12/02,163,85,56,4,0,308
balenalib/asus-tinker-board-s-fedora-node,36-build-20230530,2023/06/29,0,1,1,0,0,2
datadog/agent-buildimages-system-probe_arm64,v22885174-c6364642,2023/11/06,844,368,284,10,3,1509
bitnami/etcd,3.5.10,2023/12/06,75,18,10,2,0,105
ubuntu/jre,17-22.04_24,2023/10/31,null
circleci/api-gateway-test-server,0.2.629-9503714,2023/02/02,0,5,4,0,0,9
grafana/loki-docker-driver,2.9.2,0001/01/01,0,5,3,0,0,8
airbyte/integration-singer-postgres-source,0.1.3,2020/10/07,121,109,163,32,12,437
rancher/mirrored-k8s-dns-dnsmasq-nanny,1.22.20,2023/02/22,11,16,4,0,0,31
balenalib/zynq-xz702-debian-python,20220604,2022/06/12,127,90,78,20,0,315
google/deepsomatic,1.6.0,2023/10/19,117,180,9,0,0,306
kasmweb/filezilla,1.14.0,2023/09/14,219,443,0,0,0,662
bitnami/fluentd,1.16.2,2023/11/15,163,70,28,3,0,264
airbyte/destination-convex,0.2.0,2023/05/24,0,17,25,1,0,43
kasmweb/thunderbird,1.14.0,2023/09/14,217,484,0,0,0,701
onlyoffice/4testing-docspace-proxy,1.1.3.2484,2023/09/08,183,277,19,0,0,479
astronomerinc/ap-redis,6.2.13,2023/09/25,139,66,29,3,0,237
bitnami/external-dns,0.14.0,2023/12/06,77,17,7,2,0,103
docker/dockerfile-upstream,1.6,2023/07/12,0,6,5,0,0,11
mattermost/mattermod,0.18.0,2023/10/11,36,57,20,0,0,113
kong/pulp-worker,1.1.38,2022/08/24,4,14,10,4,0,32
balenalib/odroid-xu4-debian-golang,20230911,2023/09/11,446,124,78,10,0,658
bitnami/jupyterhub,4.0.2,2023/12/02,87,27,12,3,0,129
airbyte/source-appstore-singer,0.2.6,2021/12/23,3,24,52,8,0,87
balenalib/apalis-imx6q-ubuntu-golang,20220523,2022/06/03,221,534,46,0,0,801
appdynamics/infra-agent,21.5.0-1784,2021/04/27,77,104,64,0,0,245
balenalib/orbitty-tx2-ubuntu-openjdk,11-xenial-20231103,2023/11/06,null
hashicorp/consul-enterprise-fips,1.17.0-ent.fips1402-ubi,2023/11/03,35,28,3,0,0,66
balenalib/odroid-c1-python,20220604,2022/06/12,127,90,78,20,0,315
onlyoffice/4testing-ds-spellchecker-de,6.2.0-eu-r2,2021/03/04,544,498,32,3,0,1077
rancher/plugin-manager,v0.2.12,2016/11/30,306,399,26,0,0,731
balenalib/am571x-evm-ubuntu-openjdk,20210826,2021/09/04,136,435,10,0,0,581
rancher/istio-galley,1.5.9,2020/08/07,405,1085,142,0,0,1632
greenbone/pg-gvm,22.6.1,2023/07/26,120,42,39,2,0,203
docker/ucp-calico-kube-controllers-s390x,3.1.0-beta3,2018/10/04,0,2,2,2,0,6
vmware/admiral_agent,1.3.1,2018/07/23,8,55,72,37,0,172
kasmweb/sublime-text,1.14.0,2023/09/14,217,443,0,0,0,660
kasmweb/core-rockylinux-9,1.14.0,2023/09/09,0,2,1,0,0,3
balenalib/intel-nuc-golang,20231106,2023/11/06,440,97,56,6,0,599
amazon/aws-lambda-java,21-preview,2023/11/12,0,1,0,0,0,1
rancher/pipeline-jenkins-server,v0.1.5,2020/02/14,211,209,271,76,12,779
grafana/mv-manager,7770886,1970/01/01,0,2,2,0,0,4
mattermost/mirror-sync-gitlab,latest-0743b65,2021/12/20,0,11,21,1,0,33
rapidfort/zookeeper-ib,3.8.2,2023/08/31,15,15,5,1,0,36
balenalib/amd64-openjdk,20231106,2023/11/06,121,52,24,4,0,201
redislabs/memtier_benchmark,2.0.0,2023/06/22,null
balenalib/odroid-c1-alpine-python,20220714,2022/07/19,7,44,35,10,0,96
circleci/cassandra,3.10,2017/05/25,59,174,159,79,23,494
balenalib/artik530-openjdk,20220714,2022/07/22,160,136,87,18,0,401
rapidfort/mariadb,11.1.2,2023/10/20,22,7,1,1,0,31
balenalib/asus-tinker-board-s-debian-node,20230911,2023/09/12,121,47,43,6,0,217
objectscale/telemetry-upload,3.0.4-413.8230f25,2023/10/03,2,6,5,0,0,13
balenalib/i386-nlp-debian-node,7.10.1,2018/11/07,398,1019,720,182,45,2364
airbyte/source-survey-sparrow,0.2.0,2022/12/09,0,18,25,1,0,44
balenalib/via-vab820-quad-python,20220604,2022/06/12,127,90,78,20,0,315
docker/artifactory-docker-desktop,v1.0.45,2023/10/02,null
rancher/vm-rhel,7.6-x86_64,2018/11/26,null
onlyoffice/documentserver-ee,7.5.1.1,2023/11/05,125,122,2,1,0,250
rancher/jimmidyson-configmap-reload,v0.4.0,2020/07/13,0,1,1,0,0,2
grafana/ci-e2e,12.19.0-1,2020/10/20,468,660,580,91,13,1812
rancher/rancher-csp-adapter,v3.0.0,2023/10/23,0,5,5,0,0,10
airbyte/source-convex,0.2.0,2023/06/21,0,15,17,0,0,32
datadog/cws-instrumentation,7.50.0-devel.git.506.5fb6ed0.pipeline.22983080,2023/11/07,null
rancher/mirrored-skopeo-skopeo,v1.13.2,2023/08/29,null
rancher/squareup-ghostunnel,v1.5.2,2019/11/20,5,18,34,2,0,59
puppet/puppetexplorer,2.0.0,2017/10/24,0,19,8,18,0,45
rancher/mirrored-istio-pilot,1.19.0,2023/09/01,29,21,6,0,0,56
continuumio/miniconda,4.7.12,2019/10/16,214,222,285,60,13,794
greenbone/ospd-openvas,22.6.1,2023/10/24,120,53,32,4,0,209
intel/pilot,1.19.0-intel.0,2023/09/27,29,21,6,0,0,56
airbyte/source-mysql,3.1.7,2023/11/08,5,29,17,2,0,53
balenalib/odroid-xu4-fedora-node,36-build-20230530,2023/06/29,0,1,1,0,0,2
bitnami/rmq-default-credential-updater,1.0.4,2023/12/06,null
balenalib/artik533s-fedora-openjdk,8-20220224,2022/03/05,null
rancher/strato-min,0.0.2,2017/01/02,null
bitnami/spring-cloud-skipper,2.11.1,2023/12/15,77,18,21,4,0,120
rancher/opni-inference-service,v0.12.1-rc1,2023/11/10,8,72,81,5,14,180
balenalib/beaglebone-black-fedora,20221109,2022/12/04,null
passbolt/labs,2.13.5-fpm,1970/01/01,83,254,188,59,7,591
hashicorp/secrets-store-csi-driver-provider-vault,0.0.7,2021/01/20,2,14,14,1,0,31
docker/ucp-agent,3.3.1,2020/06/26,2,8,9,1,0,20
redislabs/redisedge-bionic,0.1,2019/06/09,94,76,7,0,0,177
nginxinc/mra_python_base,3.5,2018/05/31,418,1554,1058,274,69,3373
balenalib/jetson-tx1-debian,20230530,2023/06/28,121,48,43,6,0,218
rancher/goharbor-chartmuseum-photon,v0.8.1-v1.7.5,2019/04/01,14,63,88,37,0,202
rancher/storage-rbd,v0.9.7,2018/07/09,251,509,17,0,0,777
balenalib/bananapi-m1-plus-ubuntu,20231026,2023/11/02,37,18,0,0,0,55
mirantis/dtr,2.9.14,2023/09/28,0,19,10,0,0,29
mattermost/notice-file-generator-daily,v0.0.2,2022/07/08,0,2,4,0,0,6
rancher/mirrored-cloud-provider-vsphere-csi-release-syncer,v3.1.1,2023/10/24,3,8,10,3,0,24
google/apigee,nginx,2019/04/16,43,55,81,31,7,217
balenalib/beaglebone-black-node,20230911,2023/09/12,121,47,43,6,0,217
snyk/container-registry-agent,70316042f6291a25d1ddf2e0535c057570aebd42,2021/11/10,0,21,47,6,0,74
rancher/security-scan,v0.2.13,2023/09/12,2,13,18,0,6,39
airbyte/source-dockerhub,0.2.0,2023/08/24,0,17,24,1,0,42
balenalib/qemux86-64-debian,20231106,2023/11/06,117,29,31,4,0,181
objectscale/objectscale-operator,0.71.3,2021/04/19,4,16,18,0,0,38
balenalib/generic-armv7ahf-ubuntu-python,20230904,2023/09/09,42,20,4,0,0,66
rancher/connectivity-check,v0.0.8,2018/07/17,306,388,24,0,0,718
mirantis/k8s-netchecker-agent,v1.2.2,2018/01/02,null
airbyte/source-posthog,0.1.15,2023/11/03,65,13,3,1,0,82
rancher/tektoncd-controller,80e040a5,2019/05/29,0,0,0,0,6,6
bitnami/wavefront-prometheus-storage-adapter,1.0.7,2023/06/17,77,30,18,2,0,127
balenalib/rpi-alpine-openjdk,8-20231026,2023/11/01,8,14,2,0,0,24
balenalib/beaglebone-green-wifi-debian-golang,20230911,2023/09/12,446,124,78,10,0,658
rancher/mirrored-cilium-kvstoremesh,v1.14.4,2023/11/13,null
airbyte/source-weatherstack,0.1.0,2022/11/07,0,17,17,0,0,34
mattermost/mattermost-push-proxy,5.26.0,2023/11/01,0,5,2,0,0,7
intel/intelligent_traffic_management_pipeline_server_init,2.0,2022/11/15,45,52,5,0,0,102
bitnami/supabase-studio,0.23.10,2023/12/09,81,21,8,2,0,112
mongodb/mongodb-community-server,7.0.3-ubuntu2204-20231115T085830Z,2023/11/15,144,152,1,0,0,297
mattermost/genesis,209d026,2021/04/14,1,25,54,5,0,85
bitnami/redis-sentinel,7.2.3,2023/12/09,77,16,7,2,0,102
docker/remote,server,2017/09/15,0,26,3,0,0,29
rancher/rancher-cleanup,130,2022/05/30,5,53,34,3,14,109
pingidentity/pingintelligence,2310,2023/11/01,509,524,6,0,0,1039
bitnami/mxnet-archived,1.9.1,2023/10/11,610,207,95,11,0,923
rancher/harvester-pcidevices,v0.2.6,2023/12/07,0,5,1,0,2,8
balenalib/i386-node,16.19.1-20231106,2023/11/06,110,31,23,4,0,168
intel/esp-uos-builder,v3.1.2,2023/07/25,2,12,38,4,0,56
balenalib/zynq-xz702-openjdk,20210602,2021/06/05,222,249,144,39,9,663
sysdig/falco_rules_installer,12,2022/09/23,830,931,655,37,7,2460
balenalib/artik530-alpine-node,20220803,2022/08/04,7,44,34,10,0,95
rancher/istio-citadel,1.5.9,2020/08/07,406,1088,142,0,0,1636
airbyte/source-metabase,1.1.0,2023/10/31,65,13,5,1,0,84
rancher/metadata-syncer,319,2023/11/15,0,6,3,0,0,9
rancher/kube-api-auth,v0.2.0,2023/07/12,2,12,11,0,1,26
google/cloud-sdk,455.0.0,2023/12/05,539,184,130,14,2,869
balena/open-balena-db,5.2.1,2023/04/21,113,46,39,2,0,200
onlyoffice/dropbox-callback,1.0.0-rc7,2023/09/04,0,7,6,0,0,13
jetbrains/qodana-go,2023.2,2023/09/06,488,174,145,18,2,827
balenalib/odroid-xu4-fedora-python,20221109,2022/11/16,0,1,0,0,0,1
astronomerinc/ap-elasticsearch,8.9.2,2023/10/31,25,23,4,0,0,52
pachyderm/seldon-pachyderm-rsi-deployer,0.1.4,2021/02/11,8,33,52,7,0,100
airbyte/migration,0.33.0-alpha,2021/12/03,96,91,93,24,7,311
rancher/mirrored-istio-coredns-plugin,0.2-istio-1.1,2019/03/06,331,452,37,0,0,820
balenalib/stem-x86-32-golang,20230904,2023/09/09,446,126,78,10,0,660
bitnami/odoo,17.0.20231105,2023/12/02,103,33,23,5,0,164
airbyte/source-vitally,0.1.0,2022/11/14,0,19,25,1,0,45
objectscale/chunks3server,1.0.0-367.df32ef43,2022/09/09,7,45,56,4,3,115
airbyte/source-http-request,0.2.4,2021/06/09,140,101,113,34,8,396
rancher/rke-nginx-proxy,v0.1.1,2018/01/20,0,26,9,23,0,58
balenalib/zynq-xz702-fedora-golang,20220507,2022/05/12,null
rancher/agent,v2.0.3,2018/03/07,7,31,0,0,0,38
hashicorp/vault-enterprise,1.15.2-ent,2023/11/07,0,9,2,0,0,11
balena/open-balena-vpn,11.29.17,2023/10/18,362,121,85,6,6,580
google/apigee-istio-galley,1.4.6,2020/02/22,648,1306,152,0,0,2106
rancher/build-base,v1.14.2,2020/08/09,1236,1950,1442,88,19,4735
rancher/linkerd-install,stable-2.8.1,2020/07/30,122,227,28,0,0,377
snyk/snyk-operator-bundle,1.63.0-pre0,2021/06/04,98,207,35,2,0,342
objectscale/objectstore-connectivity,0.71.3,2021/03/24,2,18,23,0,0,43
okteto/gc,1.0.0,2020/03/13,2,19,41,4,0,66
objectscale/chunkserver,1.0.0-418.1b630f7e,2023/11/14,0,8,11,0,0,19
rancher/net,v0.13.17,2018/07/19,306,388,24,0,0,718
balenalib/nitrogen6x-ubuntu-golang,20220523,2022/06/03,221,534,46,0,0,801
rancher/kube-rbac-proxy,v0.5.0,2020/02/17,2,20,42,4,0,68
mattermost/awat-e2e,8330887,2022/03/30,497,392,306,56,3,1254
mattermost/cloud-db-factory-vertical-scaling,7665090,2020/09/21,3,25,41,4,0,73
airbyte/source-tyntec-sms,0.1.0,2022/11/16,0,19,25,1,0,45
intel/esp-certbot,v3.1.2,2023/07/25,4,7,4,0,0,15
redislabs/redis-webcli,yuvallevy2-webcli_tls_support-RED-37222,2020/02/09,590,1654,1280,279,16,3819
rancher/cleanup-1-1,v0.1.2,2017/01/19,141,323,305,146,0,915
cimg/clojure,1.11.1,2022/11/28,488,1003,99,0,0,1590
rapidfort/mysql,8.1,2023/10/17,22,6,1,0,0,29
kasmweb/zoom,1.14.0,2023/09/14,219,443,0,0,0,662
mirantis/ucp-hardware-info,3.7.1,2023/09/26,2,11,6,2,0,21
atlassian/bitbucket,8.15.1,2023/12/16,47,67,27,2,0,143
docker/desktop-kubernetes-pause,3.9,2022/10/13,null
intel/search-image-by-image,evi-2.0.0,2022/10/31,51,45,39,7,0,142
bitnami/spark,3.5.0,2023/12/16,91,43,57,8,0,199
airbyte/source-slack,0.3.5,2023/10/15,65,28,7,1,0,101
rancher/harvester-cloud-provider,v0.2.0,2023/06/07,1,10,11,0,1,23
bitnami/laravel,10.2.9,2023/11/14,160,95,60,5,0,320
bellsoft/liberica-native-image-kit-container,jdk-17-nik-22.3.2-stream-musl,2023/12/19,null
airbyte/source-yotpo,0.1.0,2023/05/01,0,18,25,1,0,44
balenalib/amd64-fedora-golang,20231103,2023/11/04,null
mirantis/ucp-metrics-swarm-only,3.7.1,2023/09/26,2,19,10,2,0,33
balenalib/armv7hf-alpine-python,20231106,2023/11/07,0,7,2,0,0,9
daggerio/ci-test,32728,2022/07/25,0,14,14,1,0,29
rancher/storage-secrets,v0.9.7,2018/07/09,125,218,12,0,0,355
amazon/aws-lambda-nodejs,20.2023.11.13.16,2023/11/13,0,3,0,1,0,4
pachyderm/worker-arm64,97276071e371d5b1ea221437e99cfd87b5599ddf,2023/11/03,1,10,8,0,0,19
docker/tutum-test-alpine,quantal,2020/05/29,2,10,32,4,0,48
airbyte/source-pipedrive,2.2.1,2023/11/06,0,15,24,1,0,40
circleci/android,example,2021/03/18,883,745,815,155,21,2619
rancher/metrics-server,v0.4.1,2020/11/16,0,8,12,1,5,26
airbyte/source-dremio,0.1.0,2023/01/12,0,18,25,1,0,44
airbyte/source-chargebee,0.2.5,2023/10/15,65,28,7,1,0,101
balenalib/orbitty-tx2-alpine-openjdk,8-20231106,2023/11/06,8,14,2,0,0,24
grafana/dd-proxy,v0.1.0,2020/09/24,6,33,49,4,0,92
balenalib/raspberrypi3-debian-node,20230530,2023/07/02,121,47,43,6,0,217
kasmweb/chromium,1.14.0,2023/09/14,217,442,0,0,0,659
circleci/twistlock-secret-fetcher,0.1.31-be7da25,2019/05/28,0,6,5,7,0,18
airbyte/source-hubplanner,0.2.0,2023/09/04,0,17,24,1,0,42
ambassador/aes-authsvc,v4.0.0-preview.2.dev.1,2023/10/27,0,2,1,0,0,3
rancher/os-selinuxtools,v1.5.8,2021/02/05,null
balenalib/asus-tinker-board-s-alpine-python,20231106,2023/11/07,0,7,2,0,0,9
rancher/opensearch-dashboards,1.3.1,2022/05/19,27,204,316,18,0,565
mattermost/matterbuild,0.12.1,2023/10/11,25,19,7,0,0,51
balenalib/stem-x86-32-node,16.19.1-20230904,2023/09/09,121,47,43,6,0,217
rancher/k8s-dns-sidecar,1.15.10,2020/03/05,16,17,19,8,1,61
balenalib/intel-nuc-debian-openjdk,20231103,2023/11/05,128,52,33,4,0,217
balenalib/amd64-fedora-python,20231103,2023/11/04,null
rancher/mirrored-sig-storage-csi-attacher,v4.4.2,2023/11/09,null
onlyoffice/documentserver-de,7.5.1.1,2023/11/05,125,122,2,1,0,250
balenalib/artik530-fedora-openjdk,8-20220224,2022/03/05,null
balenalib/via-vab820-quad-ubuntu-openjdk,20210826,2021/09/04,136,435,10,0,0,581
google/apigee-istio-pilot,1.4.6,2020/02/22,648,1311,159,1,0,2119
balenalib/artik530-fedora-python,20220714,2022/07/23,0,1,1,0,0,2
docker/ucp-controller,3.3.1,2020/06/26,2,8,9,1,0,20
airbyte/source-datascope,0.1.0,2022/11/11,0,19,25,1,0,45
docker/fab-backend,50b36877f5c4f4f9947837690a988f592450d1de,2018/11/21,1,0,14,11,0,26
airbyte/source-instatus,0.1.0,2023/01/13,0,18,25,1,0,44
intel/intel-deviceplugin-operator,0.28.0,2023/09/22,null
objectscale/bookkeeper-operator,0.1.9-99-582916f,2023/02/10,1,16,17,0,0,34
airbyte/destination-s3,1.0.0,2023/01/13,28,191,244,21,0,484
intel/evi-fm-master,master-ae213cd97d6931b1d44fc7689867cf5701e0f15d,2023/09/23,56,13,4,1,0,74
balenalib/armv7hf-debian,20230929,2023/10/02,114,45,34,6,0,199
circleci/erlang,25,2022/02/22,855,1044,779,101,5,2784
balenalib/jetson-tx2-debian-python,20231106,2023/11/07,117,30,31,4,0,182
airbyte/source-breezometer,0.1.0,2022/11/08,0,19,25,1,0,45
atlassian/pipelines-kubectl,1.28.1,2023/08/31,0,3,1,0,0,4
rancher/os-extras,v0.7.1,2016/10/03,0,53,26,10,0,89
rancher/os-rootfs,3929481,2017/02/03,null
balena/i386-nlp-supervisor-base,v1.4.7,2019/05/28,null
snyk/kubernetes-operator-index,1.100.2,2023/01/03,3,27,53,3,0,86
balenalib/artik10-debian-openjdk,20220714,2022/07/22,160,136,87,18,0,401
balenalib/odroid-xu4-alpine,20231106,2023/11/07,0,6,2,0,0,8
newrelic/cluster-api-controller-ppc64le,mv1a,2019/04/17,0,0,0,0,6,6
airbyte/destination-mongodb-strict-encrypt,0.2.0,2023/07/26,25,163,191,6,0,385
graphcore/ipu-operator-launcher,1.2.0,2023/05/30,31,17,3,0,0,51
rancher/os-cloudinit,v0.7.1,2016/11/01,null
balenalib/am571x-evm-debian-python,20220604,2022/06/12,127,90,78,20,0,315
mattermost/community-continuous-profiling,6055961,2021/01/20,10,21,40,6,0,77
onlyoffice/4testing-docspace-healthchecks,2.0.0.33,2023/11/24,1024,156,211,13,0,1404
intel/intelligent_traffic_management_analytics_dev,2.0,2022/12/06,100,217,15,0,0,332
rancher/mirrored-curlimages-curl,7.85.0,2022/08/31,0,13,12,0,0,25
balenalib/artik5-ubuntu,20220714,2022/08/02,87,91,11,0,0,189
grafana/technical-documentation-build-image,6673591,2022/11/15,1,14,15,3,0,33
objectscale/csi-baremetal-node-controller,1.4.0-652.08b8de3,2023/11/13,0,2,0,0,0,2
adobecoldfusion/apimanager2021,2021.0.1,2021/12/17,109,250,101,40,0,500
kasmweb/alpine-317-desktop,1.14.0,2023/09/14,14,148,151,22,2,337
vmware/vs-api-manager,v0.0.1,2017/12/05,15,81,98,70,0,264
rancher/mirrored-jenkins-jnlp-slave,4.7-1,2021/03/24,235,163,195,54,13,660
okteto/traefik,dev,2020/04/10,12,39,68,8,0,127
cockroachdb/xgo,20170218,2017/02/19,764,1408,75,1,0,2248
mirantis/operations-ui,remove-keycloak-stuff,2018/11/08,409,1276,811,204,49,2749
objectscale/csi-baremetal-scheduler-patcher,0.69.0,2021/03/07,0,15,49,12,0,76
docker/proxy_init,1.1.2,2019/04/12,40,35,0,0,0,75
balena/aarch64-supervisor-base,v1.4.7,2019/05/28,null
balenalib/apalis-imx6q,20220714,2022/07/20,127,77,76,18,0,298
percona/dbaas-operator-bundle,0.1.17,2023/07/04,null
intel/intel-iaa-plugin,0.28.0,2023/09/22,null
circleci/nomad,0.9-8443593,2019/08/16,60,69,111,16,10,266
airbyte/proxy,0.51.0,2023/07/20,93,52,26,3,2,176
bellsoft/liberica-openjre-centos,21.0.1-12,2023/11/14,551,504,32,3,0,1090
redislabs/mp-vault,0.0.2,2019/06/26,0,0,0,2,0,2
bitnami/memcached,1.6.22,2023/12/15,81,16,8,3,0,108
balenalib/via-vab820-quad-alpine-python,20220714,2022/07/19,7,44,35,10,0,96
rancher/mirrored-library-busybox,1.36.1,2023/12/05,null
airbyte/destination-postgres-strict-encrypt,0.4.0,2023/06/29,29,190,236,21,0,476
rancher/mirrored-jimmidyson-configmap-reload,v0.8.0,2022/10/11,null
onlyoffice/4testing-ds-proxy-de,6.2.0-eu-r2,2021/03/04,601,594,37,3,0,1235
balena/open-balena-api,14.14.3,2023/11/13,362,110,64,6,6,548
onlyoffice/documentserver-builder,develop-latest,2019/02/18,17,29,10,6,0,62
vmware/photon2,20180620,2018/06/20,15,71,90,57,0,233
airbyte/source-workable,0.1.0,2022/10/27,0,19,25,1,0,45
couchbase/sync-gateway,1.4.0-2,2019/04/10,614,642,48,3,0,1307
circleci/migratorator-test,0.1,2017/08/26,501,1809,1164,312,70,3856
amazon/aws-secrets-manager-secret-rotator,v1,2020/10/14,0,8,13,0,6,27
balenalib/orangepi-plus2-alpine,20231106,2023/11/07,0,6,2,0,0,8
balenalib/revpi-core-3-ubuntu,20231026,2023/11/02,37,18,0,0,0,55
rancher/rdns-server,v0.5.8-rancher-amd64,2019/12/27,108,74,12,0,0,194
okteto/test-auth,dev,2020/02/06,2,10,29,4,0,45
rancher/slack-irc,3.12.0,2018/08/13,333,485,42,4,0,864
grafana/benchtool,v0.11.0,2023/09/06,0,3,3,0,0,6
balenalib/odroid-xu4-golang,20230911,2023/09/11,446,124,78,10,0,658
netdata/os-test,ubuntu1904,2020/04/14,0,4,0,0,0,4
newrelic/synthetics-minion-runner,3.0.95,2023/11/03,34,224,238,45,0,541
grafana/vale,6673591,2022/11/15,0,5,4,1,0,10
balenalib/aarch64-alpine-openjdk,8-20231106,2023/11/06,6,12,2,0,0,20
pachyderm/split-loadtest-supervisor,20191119.0802,2019/11/19,null
hashicorp/consul-esm,0.7.1,2023/01/06,0,26,21,0,0,47
grafana/metrictank,v1.1,2021/01/14,4,14,9,3,0,30
docker/dtr-notary-signer,2.8.1,2020/06/17,2,9,8,1,0,20
pachyderm/job-shim,1.3.19,2017/03/30,376,507,68,1,0,952
airbyte/source-klaviyo,2.0.1,2023/11/09,65,28,7,1,0,101
bitnami/git,2.42.1,2023/11/02,139,29,33,5,8,214
rancher/klipper-lb,v0.4.4,2023/05/27,0,10,2,3,0,15
mattermost/mattermost-enterprise-edition,9.2.2,2023/11/08,52,48,6,0,0,106
intel/esp-uos-wifi,v3.1.2,2023/07/25,null
okteto/java-maven-getting-started,1.0.0,2023/02/27,112,87,115,34,0,348
onlyoffice/4testing-ds-converter,6.0.0,2020/10/21,563,574,32,3,0,1172
rancher/rancher-operator,v0.2.0-alpha03,2021/04/13,1,13,42,4,0,60
airbyte/tests,dev-3,2022/01/23,105,121,92,30,0,348
airbyte/source-linkedin-pages,1.0.2,2023/05/30,0,17,25,1,0,43
docker/ucp-agent-s390x,3.1.0-beta3,2018/10/04,0,2,6,16,0,24
airbyte/destination-r2,0.1.0,2022/09/26,81,97,103,34,0,315
balenalib/generic-armv7ahf-debian-python,20230904,2023/09/09,121,46,42,6,0,215
circleci/dynamodb,19,2022/02/22,18,79,42,1,0,140
objectscale/base-service-tools,2.69.0,2021/03/16,18,140,169,6,6,339
rapidfort/haproxy,2.8.3,2023/10/17,29,7,4,1,0,41
balenalib/raspberry-pi2-fedora-golang,20220523,2022/06/04,null
puppet/continuous-delivery-for-puppet-enterprise,4.3.3,2021/02/23,109,84,88,28,7,316
solace/solace-pubsub-standard,10.6.0.34,2023/10/27,186,222,6,0,0,414
rancher/bats-bats,v1.1.0,2018/08/02,0,0,0,2,0,2
cimg/base,2023.11,2023/11/07,194,189,6,0,0,389
balenalib/jetson-tx2-ubuntu,20231103,2023/11/06,37,18,0,0,0,55
balenalib/beaglebone-green-wifi-debian,20230911,2023/09/11,121,45,42,6,0,214
couchbase/operator-certification,2.5.0,2023/08/14,250,121,67,8,2,448
docker/ucp-pause-s390x,3.1.0-beta3,2018/10/04,null
vmware/log-intelligence-fluentd,3.6,2021/03/12,1429,1375,997,150,40,3991
circleci/circleci-inferconfig,0.1412,2023/10/03,241,272,32,0,0,545
airbyte/source-alloydb,3.1.8,2023/09/20,8,43,39,2,0,92
ubuntu/squid,6.1-23.10_edge,2023/12/11,12,7,0,0,0,19
kong/go-plugin-tool,47123c5-alpine-latest,2020/05/22,8,29,74,11,0,122
rancher/agent-windows,v0.2.0,2018/03/15,null
intel/esp-uos-firmware-wifi,v3.1.2,2023/07/25,null
airbyte/destination-aws-datalake,0.1.4,2023/10/25,65,13,4,2,0,84
balenalib/asus-tinker-board-ubuntu-node,20231026,2023/11/02,38,19,1,0,0,58
airbyte/source-google-ads,2.0.4,2023/11/10,65,28,7,1,0,101
docker/ucp-interlock-s390x,3.1.0-beta3,2018/10/04,0,2,6,16,0,24
astronomerinc/ap-keda-metrics-adapter,1.5.0,2020/08/03,134,307,47,1,0,489
dynatrace/easytravel-frontend,7.1,2018/05/11,3,19,12,22,0,56
rancher/enterprise,v1.6.30,2020/05/05,74,91,63,25,0,253
balenalib/artik5-fedora-openjdk,8-20220224,2022/03/05,null
onlyoffice/docspace-ssoauth,1.1.4.1,2023/10/23,1013,182,235,23,0,1453
mattermost/mm-cloud-ee,2786a79-102,2020/10/14,10,57,84,11,0,162
balenalib/raspberry-pi2-ubuntu-golang,20231026,2023/11/02,135,137,1,0,0,273
balenalib/raspberry-pi2-python,20230911,2023/09/12,121,46,42,6,0,215
rancher/mirrored-calico-kube-controllers,v3.26.3,2023/10/06,0,3,3,0,0,6
balenalib/kitra710-debian-node,20230904,2023/09/09,121,47,43,6,0,217
docker/dtr-content-cache,2.8.1,2020/06/17,2,9,8,1,0,20
balena/rpi-supervisor-node,1244-update-lock-weirdness,2020/04/02,730,721,623,71,9,2154
vmware/lightwave-toolchain-photon3,1.0.1,2019/11/27,53,279,392,86,0,810
balenalib/raspberry-pi2-node,20230911,2023/09/12,121,47,43,6,0,217
bitnami/wavefront-hpa-adapter,0.9.10,2023/05/21,0,4,5,0,0,9
balenalib/kitra710-fedora,20230904,2023/09/09,null
snyk/sweater-comb,2.3.9,2023/11/06,0,4,2,0,0,6
rancher/network-diagnostics-agent,v0.1.0,2017/06/17,307,389,24,0,0,720
balenalib/odroid-xu4-fedora-golang,20221210,2022/12/13,null
kasmweb/telegram,1.14.0,2023/09/14,217,443,0,0,0,660
balenalib/am571x-evm-fedora,20220604,2022/06/12,null
balenalib/beaglebone-black-alpine-openjdk,8-20231106,2023/11/07,0,6,2,0,0,8
mirantis/ucp-kube-compose,3.5.3,2019/11/07,4,14,9,1,0,28
rancher/mirrored-fluent-fluent-bit,1.9.5,2022/06/20,27,33,24,5,0,89
lacework/codesec-iac,v1.0.4,2023/10/02,57,67,12,0,0,136
bitnami/redis-cluster,7.2.3,2023/12/09,78,17,7,2,0,104
amazon/aws-ebs-csi-driver,8382640,2021/07/12,131,110,116,38,3,398
balenalib/orbitty-tx2-debian,20231106,2023/11/07,117,29,31,4,0,181
airbyte/source-strava,0.2.0,2023/10/24,0,15,24,1,0,40
apachepinot/pinot-superset,470541885905-20220907,2022/09/07,820,846,627,51,3,2347
rancher/mirrored-dexidp-dex,v2.37.0,2023/06/30,0,17,6,3,0,26
ambassador/aes-envoy,v4.0.0-preview.2.dev.1,2023/10/27,21,5,1,0,0,27
mirantis/ucp-interlock-extension,3.7.1,2023/09/26,2,9,7,2,0,20
grafana/openshift-cloud-log-forwarder,1.0.1,2022/03/08,73,111,21,0,0,205
airbyte/scheduler,0.101.0-alpha,2021/06/04,249,236,216,48,13,762
okteto/chaat,dev,2020/07/22,1391,1144,1077,121,20,3753
sysdig/aws-mfa,0.1.0,2020/02/12,109,113,99,33,8,362
bitnami/grafana,10.2.0,2023/11/08,91,26,19,4,0,140
redislabs/rcp-gcloud,8a3bb250e2bf37a24038396891e68b5f,2019/07/14,327,710,515,101,16,1669
balenalib/fincm3-fedora,20221031,2022/11/04,null
rapidfort/influxdb,2.7.1,2023/10/12,45,16,13,3,0,77
balenalib/ts4900-alpine-golang,20220714,2022/07/27,8,45,38,12,0,103
okteto/python-job-launcher,launcher,2020/08/18,101,86,90,31,8,316
hashicorp/consul-k8s,0.26.0,2021/06/22,5,32,48,8,0,93
bellsoft/liberica-runtime-container,jre-21.0.1-stream-musl,2023/12/19,null
okteto/welcome,44,2018/12/20,1,9,11,4,0,25
objectscale/iamsvc,0.71.3,2021/04/14,13,93,110,14,3,233
grafana/grafana-arm32v7-linux,7.0.6,2020/07/09,4,32,54,9,0,99
onlyoffice/trello-proxy,1.0.7,2023/11/15,0,3,2,0,0,5
airbyte/source-mailjet-mail,0.1.1,2023/04/19,0,18,25,1,0,44
rancher/fluent-fluent-bit,1.6.10,2021/01/08,13,33,25,10,5,86
atlassian/bamboo-server,9.4.1,2023/12/12,53,76,20,14,0,163
docker/dev-environments-default,639923ad2c5ce6f29a24ca8d11c8f38f9206c462,2021/06/21,517,275,416,60,15,1283
amazon/aws-sam-cli-emulation-image-dotnetcore3.1,20220125,2022/01/25,3,48,22,0,0,73
google/apigee-busybox,1.30.1,2019/05/09,null
snyk/broker,4.169.3-rhel-ubi-nexus2,2023/11/14,62,14,0,0,0,76
newrelic/external-dns,ns1,2019/04/02,4,14,8,2,0,28
newrelic/cluster-api-controller-s390x,mv1a,2019/04/17,0,0,0,0,6,6
balenalib/odroid-xu4-ubuntu-golang,20231026,2023/11/02,135,137,1,0,0,273
onlyoffice/gdrive-gateway,1.0.0-rc15,2023/09/18,0,7,6,0,0,13
mattermost/mattermost-prod-app,v5.33.3,2021/03/31,2,25,28,1,0,56
bitnami/tensorflow-serving,2.14.0,2023/11/16,312,34,25,3,0,374
hashicorp/consul-lambda-registrator,0.1.0-beta4,2023/04/28,4,48,30,2,0,84
dynatrace/dynatrace-oneagent-operator,v0.10.2,2021/09/07,101,193,34,0,0,328
rapidfort/airflow,2.7.1,2023/11/17,29,9,2,1,0,41
percona/percona-server-mongodb,7.0.2-1,2023/10/10,6,16,19,0,0,41
rancher/storage-efs,v0.9.0,2018/01/12,395,723,49,3,0,1170
rancher/terraform-provider-harvester,v0.6.3,2023/08/21,4,23,32,1,2,62
balenalib/intel-nuc-openjdk,20231103,2023/11/05,128,52,33,4,0,217
grafana/logql-analyzer,2.9.2-amd64,2023/10/25,0,3,2,0,0,5
balenalib/aarch64-openjdk,20231106,2023/11/07,121,52,24,4,0,201
mattermost/awat,8330887,2022/03/30,4,40,19,3,0,66
newrelic/cluster-api-controller-amd64,79dda1d3,2019/07/01,0,0,0,0,6,6
intel/query-web,evi-2.0.0,2022/10/31,62,88,1,0,0,151
onlyoffice/docspace-notify,1.1.4.1,2023/10/23,1024,157,214,13,0,1408
ubuntu/postgres,14-22.04_edge,2023/11/28,20,14,0,0,0,34
balenalib/generic-armv7ahf-python,20230904,2023/09/09,121,46,42,6,0,215
atlassian/maven,3.5-jdk-8-alpine,2017/09/27,21,69,47,44,0,181
jetbrains/upsource-opscenter,2020.1.1992,2022/03/11,80,152,245,97,0,574
appdynamics/ad-nite-go-services,2019-03-13-1552519571,2019/03/13,210,515,555,132,35,1447
balenalib/qemux86-64-ubuntu-node,20230911,2023/09/11,43,20,5,0,0,68
docker/ucp-kube-compose-s390x,3.1.0-beta3,2018/10/04,0,0,0,2,0,2
rapidfort/nginx-official,1.23.4-perl,2023/05/23,44,34,10,1,0,89
datadog/dd-lib-dotnet-init,v2.41.0,2023/11/05,0,2,2,0,0,4
balenalib/orbitty-tx2-debian-node,20231106,2023/11/07,117,31,32,4,0,184
balenalib/am571x-evm-ubuntu-node,20220715,2022/07/19,88,113,12,0,0,213
balenalib/nitrogen6x-fedora-openjdk,30-20210825,2021/09/03,null
intel/storage-rest,evi-2.0.0,2022/10/31,121,241,43,0,0,405
kumahq/kuma-cp,2.4.4,2023/11/06,0,1,1,0,0,2
balenalib/ts4900-golang,20220714,2022/07/28,471,275,219,29,1,995
rancher/longhornio-longhorn-instance-manager,v1_20220808-s390x,2022/08/08,8,77,75,3,14,177
airbyte/source-google-search-console-singer,0.1.3,2021/07/06,559,326,284,40,8,1217
netdata/base,v2,2023/12/20,132,34,23,1,0,190
balenalib/orbitty-tx2-openjdk,20231106,2023/11/07,128,52,33,4,0,217
rancher/opni-gpu-service-controller,v0.3.1,2022/03/07,8,102,111,7,17,245
rancher/mirrored-sig-storage-snapshot-validation-webhook,v6.2.2,2023/05/27,0,2,1,0,0,3
mirantis/virtlet-base,v1-6348ee2277c565d3895260bccb5ada96,2018/11/30,339,505,35,0,0,879
airbyte/destination-mongodb,0.2.0,2023/07/27,25,163,191,6,0,385
balenalib/qemux86-64-ubuntu-python,20230911,2023/09/11,42,20,4,0,0,66
okteto/guestbook,golang,2020/10/30,94,46,55,16,7,218
kasmweb/core-fedora-37,1.14.0,2023/09/09,null
balenalib/armv5e,20200221,2020/02/29,171,135,171,30,7,514
jetbrains/intellij-http-client,233.11799.6,2023/11/09,0,12,8,0,0,20
balenalib/bananapi-m1-plus-golang,20230904,2023/09/09,446,124,78,10,0,658
balenalib/ts4900-node,18.6-20220714,2022/07/21,127,79,77,18,0,301
vmware/nginx-photon,1.11.13,2017/11/21,8,63,80,49,0,200
redislabs/prometheus-redistimeseries-adapter,version-0.0.17,2020/05/12,2,19,45,4,0,70
pachyderm/goimage,778b7030efafdab9c9d33e97d5b7ea27508c62df,2020/07/14,2,10,32,4,0,48
redislabs/hoverfly,v0.17.7,2019/01/14,83,76,150,28,12,349
grafana/docker-desktop-extension,0.0.5,2023/09/27,0,5,7,0,0,12
mattermost/chaos-dashboard,v0.0.1,2021/08/11,91,44,59,13,7,214
bitnami/nats-exporter,0.13.0,2023/12/06,77,17,9,2,0,105
bellsoft/buildpacks.syft,1.26.0,1980/01/01,null
grafana/grafana-marketing-build,248877623c,2023/06/05,3,24,40,2,0,69
intel/intelligent_traffic_management,4.0,2022/03/23,439,1426,68,0,0,1933
atlassian/jira-core,9.11.3,2023/12/16,16,30,27,2,0,75
balenalib/intel-nuc-alpine-python,20231106,2023/11/07,0,7,2,0,0,9
rapidfort/memcached-ib,1.6.22,2023/10/25,94,41,0,0,0,135
kasmweb/postgres,1.12.0,2022/12/12,0,12,11,0,0,23
balenalib/odroid-xu4-alpine-openjdk,8-20231106,2023/11/07,0,6,2,0,0,8
rancher/dapper,19.03,2020/04/27,2,11,29,4,0,46
onlyoffice/wrata,v1.30.0-197-gb37558a,2023/11/10,0,20,9,0,0,29
airbyte/source-bigcommerce,0.2.0,2023/09/15,0,17,24,1,0,42
newrelic/k8s-nri-nginx,2.0.0,2020/01/28,2,11,29,4,0,46
ubuntu/redis,6.0-22.04_edge,2023/11/28,17,4,0,0,0,21
objectscale/zookeeper-operator,0.28.0,2019/10/09,0,0,0,2,0,2
rancher/helm-project-operator,v0.2.1,2023/06/26,0,13,7,0,1,21
amazon/aws-stepfunctions-local,1.13.2,2023/10/31,16,12,4,0,0,32
balenalib/up-board-ubuntu-python,20230911,2023/09/12,42,20,4,0,0,66
vmware/csp-driver,v1.13.1,2019/03/14,141,581,480,92,18,1312
docker/pipeline_scratch,0.2.0-alpha,2017/04/04,null
rancher/mirrored-library-nginx,1.24.0-alpine-s390x,2023/12/01,0,4,0,0,0,4
airbyte/normalization-tidb,0.4.3,2023/05/12,486,394,335,50,4,1269
balenalib/raspberry-pi2-debian-node,20230911,2023/09/12,121,47,43,6,0,217
balenalib/intel-nuc-alpine,20231106,2023/11/07,0,6,2,0,0,8
balenalib/generic-armv7ahf-debian-openjdk,20230904,2023/09/09,132,73,46,6,0,257
airbyte/connector-builder-server-wrapped,dev-9895397664,2023/08/19,20,77,77,2,0,176
hashicorp/dashboard-init,0.0.4,2018/11/15,0,0,6,14,0,20
rancher/submariner-route-agent,v0.0.1,2019/03/12,45,68,11,0,0,124
mirantis/ucp-kube-dns-sidecar,3.2.15,2021/06/29,0,0,0,2,0,2
astronomerinc/ap-nginx,1.9.4,2023/10/31,0,7,0,0,0,7
graphcore/pytorch-minimal,3.3.0,2023/07/03,133,186,27,0,0,346
ubuntu/grafana-agent,0.35.2-22.04,2023/12/12,12,11,5,0,0,28
pachyderm/example-python-spout-producer,6.x,2021/08/04,34,14,46,13,4,111
grafana/xk6,0.9.2,2023/06/13,468,170,133,15,2,788
airbyte/source-python-http-tutorial,0.1.3,2021/12/30,101,65,76,27,8,277
airbyte/source-postgres,3.2.21,2023/11/09,5,29,17,2,0,53
bitnami/orangehrm-archived,4.9.0-0,2022/01/17,289,287,187,32,13,808
docker/desktop-storage-provisioner,v2.0,2021/04/26,0,7,11,0,0,18
balenalib/beaglebone-green-wifi-fedora-golang,20220523,2022/06/05,null
snyk/snyk-docker-desktop-extension,0.7.4,2023/10/02,null
vmware/photon-2.0-calico-cni,v1.11.2-20180619,2018/06/19,15,72,90,57,0,234
grafana/enterprise-traces,v2.2.4,2023/10/26,0,4,3,0,0,7
intel/oact-rpc-go,v2.22.0,2023/11/07,0,1,0,0,0,1
amazon/aws-sam-cli-emulation-image-provided,20220125,2022/01/25,1,132,83,15,0,231
airbyte/source-tempo,0.3.1,2023/03/08,0,18,25,1,0,44
airbyte/source-customer-io,0.2.0,2023/08/29,0,17,24,1,0,42
newrelic/infrastructure,1.48.1,2023/11/02,0,12,0,0,0,12
balenalib/generic-aarch64-fedora-node,20231106,2023/11/06,0,1,1,0,0,2
balenalib/beaglebone-green-fedora-openjdk,30-20210825,2021/09/03,null
hashicorp/counting-init,0.0.9,2018/11/15,0,0,6,14,0,20
rancher/k3d,5.3.0,2022/02/03,9,79,84,17,0,189
atlassian/jira-servicedesk,5.11.3,2023/12/16,20,44,33,4,0,101
intel/gsg_nginx,12.0,2022/12/12,109,118,51,9,0,287
lacework/alert-evidence-materialization,2022-12-29_ANEP-1281_draft_4044af177dd2d4d11f902f86d0afc2916d800af1_RA,2022/12/29,102,271,6,0,0,379
rancher/coreos-prometheus-operator,v0.43.0,2020/10/27,1,8,13,0,0,22
okteto/vote-ssh,dev,2019/05/19,562,1499,1175,245,14,3495
airbyte/seed,0.101.0-alpha,2021/06/03,0,10,2,0,0,12
balenalib/via-vab820-quad-alpine-node,20220714,2022/07/19,7,44,34,10,0,95
datadog/agent-buildimages-windows_1809_x86,v3686353-1e75137,2021/01/12,8,50,134,12,0,204
intel/edge_to_azure_bridge,3.0,2022/04/14,76,93,6,0,0,175
bitnami/kaniko,1.18.0,2023/11/08,0,9,6,0,0,15
balenalib/generic-aarch64-fedora-python,20231106,2023/11/06,null
objectscale/dtsm,3.9.0.0-139102.b4b5064355c,2023/05/03,12,53,47,2,0,114
balenalib/aarch64-alpine-python,20231106,2023/11/06,0,7,2,0,0,9
balenalib/am571x-evm-fedora-openjdk,30-20210825,2021/09/03,null
percona/percona-xtrabackup,8.1.0-1,2023/10/19,101,39,2,0,0,142
balenalib/generic-armv7ahf-fedora-python,20221109,2022/11/16,0,1,0,0,0,1
hashicorp/dev-portal,sha-9855822,2023/01/12,3,143,54,6,0,206
pachyderm/metric-collector,v4,2023/03/31,97,45,36,3,4,185
rancher/ui-plugin-operator,v0.1.1,2023/04/04,0,8,7,0,1,16
balenalib/rpi-golang,20231106,2023/11/07,375,62,46,5,0,488
okteto/rust,1.47.0,2020/11/16,1483,1569,1200,199,40,4491
astronomerinc/ap-airflow,2.4.3-6,2023/03/31,114,97,52,11,0,274
datadog/agent-buildimages-datadog-ci-uploader,v22885174-c6364642,2023/11/06,100,160,13,0,0,273
grafana/celery-exporter,056e4f902d-linux-arm64,2023/10/20,1,4,2,0,0,7
balenalib/generic-armv7ahf-fedora-golang,20221210,2022/12/13,null
grafana/enterprise-logs-provisioner,v1.8.4,2023/10/18,0,2,2,0,0,4
grafana/phlare,0.6.1,2023/06/13,0,23,9,0,0,32
mirantis/ucp-openstack-ccm,3.5.3,2020/03/31,7,33,53,5,0,98
atlassian/confluence,8.6.1,2023/12/16,16,26,22,7,0,71
circleci/rabbitmq-delayed,3.8.9-management-38,2020/10/28,2,15,42,12,0,71
grafana/cortex-ruler,w37-0193e7b7,2018/09/11,0,0,0,2,0,2
airbyte/source-recruitee,0.1.0,2022/11/08,0,19,25,1,0,45
airbyte/source-github,20211124-rc1,2021/11/24,80,65,58,24,1,228
airbyte/connector-builder,0.40.17,2022/10/25,79,45,40,3,0,167
newrelic/nri-network-telemetry,v1.0.3,2020/05/19,2,11,27,4,0,44
hashicorp/levant,0.3.3,2023/10/05,0,4,1,0,0,5
rancher/istio-kubectl,1.5.10,2020/08/19,405,1076,128,0,0,1609
vmware/event-publisher-toolchain,0.2.8,2019/01/23,57,262,299,111,0,729
mattermost/cloud-thanos-store-discovery,v0.1.1,2021/12/08,0,17,24,1,0,42
balenalib/fincm3-golang,20230530,2023/06/27,382,68,50,8,0,508
apachepinot/thirdeye,0.5.0-SNAPSHOT-8900ebb99-20200904,2020/09/04,102,98,110,35,7,352
newrelic/deployer,v1.0.4,2023/11/07,813,757,540,30,2,2142
balenalib/stem-x86-32-alpine-node,16.19.1-20230712,2023/07/15,2,15,7,2,0,26
launchdarkly/ld-find-code-refs-github-action,2.11.4,2023/10/16,0,5,2,0,0,7
okteto/registry-configurator,0.1.5,2021/05/28,98,39,53,15,7,212
sysdig/workload-agent,3.0.1-experimental,2022/07/27,0,0,2,0,0,2
percona/pmm-client,2.40.1,2023/10/20,3,22,8,0,0,33
docker/ucp-interlock-config,3.3.1,2020/06/26,2,19,34,5,0,60
balenalib/kitra520-ubuntu,20220714,2022/08/02,87,91,11,0,0,189
graphcore/pytorch-geometric-jupyter,3.2.1,2023/05/31,320,526,27,0,0,873
greenbone/openvas-smb,22.5.4,2023/10/17,61,9,3,1,0,74
intel/data-analytics,2023.2-py3.10,2023/09/20,100,102,8,1,0,211
netdata/static-builder,v1,2023/12/20,null
airbyte/source-nasa,0.2.0,2023/10/25,0,15,24,1,0,40
okteto/daemon,0.4.0,2023/08/28,0,2,1,0,0,3
balenalib/colibri-imx6dl-ubuntu-openjdk,20210826,2021/09/04,136,435,10,0,0,581
bitnami/service-catalog-archived,0.3.1,2022/01/12,130,92,94,24,7,347
kasmweb/desktop-deluxe,1.14.0,2023/09/14,296,633,0,0,0,929
snyk/ubuntu,nlatest,2023/09/05,21,4,0,0,0,25
balenalib/intel-nuc-node,20231106,2023/11/06,117,31,32,4,0,184
onlyoffice/docs-docservice-ee,7.5.1-1,2023/11/09,16,3,1,1,0,21
rancher/mirrored-metrics-server,v0.6.3,2023/03/21,0,4,4,0,0,8
bitnami/attu,2.3.2,2023/11/23,80,18,8,2,0,108
docker/desktop-kubernetes-etcd,3.5.9-0,2023/05/16,0,16,12,0,0,28
balenalib/intel-nuc-ubuntu,20230911,2023/09/11,42,19,4,0,0,65
objectscale/kubectl,v1.25.15,2023/11/03,0,3,3,0,0,6
airbyte/source-xkcd,0.1.1,2022/10/24,0,17,17,0,0,34
astronomerinc/ap-nats-exporter,0.12.0-1,2023/11/08,0,5,2,0,0,7
mattermost/calls-recorder-daily,v0.4.2-dev,2023/08/16,0,3,1,0,0,4
airbyte/source-mssql,3.0.0,2023/11/07,5,29,17,2,0,53
airbyte/source-lokalise,0.1.0,2022/10/28,0,19,25,1,0,45
rancher/mirrored-thanos-thanos,v0.30.2,2023/01/31,0,5,4,0,0,9
mirantis/ucp-kube-gmsa-webhook,3.5.3,2019/07/17,null
airbyte/source-glassfrog,0.2.0,2023/08/30,0,17,24,1,0,42
hashicorp/vault-k8s,1.3.1,2023/10/25,0,3,2,0,0,5
balenalib/bananapi-m1-plus-debian-golang,20230904,2023/09/09,446,124,78,10,0,658
balenalib/am571x-evm-debian-openjdk,20210602,2021/06/05,222,249,144,39,9,663
balenalib/amd64,20231106,2023/11/06,110,29,22,4,0,165
objectscale/diagnostic-service,0.71.3,2021/04/15,17,149,226,36,6,434
airbyte/source-sftp-bulk,0.1.2,2023/04/19,81,41,27,2,0,151
rancher/hardened-sriov-network-config-daemon,14bd335c17c1b4c6cb7d37c2972c05cc62cadeeb-build20211119,2021/11/19,461,453,36,4,0,954
mirantis/ucp-sf-notifier,3.7.1,2023/09/26,3,8,4,0,0,15
pachyderm/iris-train,rstats-svm,2017/04/20,234,641,708,121,40,1744
rancher/os-logrotate,v1.5.8,2021/02/05,null
airbyte/connector-builder-server,0.50.34,2023/11/09,26,86,111,2,0,225
onlyoffice/box-gateway,1.0.1,2023/09/12,0,7,6,0,0,13
onlyoffice/4testing-docspace-nodejs-runtime,v1.0.0,2023/09/04,1013,190,239,16,0,1458
rancher/storage-abs,v0.9.7,2018/07/09,317,492,36,0,0,845
bitnami/tensorflow,2.14.0,2023/10/30,80,18,8,2,0,108
balenalib/ts4900-fedora-node,36-build-20220714,2022/07/22,0,1,1,0,0,2
atlassian/nucleus,88049123,2018/07/12,430,1227,888,242,52,2839
mirantis/ucp-interlock-config,3.7.1,2023/09/26,2,8,4,2,0,16
okteto/node-getting-started,1.0.0,2023/02/27,87,32,34,2,4,159
balenalib/rpi-debian-python,20231106,2023/11/07,110,44,30,4,0,188
balenalib/stem-x86-32-ubuntu,20210812,2021/08/22,108,183,10,0,0,301
airbyte/source-klarna,0.2.0,2023/10/23,0,15,24,1,0,40
intel/observability-telegraf,1.3.0,2023/09/21,0,7,7,0,0,14
mirantis/jnlp-slave,3.7-1,2018/07/11,571,2250,1647,277,27,4772
rancher/mirrored-library-traefik,2.10.5,2023/10/11,0,9,3,0,0,12
airbyte/source-facebook-marketing,20220315-rc1,2022/03/15,80,54,52,17,1,204
accurics/gitlab-connector,1.3,2021/06/11,0,13,40,4,0,57
airbyte/source-github-singer,0.2.8,2021/06/09,102,68,80,30,8,288
rancher/os-acpid,3929481,2017/02/03,null
couchbase/operator,2.5.0,2023/08/14,0,2,1,0,0,3
newrelic/newrelic-super-agent,nightly,2023/12/19,60,10,1,1,0,72
atlassian/deployment-locker,1.7,2021/08/04,null
kasmweb/terminal,1.14.0,2023/09/14,219,451,0,0,0,670
intel/multimodal-data-visualization-streaming,3.0,2022/07/28,151,381,43,0,0,575
rapidfort/zookeeper,3.9.1,2023/12/07,38,11,5,1,0,55
rancher/harvester-eventrouter,v0.1.1,2023/07/18,0,7,5,0,1,13
balenalib/asus-tinker-board-alpine-golang,20231106,2023/11/07,0,6,2,0,0,8
bitnami/node,20.9.0,2023/11/23,429,92,50,6,0,577
rancher/opni-preprocessing-service,v0.12.1-rc1,2023/11/10,2,11,20,0,10,43
bitnami/prometheus,2.47.2,2023/11/09,77,28,13,2,0,120
rancher/netes,v1.7.6-netes2-1,2017/09/23,597,900,62,1,0,1560
datadog/dd-lib-js-init,v4.18.0,2023/11/03,0,3,2,0,0,5
rancher/heapster-grafana-amd64,v4.4.3,2017/09/05,1,8,4,1,0,14
balenalib/i386-nlp-ubuntu-openjdk,20210225,2021/04/11,151,500,17,0,0,668
lacework/lacework-scan,1.2.0,2023/06/08,2,16,14,2,0,34
airbyte/source-qonto,0.2.0,2023/10/25,0,13,16,0,0,29
balenalib/nitrogen6x,20220714,2022/07/20,127,77,76,18,0,298
balenalib/hummingboard,20230904,2023/09/09,121,45,42,6,0,214
pachyderm/notebooks-user,v2.8.0-rc.2,2023/11/13,59,67,26,1,0,153
airbyte/integration-base,0.1.0,2023/01/18,2,84,250,17,0,353
grafana/tns-loadgen,842bd3b,2021/10/31,2,14,13,0,0,29
adobecoldfusion/coldfusion,latest-2023,2023/11/16,28,35,51,23,0,137
vmware/vss-remediation-worker,440-python3.8-alpine3.12,2023/09/27,66,236,168,28,0,498
rancher/network-manager,v0.8.8,2017/09/30,306,388,24,0,0,718
balenalib/revpi-core-3-alpine-openjdk,8-20231106,2023/11/07,0,6,2,0,0,8
balenalib/up-board-debian-python,20230712,2023/07/30,0,1,0,0,0,1
airbyte/source-appfollow,1.0.0,2023/08/21,142,88,44,3,0,277
rancher/mirrored-cilium-cilium,v1.14.4,2023/11/13,19,12,0,0,0,31
google/apigee-mart-server,1.8.0-preview.2,2022/02/18,10,29,28,3,5,75
rapidfort/oncall,v1.0.51,2023/11/17,0,21,18,1,0,40
docker/ecs-searchdomain-sidecar,1.0,2020/10/26,null
okteto/spring-boot-jib,debug2,1970/01/01,31,78,80,28,7,224
balenalib/asus-tinker-board-s-debian-golang,20230911,2023/09/12,446,124,78,10,0,658
docker/dtr,2.8.1,2020/06/17,5,29,37,4,0,75
airbyte/source-mongodb-v2,1.0.9,2023/11/14,5,29,17,2,0,53
okteto/admission-controller,0.2,2019/05/29,0,0,0,2,0,2
onlyoffice/dropbox-auth,1.0.0-rc7,2023/09/04,0,7,5,0,0,12
hashicorp/nomad-website,539195317e77b29c27ffbc0de027bbbf225e7e2cd2a97862659d2fc51dff90a7,2021/03/30,9,62,89,17,0,177
balenalib/asus-tinker-board-s,20230911,2023/09/11,121,45,42,6,0,214
rancher/dqlite-build,v1.4.1-r1,2020/04/23,null
rapidfort/envoy,1.27.1,2023/10/17,20,3,1,0,0,24
rancher/convoy-agent,v0.12.0,2016/09/30,null
astronomerinc/ap-e2e-test,0.3.6,2023/05/25,1104,490,306,20,4,1924
intel/intelligent_traffic_management_pipeline_server_init_dev,2.0,2022/11/15,45,52,5,0,0,102
balenalib/asus-tinker-board-s-ubuntu-python,20231026,2023/11/02,37,19,0,0,0,56
mirantis/dtr-notary-signer,3.0.0-alpha.2,2021/09/22,0,6,26,3,0,35
balenalib/fincm3-debian-node,20230530,2023/07/02,121,47,43,6,0,217
circleci/rabbitmq,3.7.7,2018/09/10,89,117,194,58,12,470
kasmweb/discord,1.14.0,2023/09/14,217,443,0,0,0,660
intel/opae-nlb-demo,0.28.0,2023/09/22,null
balenalib/colibri-imx6dl-alpine-node,20220714,2022/07/19,7,44,34,10,0,95
balenalib/beaglebone-green-wifi-alpine-python,20231106,2023/11/07,0,7,2,0,0,9
airbyte/container-orchestrator,0.50.34,2023/11/09,20,73,57,2,0,152
datadog/agent-buildimages-windows_1909_x64,v3686353-1e75137,2021/01/12,8,50,134,12,0,204
bellsoft/buildpacks.liberica,1.0.0,1980/01/01,0,4,2,0,0,6
mirantis/jenkins,2.121.3,2018/09/05,290,527,439,151,19,1426
pachyderm/chess-analyze,866d97ff6035463c92030b8f01b861c7,2016/12/01,640,1033,72,1,0,1746
google/dart,2.16-beta,2021/12/13,187,114,125,39,12,477
onlyoffice/docspace-studio-notify,1.1.4.1,2023/10/23,1024,157,214,13,0,1408
bitnami/minio-client,2023.11.10,2023/11/16,77,17,7,2,0,103
onlyoffice/docs-converter-ee,7.5.1-1,2023/11/09,16,3,0,0,0,19
docker/desktop-kubernetes-proxy,v1.28.2,2023/09/13,22,12,5,0,0,39
balenalib/am571x-evm-fedora-node,36-build-20220714,2022/07/22,0,1,1,0,0,2
kasmweb/core-oracle-9,1.14.0,2023/09/09,17,112,922,0,0,1051
balenalib/artik10-fedora,20220714,2022/07/23,null
kong/ubi-kuma-prometheus-sd,1.9.8,2023/07/28,40,48,9,0,0,97
purestorage/cockroach-operator,v1.2.2,2022/01/28,0,9,14,1,0,24
docker/embedded-docs-extension,0.0.1-alpha.2,2022/01/21,0,13,22,1,0,36
okteto/gradle,6.5,2023/08/24,170,328,40,2,0,540
intel/esp-logging-agent,v3.1.2,2023/08/17,92,40,31,6,0,169
astronomerinc/ap-openresty,1.21.4-12,2023/11/08,0,2,0,0,0,2
balenalib/bananapi-m1-plus-fedora-golang,20221210,2022/12/13,null
docker/ucp-calico-cni,3.3.1,2020/06/26,119,275,27,0,0,421
vmware/vfile,0.21,0001/01/01,0,16,8,2,0,26
balenalib/colibri-imx6dl-alpine-python,20220714,2022/07/19,7,44,35,10,0,96
airbyte/source-youtube-analytics-business,0.1.0,2022/11/09,0,19,25,1,0,45
bitnami/neo4j,5.13.0,2023/11/03,77,16,7,2,0,102
balenalib/artik710-python,20230829,2023/09/02,121,46,42,6,0,215
okteto/registry-auth,0.1.2,2020/02/05,3,19,41,4,0,67
balenalib/artik530-fedora-node,36-build-20220803,2022/08/04,0,1,1,0,0,2
rancher/opni-training-controller,v0.1.2,2021/07/12,185,159,143,44,9,540
balenalib/artik5-ubuntu-node,20220715,2022/08/02,88,92,12,0,0,192
mirantis/k8s-daemonupgradecontroller,1.5,2017/06/02,0,1,3,0,0,4
airbyte/source-apify-dataset,2.1.0,2023/10/13,0,16,24,1,0,41
airbyte/destination-firebolt,0.1.0,2022/06/27,81,51,46,9,0,187
hashicorp/packer,1.9.4,2023/08/18,1,8,7,1,0,17
pachyderm/pgbouncer,1.17.0-1,2022/05/05,455,325,219,22,1,1022
bitnami/sealed-secrets-controller,v0.24.3,2023/11/02,0,1,0,0,0,1
balenalib/apalis-imx6q-ubuntu-python,20220622,2022/06/23,87,122,13,0,0,222
datadog/watermarkpodautoscaler,v0.6.0,2023/10/10,64,23,8,0,0,95
grafana/loki-canary-boringcrypto,2.9.2,2023/10/25,0,4,3,0,0,7
dynatrace/dynatrace-activegate,1.277.180.20231107-134834,2023/11/07,24,6,0,0,0,30
rancher/git-porter,v2.0.0,2022/06/29,8,46,46,13,0,113
rancher/mirrored-calico-ctl,v3.26.3,2023/10/06,0,3,2,0,0,5
rancher/vm-ubuntu,18.04.1-server-amd64-old,2018/11/26,null
balenalib/raspberry-pi2-openjdk,20230911,2023/09/12,132,73,46,6,0,257
balenalib/beaglebone-green-debian-golang,20230911,2023/09/11,446,124,78,10,0,658
grafana/worldping-gw,37b8b2f,2017/11/23,0,1,1,0,0,2
airbyte/cli,0.40.15,2022/10/13,0,26,21,2,0,49
intel/xpumanager,v1.2.13,2023/06/29,24,27,5,0,0,56
graphcore/pytorch-jupyter,3.2.1,2023/05/31,320,524,26,0,0,870
lacework/ephemeral_job_controller_post_processor,20231113-main-9895c0e,1970/01/01,12,20,12,7,0,51
intel/oact-webui,v2.15.0,2023/10/31,0,2,0,0,0,2
grafana/github-repo-metrics,v2,2018/05/09,55,43,70,17,10,195
balenalib/artik533s-alpine-openjdk,8-jre-20220803,2022/08/04,31,90,43,10,0,174
intel/observability-collectd,1.0,2022/06/03,6,72,47,7,0,132
onlyoffice/documentserver-ie,6.0.2.5,2020/11/09,360,1043,60,0,0,1463
jetbrains/qodana-js,2023.2,2023/09/06,141,59,65,11,0,276
rancher/jenkins-jnlp-slave,3.40-1,2020/01/11,64,95,181,48,10,398
docker/ucp-nvidia-device-plugin,3.3.1,2020/06/26,5,26,25,1,0,57
google/cadvisor,v0.33.0,2019/02/27,0,0,8,8,0,16
rancher/mirrored-messagebird-sachet,0.3.1,2022/04/07,0,18,13,1,0,32
airbyte/base-airbyte-protocol-python,0.1.1,2021/04/03,102,63,79,30,8,282
amazon/amazon-ecs-network-sidecar,2.0.0,2022/12/23,3,23,15,0,0,41
balenalib/raspberry-pi2-ubuntu-openjdk,11-xenial-20231026,2023/11/02,null
pachyderm/mount-server-amd64,97276071e371d5b1ea221437e99cfd87b5599ddf,2023/11/03,91,23,30,2,1,147
bellsoft/liberica-openjre-debian,21.0.1-12,2023/11/14,106,26,19,4,0,155
balenalib/fincm3-debian-openjdk,20230530,2023/07/04,146,81,48,6,0,281
kasmweb/atom,1.14.0,2023/09/14,219,443,0,0,0,662
airbyte/destination-csv,1.0.0,2023/01/10,24,171,203,6,0,404
balenalib/armv5e-python,20191011,2019/10/29,183,177,177,35,9,581
balenalib/odroid-c1-alpine,20220714,2022/07/19,7,43,33,10,0,93
grafana/pyroscope,1.1.5,2023/10/12,0,10,8,0,0,18
kasmweb/only-office,1.14.0,2023/09/14,219,443,0,0,0,662
circleci/postgres,13.5,2021/12/18,119,89,79,26,0,313
balenalib/orbitty-tx2,20231106,2023/11/07,117,29,31,4,0,181
balenalib/beaglebone-green-wifi-alpine-openjdk,8-20231106,2023/11/07,0,6,2,0,0,8
vmware/pmdui-toolchain-photon2,1.0.0,2018/07/24,15,192,194,79,0,480
airbyte/source-facebook-marketing-api-singer,0.1.5,2020/12/16,568,381,313,41,8,1311
balenalib/nitrogen6x-ubuntu-node,20220715,2022/07/19,88,113,12,0,0,213
astronomerinc/ap-kube-state,2.10.0,2023/08/31,0,3,1,0,0,4
objectscale/dcm,0.71.3,2021/04/15,16,142,200,36,3,397
intel/rdma_rhel_intel,1.0,2023/04/11,105,80,9,0,0,194
rapidfort/mongodb-perfomance-test,7461f9faf40138c52dc31f5889eb04bddda66a43,2022/06/26,159,127,128,36,2,452
datadog/docker-dd-agent,12.9.5328,2020/10/08,128,88,109,27,7,359
pachyderm/test,9968828025df9eab37b9b01837c11a80cf624f75,2017/09/28,65,106,17,0,0,188
bitnami/pinniped-cli,0.27.0,2023/12/07,87,26,17,4,0,134
rancher/mirrored-directxman12-k8s-prometheus-adapter-amd64,v0.8.3,2021/01/26,null
balenalib/artik10-alpine-python,20220803,2022/08/04,7,44,35,10,0,96
pachyderm/ubuntu-with-s3-clients,v0.0.2,2022/02/18,347,735,69,0,0,1151
google/apigee-asm-istiod,1.12.9-asm.3,2022/09/30,74,144,14,0,0,232
kasmweb/hunchly,1.14.0,2023/09/14,219,443,0,0,0,662
balenalib/asus-tinker-board-ubuntu-openjdk,11-xenial-20231026,2023/11/02,null
google/apigee-runtime,1.8.0-preview.2,2022/02/18,10,36,34,3,5,88
airbyte/destination-dynamodb,0.1.7,2022/11/03,28,192,249,21,0,490
airbyte/source-workramp,0.1.0,2022/11/14,0,19,25,1,0,45
airbyte/source-instagram,1.0.14,2023/11/13,132,48,13,1,0,194
kasmweb/fedora-37-desktop,1.14.0,2023/09/14,0,4,2,0,0,6
objectscale/management-gateway,0.71.3,2021/04/02,5,52,64,5,2,128
balenalib/revpi-core-3-alpine-python,20231106,2023/11/07,0,7,2,0,0,9
newrelic/fastly-to-insights,1.3.2,2023/11/03,0,3,2,0,0,5
balenalib/armv5e-debian-golang,20200213,2020/02/19,674,546,492,64,10,1786
intel/mcss_covid19_solution,2021.4.2,2021/12/16,277,822,38,0,0,1137
newrelic/k8s-nri-couchbase,2.3.5,2020/02/03,2,10,29,4,0,45
cimg/php,8.2.12,2023/10/25,318,368,44,0,0,730
mattermost/builder,go-1.21.3-node-18.17.1-1,2023/10/12,492,124,92,10,2,720
appdynamics/ad-nite-demo-load,2019-03-13-1552504953,2019/03/13,0,0,4,8,0,12
newrelic/k8s-nri-postgresql,2.3.0,2020/01/03,null
appdynamics/analytics-agent,21.6.0,2021/07/13,129,124,40,4,0,297
airbyte/destination-clickhouse-strict-encrypt,0.2.5,2023/06/23,29,191,236,21,0,477
kong/kced,v0.1.16,2023/06/26,0,12,2,0,0,14
mirantis/ucp-containerd-shim-process,3.7.1,2023/07/28,0,4,2,0,0,6
kong/pulp-content,1.1.38,2022/08/24,4,14,10,4,0,32
airbyte/integration-base-singer,0.1.2,2021/08/02,102,63,79,30,8,282
balenalib/imx6ul-var-dart-fedora-python,20221109,2022/11/16,0,1,0,0,0,1
mattermost/mattermost-test-enterprise,8789a29,2020/03/28,6,47,80,9,0,142
mattermost/mattermost-loadtest,5.11,2019/06/21,205,534,557,123,24,1443
rancher/longhornio-longhorn-engine,v1.3.1,2022/08/11,9,82,86,3,14,194
rancher/ui,wagyu,2017/07/31,511,2270,1379,332,74,4566
mirantis/ucp-azure-ip-allocator,3.7.1,2023/09/26,2,9,4,2,0,17
airbyte/destination-meilisearch,1.0.0,2022/10/27,0,19,25,1,0,45
balenalib/odroid-xu4-python,20230911,2023/09/11,121,46,42,6,0,215
datadog/fips-proxy-dev,0.5.1-dev1,2023/05/17,31,21,2,0,0,54
airbyte/server,0.50.34,2023/11/09,21,73,57,2,0,153
airbyte/source-twilio-singer,0.2.3,2021/06/09,563,349,295,40,8,1255
grafana/agent,v0.37.4,2023/11/06,14,9,1,0,0,24
intel/esp-qemu,v3.1.2,2023/08/16,7,99,77,21,0,204
intel/dlstreamer-edge-ai-extension,0.7.1,2022/05/24,342,1255,52,0,0,1649
balenalib/hummingboard-debian-golang,20230904,2023/09/09,446,124,78,10,0,658
bitnami/ruby,3.2.2,2023/12/02,432,96,50,6,0,584
graphcore/pytorch-tutorials,3.1.0,2023/01/04,424,928,39,1,0,1392
rancher/secrets-bridge,v0.2.0,2016/11/27,null
greenbone/openvas-scanner-build,v22.7.6,2023/10/11,500,110,63,6,0,679
airbyte/source-sendgrid,0.4.1,2023/10/15,65,28,7,1,0,101
airbyte/source-shopify,1.1.4,2023/10/19,65,28,7,1,0,101
ddosify/selfhosted_backend,2.3.1,2023/11/01,414,122,62,4,0,602
hashicorp/consul-ecs,0.7,2023/12/18,0,5,2,0,0,7
rancher/os-pingan,v1.5.8,2021/02/05,133,91,104,23,7,358
circleci/vault-cci,0.4,2021/12/14,3,42,53,14,0,112
rancher/calico-cni,v3.18.1,2021/03/10,0,24,42,0,0,66
bitnami/dokuwiki,20230404.1.0,2023/12/02,163,88,60,5,0,316
rancher/alpine-git,1.0.4,2017/07/27,0,30,12,17,0,59
airbyte/source-google-analytics-data-api,2.0.3,2023/11/03,68,31,8,1,0,108
bitnami/openldap,2.6.6,2023/12/15,95,20,17,2,0,134
rancher/hardened-dns-node-cache,1.22.20-build20231010-s390x,2023/10/10,3,14,17,0,5,39
airbyte/source-s3-bulk,4.1.3-dev.cc832795bb,2023/11/14,132,47,12,2,0,193
balenalib/generic-aarch64-fedora-openjdk,8-20231106,2023/11/06,null
balenalib/generic-aarch64-alpine-openjdk,8-20231106,2023/11/06,8,14,2,0,0,24
jetbrains/datalore-agent,2023.5.1,1970/01/01,184,241,43,0,0,468
rancher/mirrored-neuvector-registry-adapter,0.1.1,2023/08/17,0,2,2,0,0,4
airbyte/source-commercetools,0.2.0,2023/08/24,0,17,24,1,0,42
balenalib/artik10-alpine,20220803,2022/08/03,7,43,33,10,0,93
continuumio/ap-auth-keycloak,4.5.0.Final,2018/10/16,876,1206,355,88,0,2525
cockroachdb/molt-lms,0.2.2,2023/11/13,0,8,2,0,0,10
airbyte/destination-s3-glue,0.1.7,2023/05/04,29,190,233,21,0,473
google/apigee-installer,1.8.1,2022/09/22,0,3,6,0,0,9
balenalib/spacely-tx2-fedora-golang,20231106,2023/11/06,null
okteto/fileserver,0.0.0,2021/12/17,null
redislabs/redis-connect-sqlserver,0.8.0-139,2022/01/22,4,28,38,13,0,83
bitnami/milvus,2.3.3,2023/12/15,77,19,11,2,0,109
airbyte/webapp,0.50.34,2023/11/09,0,8,1,0,0,9
balenalib/intel-nuc-fedora-golang,20231103,2023/11/04,null
rancher/tektoncd-kubeconfigwriter,2000fdb7,2019/05/29,0,0,0,0,6,6
datadog/observability-pipelines-worker,1.6.0,2023/11/03,28,16,0,0,0,44
pachyderm/python-build,2.0.0-alpha.20,2021/05/25,1442,1329,929,143,40,3883
balenalib/hummingboard-ubuntu-openjdk,11-xenial-20230904,2023/09/09,null
airbyte/source-quickbooks,3.0.0,2023/09/27,0,17,24,1,0,42
docker/binfmt,820fdd95a9972a5308930a2bdfb8573dd4447ad3,2019/05/20,null
hashicorp/learn-website,85289765ffa05e170f7e2faedbbfefa46cd3d8d8e4b307fabae676ce5bf0e131,2020/07/27,18,131,201,40,0,390
rancher/mirrored-ingress-nginx-kube-webhook-certgen,v1.3.0,2022/08/01,0,3,6,0,0,9
airbyte/base-python-test,0.1.1,2021/04/03,102,63,79,30,8,282
airbyte/source-zendesk-support-singer,0.2.3,2021/07/02,102,67,81,30,8,288
intel/intel-idxd-config-initcontainer,0.28.0,2023/09/22,null
bitnami/mysqld-exporter,0.15.0,2023/12/06,77,19,8,2,0,106
rapidfort/etcd-ib,v3.5.10,2023/11/24,2,4,2,0,0,8
grafana/prometheus-pulsar-remote-write,v0.3.0,2023/03/09,0,18,6,0,0,24
intel/oneapi-iotkit,2023.2.1-devel-ubuntu22.04,2023/07/31,185,187,33,0,0,405
balenalib/artik533s-debian-golang,20220714,2022/07/22,471,278,225,29,1,1004
airbyte/source-genesys,0.1.0,2022/11/13,0,17,17,0,0,34
pachyderm/jupyterhub-pachyderm-user,1.1.0,2020/04/15,131,132,56,4,0,323
google/tf-serving-scann,2.11.0,2022/12/08,160,319,36,0,0,515
airbyte/source-google-search-console,1.3.6,2023/10/26,65,28,7,1,0,101
balenalib/raspberrypi3-fedora-golang,20220523,2022/06/04,null
rancher/lb-controller,v0.3.1,2016/10/16,0,9,27,8,0,44
okteto/charts,dev,2020/12/19,25,79,78,12,0,194
docker/ucp-interlock-proxy,3.3.1,2020/06/26,2,19,34,5,0,60
datadog/dd-trace-py,testrunner,2023/02/17,730,339,287,25,4,1385
balenalib/nitrogen6x-ubuntu-openjdk,20210826,2021/09/04,136,435,10,0,0,581
balenalib/qemux86-64-debian-openjdk,20231106,2023/11/06,128,52,33,4,0,217
airbyte/source-zendesk-sunshine,0.2.0,2023/08/24,0,17,24,1,0,42
bellsoft/buildpacks.spring-boot,5.23.0,1980/01/01,null
redislabs/redisml,edge,2019/02/21,49,24,49,9,7,138
docker/kube-compose-api-server,v0.5.0,2022/02/14,0,6,14,1,0,21
kong/inso,2023.5.8,2023/09/07,0,14,8,1,0,23
datadog/agent-buildimages-deb_x64,v20433308-6861270,2023/09/25,3,26,22,1,0,52
balenalib/via-vab820-quad-fedora-golang,20220507,2022/05/12,null
balena/rpi-supervisor,1299,2020/07/31,6,26,55,9,0,96
kasmweb/postman,1.14.0,2023/09/14,221,467,12,8,0,708
balenalib/raspberrypi3-alpine-golang,20231106,2023/11/07,0,6,2,0,0,8
objectscale/objectscale-lcm,1.3.0-274.bf1767e,2023/11/14,0,7,5,0,0,12
sysdig/node-image-analyzer,0.1.29,2023/10/17,103,61,8,0,0,172
airbyte/source-mailchimp,0.8.2,2023/11/14,65,28,8,1,0,102
docker/dtr-api,2.8.1,2020/06/17,7,73,99,18,1,198
airbyte/source-dixa,0.3.0,2023/10/30,0,15,24,1,0,40
intel/alpine,test-rm,2023/01/09,0,20,16,0,0,36
rancher/os2-framework,5517767-amd64,2021/10/22,32,224,199,8,8,471
kong/kubernetes-ingress-controller,3.0,2023/11/22,null
balenalib/artik533s-ubuntu-golang,20220803,2022/08/03,245,468,66,0,0,779
balenalib/armv7hf-fedora-python,20221031,2022/11/04,0,1,1,0,0,2
intel/rpbs_benchmark_service,1.0,2023/08/21,50,47,7,0,0,104
rancher/os-nvidiadriver,v1.5.8,2021/02/05,1363,1414,149,3,1,2930
onlyoffice/docs-spellchecker-de,6.2.2.17,2021/04/27,544,498,32,3,0,1077
balenalib/apalis-imx6q-alpine-golang,20220714,2022/07/27,8,45,38,12,0,103
rancher/rke-tools,v0.1.96,2023/10/30,1,24,18,0,0,43
bitnami/prometheus-rsocket-proxy,1.5.3,2023/12/09,77,28,23,4,0,132
rancher/busybox,1.31.1,2020/06/02,null
dynatrace/dynatrace-synthetic-vuc,1.277.38.20231010-152746,2023/10/10,22,16,5,0,0,43
mattermost/mattermost-team-edition,19698_b6746054,2023/07/31,62,65,10,0,0,137
rancher/telemetry,v0.6.1,2019/10/31,108,74,12,0,0,194
rancher/harvester-load-balancer,v0.2.2,2023/12/08,1,5,5,0,0,11
appdynamics/machine-agent-analytics,23.10.0,2023/10/30,133,34,8,1,0,176
onlyoffice/4testing-appserver-migration,test-2022081607,2022/08/16,1045,346,362,25,1,1779
tenable/audit-utils,20231109.14,2023/11/09,22,12,0,0,0,34
amazon/aws-cli,2.13.35,2023/11/13,16,3,0,0,0,19
kasmweb/opensuse-15-desktop,1.14.0,2023/09/14,6,51,64,3,1,125
rancher/mirrored-sig-storage-csi-node-driver-registrar,v2.9.1,2023/11/09,0,0,1,0,0,1
rapidfort/redis6-ib,6.2.14,2023/10/25,87,41,0,0,0,128
bitnami/consul-exporter,0.9.0,2023/12/06,77,19,11,2,0,109
bitnami/jruby,9.4.3-0,2023/12/02,429,97,50,5,0,581
mirantis/external-dns,v0.5.3,2018/06/15,0,2,2,2,0,6
rancher/mirrored-grafana-grafana-image-renderer,3.8.0,2023/08/25,0,7,8,1,4,20
appdynamics/dotnet-core-agent,23.10.0,2023/10/20,null
docker/cloudbees-jenkins-distribution,2.277.4.2,2021/04/28,251,218,309,79,13,870
airbyte/source-netsuite,0.1.3,2023/01/20,0,16,17,0,0,33
google/apigee-cassandra-backup-utility,1.8.0-preview.2,2022/01/20,9,36,31,6,5,87
redislabs/redisgears,1.2.5,2022/07/05,118,88,89,25,2,322
mirantis/ucp-nvidia-device-plugin,3.7.1,2023/09/26,34,45,9,0,0,88
rancher/nginx-ingress-controller,0.10.2,2018/01/25,88,108,197,64,9,466
bitnami/redis-sentinel-exporter-archived,1.7.1,2021/07/18,129,90,88,25,7,339
greenbone/gvmd,23.1,2023/11/14,97,22,16,2,0,137
onlyoffice/docs-converter,7.5.1-1,2023/11/09,16,3,0,0,0,19
airbyte/bootloader,0.50.34,2023/11/09,21,73,56,2,0,152
balenalib/ts4900-debian-golang,20220714,2022/07/28,471,275,219,29,1,995
atlassian/nfs-server-test,2.1,2023/02/02,228,164,20,0,0,412
rancher/mirrored-prometheus-prometheus,v2.42.0,2023/02/01,0,16,11,0,0,27
docker/extended-logs-extension,0.1.2,2022/04/28,0,14,8,1,0,23
balenalib/artik10-fedora-golang,20220714,2022/07/23,null
balenalib/hummingboard-openjdk,20230904,2023/09/09,132,73,46,6,0,257
airbyte/source-salesforce-singer,0.2.5,2021/08/02,559,324,281,40,8,1212
airbyte/source-tmdb,0.1.0,2022/11/16,0,19,25,1,0,45
airbyte/workload-api-server,final-0,2023/11/14,20,69,54,2,0,145
bitnami/nginx-ldap-auth-daemon-archived,0.20200116.0,2022/04/05,134,89,81,22,7,333
rancher/coreos-configmap-reload,v0.0.1,2017/01/02,null
balenalib/orangepi-plus2,20230911,2023/09/11,121,45,42,6,0,214
hashicorp/sentinel-website,621533a472164fac1133e38562d81440dc48783a,2020/07/06,13,82,133,29,0,257
airbyte/source-my-hours,0.1.1,2022/06/09,0,19,26,1,0,46
ddosify/selfhosted_hammermanager,1.2.2,2023/06/20,78,36,24,2,0,140
balenalib/imx6ul-var-dart-python,20230911,2023/09/12,121,46,42,6,0,215
objectscale/csi-baremetal-loopbackmgr,0.69.0,2021/03/07,68,69,16,0,0,153
balenalib/via-vab820-quad-alpine,20220714,2022/07/19,7,43,33,10,0,93
mirantis/ucp-calico-node,3.7.1,2023/09/26,33,23,8,0,0,64
rancher/storage-nfs,v0.9.7,2018/07/09,125,242,12,0,0,379
docker/ucp-azure-ip-allocator,3.3.1,2020/06/26,2,8,7,1,0,18
datadog/agent-amd64,7.29.1,2021/07/12,34,130,102,5,0,271
hashicorp/terraform-k8s,1.1.2,2022/11/23,0,18,19,1,0,38
balenalib/odroid-c1,20220714,2022/07/20,127,77,76,18,0,298
datadog/chaos-handler,8.3.0,2023/10/26,null
rancher/favorite-tweets,v1.0.2,2019/02/11,589,1565,1275,267,16,3712
rancher/goreleaser,v0.0.1-alpha,2023/03/07,5,51,31,8,0,95
rancher/hardened-whereabouts,v0.6.2-build20231009,2023/10/09,2,12,14,0,5,33
airbyte/source-datadog,0.3.0,2023/08/29,0,17,24,1,0,42
grafana/pdc-agent,0.0.20,2023/11/08,0,3,2,0,0,5
balenalib/asus-tinker-board-golang,20230904,2023/09/09,446,124,78,10,0,658
atlassian/pipelines-agent-log-sidecar,stg-stable,2019/07/03,85,171,172,44,11,483
intel/image-segmentation,tf-spr-3d-unet-mlperf-inference,2023/03/31,33,26,6,0,0,65
balenalib/orangepi-plus2-ubuntu-openjdk,11-xenial-20231026,2023/11/02,null
rancher/mirrored-kube-rbac-proxy,v0.14.0,2022/12/15,0,4,5,0,0,9
kong/kong-build-tools,rpm-1.8.3,2023/02/16,908,1010,48,0,0,1966
balenalib/up-board-alpine,20231106,2023/11/07,0,6,2,0,0,8
okteto/doppler-injector,0.2,2019/02/15,4,14,8,2,0,28
balenalib/artik533s-ubuntu-openjdk,20210826,2021/09/21,136,435,10,0,0,581
rancher/mirrored-jettech-kube-webhook-certgen,v1.5.2,2021/04/07,0,6,10,0,5,21
balenalib/raspberrypi3-golang,20230530,2023/06/27,382,68,50,8,0,508
rancher/mirrored-kiwigrid-k8s-sidecar,1.24.6,2023/07/06,0,12,3,3,0,18
balenalib/zynq-xz702-fedora-node,36-build-20220714,2022/07/22,0,1,1,0,0,2
balenalib/parallella-ubuntu,20230904,2023/09/09,42,19,4,0,0,65
kasmweb/api,1.14.0,2023/09/14,28,15,1,0,0,44
rancher/os-iscsi,v2.0.873-2,2019/07/23,556,1490,1159,245,14,3464
bitnami/grafana-image-renderer,3.8.4,2023/10/27,164,81,66,5,0,316
bitnami/fluxcd-source-controller,1.1.2,2023/11/15,78,22,9,2,0,111
mattermost/matterwick,v0.3.17,2023/11/14,6,38,14,1,0,59
atlassian/pipelines-docker-daemon,v20-beta,2021/03/04,10,57,62,9,0,138
mattermost/poc-simple-service-daily,v0.0.4,2022/06/22,0,5,5,0,0,10
mattermost/calls-offloader,v0.4.1,2023/10/12,3,12,6,0,0,21
astronomerinc/ap-build,0.3.0-2,2023/08/03,192,237,48,0,0,477
intel/intel-optimized-ml,xgboost-1.4.2,2021/09/07,79,80,8,1,0,168
airbyte/source-postgres-singer,0.1.4,2020/10/26,586,419,394,43,12,1454
atlassian/agent-setup-git,1.6,2016/06/28,1,62,59,23,0,145
balenalib/ts4900-debian-python,20220604,2022/06/12,127,90,78,20,0,315
balenalib/odroid-c1-debian-node,18.6-20220714,2022/07/21,127,79,77,18,0,301
rancher/kolla-base,mitaka,2016/06/16,435,2520,1677,451,78,5161
rancher/docker-elasticsearch-kubernetes,5.6.2,2017/09/28,17,76,47,13,0,153
hashicorp/envoy,1.27.2,2023/12/11,7,0,0,0,0,7
grafana/enterprise-metrics-boringcrypto,v2.10.4,2023/11/14,0,4,2,0,0,6
rancher/mirrored-prometheus-operator-prometheus-operator,v0.65.1,2023/05/05,0,4,3,0,0,7
balenalib/amd64-ubuntu,20230929,2023/10/07,39,16,4,0,0,59
redislabs/debezium-server,2.0.0.cassandra,2022/11/28,124,208,49,1,0,382
datadog/agent-buildimages-windows_1909_x86,v3686353-1e75137,2021/01/12,8,50,134,12,0,204
airbyte/source-zendesk-singer,0.1.1,2020/12/11,102,86,91,31,8,318
mattermost/chimera,6908324,2021/09/22,0,3,6,0,5,14
newrelic/infrastructure-bundle,3.2.25-rc,2023/11/15,0,18,2,0,0,20
balenalib/hummingboard-debian-python,20230904,2023/09/09,121,46,42,6,0,215
balenalib/armv7hf-debian-openjdk,20230929,2023/10/02,125,73,38,6,0,242
balenalib/parallella-debian,20230904,2023/09/09,121,45,42,6,0,214
rancher/webhook-receiver,v0.2.7,2022/06/08,0,10,7,1,2,20
bellsoft/alpaquita-linux-base,stream-musl-231114,2023/11/14,null
okteto/git-installer,1.2.9,2021/03/11,231,166,191,46,16,650
amazon/opendistro-for-elasticsearch,1.13.3,2021/12/11,566,577,116,10,0,1269
rancher/mirrored-sig-storage-snapshot-controller,v6.2.1,2023/01/04,0,2,2,0,0,4
kasmweb/core-remnux-focal,1.13.1,2023/06/06,274,567,0,0,0,841
vmware/vsphere-storage-for-docker,0.21,0001/01/01,0,1,5,2,0,8
airbyte/source-e2e-test-cloud,2.1.5,2023/10/07,9,49,81,17,0,156
airbyte/destination-weaviate-preview,dev2,2023/09/18,66,33,9,4,0,112
rancher/mirrored-coreos-prometheus-operator,v0.40.0,2020/06/18,0,9,12,0,0,21
greenbone/gvm-libs,23.3.0,2023/03/30,93,40,26,2,0,161
rancher/mirrored-kubernetes-external-dns,v0.7.3,2020/08/05,4,22,46,4,0,76
bitnami/dotnet,7.0.14,2023/12/02,432,92,52,6,0,582
objectscale/objectscale-performance,1.4.0-397.adb0726,2023/11/13,0,5,4,0,0,9
objectscale/ecs-flex-vsphere-plugin,0.71.3,2021/04/14,5,52,64,5,2,128
airbyte/source-mailerlite,0.1.0,2022/10/28,0,19,25,1,0,45
greenbone/notus-scanner,22.6,2023/11/20,74,20,10,1,0,105
balenalib/raspberry-pi2-alpine-python,20231106,2023/11/07,0,7,2,0,0,9
rancher/rke-service-sidekick,v0.1.2,2018/04/02,null
airbyte/integration-singer-postgres-destination,0.1.2,2020/10/08,578,426,399,42,12,1457
datadog/fakeintake,v94025128,2023/07/04,22,11,2,0,0,35
cockroachdb/tpc-e,master,2023/04/27,72,28,20,2,0,122
rancher/os-waagent,v2.2.34-1,2019/01/14,73,165,170,42,19,469
google/apigee-envoy-adapter,v2.1.1,2023/06/07,0,6,8,0,0,14
airbyte/destination-rockset,0.1.4,2022/08/08,82,104,128,34,0,348
airbyte/source-e2e-test,2.1.5,2023/10/06,9,49,81,17,0,156
kasmweb/oracle-8-desktop,1.14.0,2023/09/14,14,123,958,0,0,1095
balenalib/beaglebone-green-wifi-debian-node,20230911,2023/09/12,121,47,43,6,0,217
balenalib/kitra710-debian-python,20230829,2023/09/02,121,46,42,6,0,215
airbyte/airbyte-bigquery-destination-abprotocol,0.1.0,2020/10/20,97,81,87,24,7,296
intel/user-oob-client-for-azure,v0.7,2022/09/13,179,454,41,0,0,674
balenalib/artik10-ubuntu,20220714,2022/08/02,87,91,11,0,0,189
astronomerinc/ap-git-sync,3.6.9,2023/08/16,100,30,31,5,2,168
astronomerinc/ap-git-daemon,3.18.4-1,2023/11/06,0,6,0,0,0,6
balenalib/raspberry-pi2-debian,20230911,2023/09/11,121,45,42,6,0,214
balenalib/artik10-alpine-golang,20220803,2022/08/04,8,45,38,12,0,103
balenalib/beaglebone-black-debian-openjdk,20230911,2023/09/12,132,73,46,6,0,257
airbyte/destination-elasticsearch,0.1.6,2022/10/26,24,171,204,6,0,405
balenalib/colibri-imx6dl-debian-python,20220604,2022/06/12,127,90,78,20,0,315
amazon/aws-sam-cli-emulation-image-go1.x,20220125,2022/01/25,1,132,83,15,0,231
objectscale/telegraf,0.54.0,2020/11/06,2,49,53,6,2,112
bitnami/golang,1.21.4,2023/11/08,421,91,49,6,0,567
bellsoft/buildpacks.java-native-image,1.0.0,1980/01/01,0,4,2,0,0,6
intel/recommendation,wide-deep-large-ds-int8-inference,2021/07/24,674,988,164,7,0,1833
rancher/ui-plugin-catalog,1.0.1,2023/10/03,3,11,15,0,5,34
bitnami/oras,1.1.0,2023/12/06,null
bitnami/kubeapps-oci-catalog,2.9.0,2023/11/25,77,16,7,2,0,102
amazon/aws-virtual-gpu-device-plugin,v0.1.1,2020/03/03,21,380,239,23,0,663
airbyte/source-freshcaller,0.3.0,2023/11/07,0,15,24,1,0,40
rancher/mirrored-istio-mixer,1.7.8,2021/02/24,1,10,15,1,5,32
amazon/aws-lambda-provided,alami.2023.11.12.08,2023/11/12,0,3,0,0,0,3
intel/reconfigurable-ri-server,4.0,2022/12/21,32,42,25,4,0,103
airbyte/source-db2-strict-encrypt,0.1.19,2023/03/22,25,174,193,6,0,398
objectscale/resource-service,0.71.3,2021/04/15,16,142,200,36,3,397
bitnami/memcached-exporter,0.13.0,2023/11/08,77,19,8,2,0,106
portainer/pri-fidoiot,rv-master,2022/02/02,94,253,8,4,0,359
docker/dtr-notary-signer-s390x,2.5.0-beta3,2018/01/17,0,16,41,34,0,91
onlyoffice/docspace-login,1.1.4.1,2023/10/23,1011,165,219,13,0,1408
balenalib/beaglebone-black-debian-python,20230911,2023/09/12,121,46,42,6,0,215
rancher/rancher-flexvol,567229c-dirty,2016/09/14,97,122,23,0,0,242
balenalib/artik5-python,20220714,2022/07/22,127,78,78,18,0,301
rancher/k8s-dns-sidecar-amd64,1.15.0,2018/11/12,0,0,0,2,0,2
google/apigee-udca,1.8.0-preview.2,2022/04/05,7,30,34,3,5,79
airbyte/destination-redshift,0.6.10,2023/11/09,11,75,63,17,0,166
intel/spark,evi-2.0.0,2022/10/31,67,153,314,137,0,671
airbyte/destination-starburst-galaxy,0.0.1,2023/04/21,31,202,251,25,0,509
airbyte/source-cart,0.2.1,2023/02/23,0,18,25,1,0,44
grafana/loki-query-tee,2.9.2-amd64,2023/10/25,0,4,3,0,0,7
balenalib/asus-tinker-board-s-debian,20230911,2023/09/11,121,45,42,6,0,214
balenalib/nitrogen6x-debian-openjdk,20210602,2021/06/05,222,249,144,39,9,663
circleci/python,3.11-rc,2021/12/18,873,1069,812,104,5,2863
balenalib/hummingboard-fedora-node,36-build-20230530,2023/06/29,0,1,1,0,0,2
airbyte/source-elasticsearch,0.1.1,2022/12/02,24,170,203,6,0,403
balenalib/beaglebone-black-ubuntu-openjdk,11-xenial-20230712,2023/07/14,null
airbyte/source-pocket,0.1.0,2022/11/10,0,19,25,1,0,45
balenalib/spacely-tx2-ubuntu-openjdk,11-xenial-20231103,2023/11/06,null
airbyte/source-captain-data,0.1.0,2023/07/25,0,17,24,1,0,42
rancher/fluentd,v0.1.31,2021/11/16,76,70,55,20,0,221
adobecoldfusion/pmt2021,2021.0.4,2022/12/02,60,95,60,27,0,242
circleci/mariadb,10.7.1,2022/02/22,111,329,8,0,0,448
okteto/golang-http-template,0.1.1,2020/06/01,705,548,509,65,12,1839
pachyderm/tf_job_s3_gateway,1.9.2,2019/08/02,462,737,173,18,0,1390
rancher/git-mirror,v2.0.0,2022/06/29,4,30,27,7,0,68
airbyte/source-sftp,0.1.2,2022/06/17,77,80,62,19,0,238
rancher/k8s-dns-dnsmasq-nanny-amd64,1.15.0,2018/11/12,0,0,0,2,0,2
rancher/mongodb-conf,v0.1.1,2017/02/27,null
grafana/grafana-image-renderer,3.8.4,2023/10/19,0,5,3,1,4,13
airbyte/mirrored-keycloak,21.1,2023/06/28,19,38,7,0,0,64
intel/dlstreamer-pipeline-server-k8s-sidecar,2022.2.0,2022/10/22,78,40,38,3,0,159
newrelic/php-daemon,10.14.0,2023/11/13,null
bitnami/schema-registry,7.5.2,2023/12/09,77,22,17,8,0,124
rancher/mirrored-istio-install-cni,1.19.0,2023/09/01,29,22,8,0,0,59
balenalib/beaglebone-green-wifi-alpine-golang,20231106,2023/11/07,0,6,2,0,0,8
rancher/mirrored-neuvector-updater,latest-amd64,2023/12/18,null
onlyoffice/4testing-docspace-notify,2.0.0.33,2023/11/24,1024,156,211,13,0,1404
balenalib/fincm3-ubuntu-python,20230530,2023/07/02,54,30,4,0,0,88
puppet/estate-reporting-query,85360599b21e795d92898b540e0faac15c0b2d7b,2020/03/24,0,5,5,0,0,10
balenalib/fincm3-ubuntu-node,20230530,2023/07/04,55,30,5,0,0,90
apachepinot/pinot-presto,0.274,2022/07/20,1111,569,880,114,3,2677
balenalib/beaglebone-green-debian,20230911,2023/09/11,121,45,42,6,0,214
balenalib/artik5-debian,20220714,2022/07/22,127,77,76,18,0,298
google/apigee-stackdriver-prometheus-sidecar,1.0.0-beta,2019/03/25,null
newrelic/k8s-golang-apm-linkage-demo,1.1.0,2019/04/01,6,20,11,2,0,39
dynatrace/dynatrace-push-event-bitbucket-pipe,0.1.0,2021/04/15,4,10,9,1,0,24
rancher/calico-node,v3.18.1,2021/03/11,60,109,32,0,0,201
atlassian/agent-setup-hg,1.15,2016/06/30,0,57,44,18,0,119
rancher/cli2,v2.8.0,2023/10/23,0,11,12,0,4,27
bitnami/nginx-exporter,0.11.0,2023/12/07,77,16,7,2,0,102
airbyte/destination-mysql,0.2.0,2023/06/29,29,190,236,21,0,476
syncfusion/pdfviewer-server,23.1.36,2023/09/15,189,117,56,4,0,366
balenalib/kitra520-fedora,20220714,2022/07/23,null
okteto/syncthing,1.3.0,2019/10/07,4,20,21,1,0,46
qualys/qualys-client-for-jira-integration,1.2.0,2023/10/13,6,11,8,0,0,25
okteto/dns,0.1.0,2020/06/13,3,21,41,4,0,69
mirantis/virtlet,v1.5.1,2019/05/16,339,505,35,0,0,879
okteto/node,18,2023/08/24,489,313,105,10,2,919
objectscale/csi-baremetal-scheduler,0.69.0,2021/03/07,72,85,27,1,0,185
airbyte/source-paystack,0.1.3,2023/03/21,0,18,25,1,0,44
balenalib/odroid-xu4-fedora-openjdk,30-20210825,2021/09/03,null
balenalib/revpi-core-3-ubuntu-golang,20231026,2023/11/02,135,137,1,0,0,273
rancher/mirrored-k8s-dns-kube-dns,1.22.20,2023/02/22,0,2,1,0,0,3
redislabs/rgcluster,1.2.7,2022/07/05,118,88,89,29,2,326
rancher/opni-training-controller-service,v0.12.1-rc1,2023/11/10,8,86,100,6,14,214
rancher/istio-pilot,1.8.3,2021/02/05,302,919,127,2,0,1350
balenalib/armv5e-debian-openjdk,20200221,2020/02/29,245,298,213,44,9,809
formio/sql-connector,2.0.10,2022/09/22,5,88,84,14,0,191
mirantis/ucp,3.7.1,2023/09/26,4,13,8,2,0,27
balenalib/amd64-alpine-golang,20231106,2023/11/07,0,6,2,0,0,8
kasmweb/agent,1.14.0,2023/09/14,25,13,0,0,0,38
balenalib/asus-tinker-board-fedora-python,20221109,2022/11/16,0,1,0,0,0,1
mattermost/mm-ee-test,9986853,2023/05/07,71,105,13,0,0,189
rancher/openzipkin-zipkin,2.14.2,2019/06/15,5,43,84,31,6,169
rancher/system-agent-installer-k3s,v1.28.3-k3s2-linux-s390x,2023/11/08,null
mirantis/ucp-pause,3.7.1,2022/12/22,null
bitnami/mongodb,7.0.3,2023/11/22,84,27,12,3,0,126
percona/mongodb_exporter,2.37.0,2023/04/06,0,3,3,0,0,6
airbyte/source-drift,0.3.0,2023/08/15,0,17,24,1,0,42
rancher/gc-manager,v0.1.0,2017/05/17,97,113,18,0,0,228
balenalib/apalis-imx6q-debian,20220714,2022/07/20,127,77,76,18,0,298
bitnami/grafana-loki,2.9.2,2023/12/06,77,20,9,2,0,108
newrelic/newrelic-infra-operator,0.13.0,2023/11/13,0,2,2,0,0,4
balenalib/stem-x86-32-debian-openjdk,20230904,2023/09/09,132,73,46,6,0,257
percona/dbaas-catalog,0.0.66,2023/09/13,1,10,10,0,0,21
okteto/maven,3,2023/08/24,14,104,67,0,0,185
sysdig/kubewatcher,0.3.0,2019/11/26,503,2377,1485,386,72,4823
adobecoldfusion/coldfusion2021,2021.0.11,2023/10/06,32,63,183,105,0,383
docker/dtr-rethink-s390x,2.5.0-beta3,2018/01/17,2,16,7,15,0,40
graphcore/pytorch-paperspace,3.3.0,2023/07/03,245,373,28,0,0,646
vmware/cascade,1.0,2018/04/13,14,144,161,65,0,384
intel/oneapi,2023.2-devel-ubuntu22.04,2023/07/14,191,195,38,0,0,424
circleci/circleci-cli,0.1.29314,2023/11/08,328,371,44,0,0,743
redislabs/redis-connect-cli,v0.24.1-beta.15,2022/10/31,71,80,10,0,0,161
rancher/library-busybox,1.32.1,2021/04/08,null
rancher/giddyup,v0.19.0,2017/08/24,40,79,82,22,18,241
objectscale/csi-baremetal-scheduler-extender,0.69.0,2021/03/07,71,80,21,0,0,172
okteto/actions-base,1.0,2022/04/06,193,255,193,31,8,680
mattermost/release-bot-daily,66938499,2022/08/25,null
rancher/hardened-kubernetes,v1.21.2,2021/06/28,454,450,101,8,0,1013
balenalib/ts4900-debian-node,18.6-20220714,2022/07/21,127,79,77,18,0,301
puppet/puppetboard,0.3.0,2018/06/05,1,21,15,1,0,38
balenalib/jetson-tx2-alpine-golang,20231106,2023/11/06,0,6,2,0,0,8
docker/ucp-hrm,2.2.22,2019/10/07,4,11,20,1,0,36
rancher/mirrored-plugins-docker,19.03.8,2020/11/19,3,13,33,5,0,54
intel/intel-optimized-lammps,202302,2023/02/13,258,423,55,0,0,736
bitnami/cassandra,4.1.3,2023/12/13,81,22,15,2,0,120
datadog/serverless-init,1.1.3,2023/11/01,0,0,1,0,0,1
rancher/os-amazonmetadata,v1.5.8,2021/02/05,2,10,28,5,0,45
astronomerinc/ap-postgres-operator,1.8.2,2023/02/07,0,4,7,1,0,12
kasmweb/signal,1.14.0,2023/09/14,217,443,0,0,0,660
rancher/cert-manager-controller-arm64,v0.7.2-rio.1,2019/05/15,0,0,0,2,0,2
rancher/mirrored-istio-galley,1.5.9,2020/08/07,405,1085,142,0,0,1632
grafana/tns-lint,6daf0b2,2020/06/29,4,15,37,5,0,61
kong/ubi-kuma-cni,2.4.4,2023/11/06,27,35,8,0,0,70
airbyte/source-postmarkapp,0.1.0,2022/11/09,0,19,25,1,0,45
rancher/mirrored-openpolicyagent-gatekeeper,v3.13.0,2023/08/08,0,3,3,0,0,6
balenalib/artik530-ubuntu-node,20220715,2022/08/02,88,92,12,0,0,192
balenalib/fincm3-alpine-openjdk,8-20230530,2023/06/26,8,24,7,2,0,41
appdynamics/ad-nite-java-services,2019-03-13-1552511460,2019/03/13,102,135,127,40,0,404
kong/httpbin,0.1.0,2022/06/23,208,555,54,3,0,820
balenalib/artik5-ubuntu-golang,20220803,2022/08/03,245,468,66,0,0,779
rancher/mirrored-cilium-hubble-ui,v0.12.1,2023/10/11,2,10,7,5,0,24
rancher/build-master,v0.20.0,2016/06/23,582,863,84,1,0,1530
amazon/lambda-build-node10.x,20190802,2019/08/13,58,630,554,31,0,1273
bitnami/configmap-reload,0.12.0,2023/12/06,77,16,7,2,0,102
jetbrains/upsource-cluster-init,2020.1.1992,2022/03/11,80,152,245,97,0,574
intel/xfastertransformer,1.0.0,2023/11/07,76,76,0,1,0,153
balenalib/am571x-evm-debian-node,18.6-20220714,2022/07/21,127,79,77,18,0,301
balenalib/qemux86-64-debian-python,20231106,2023/11/06,117,30,31,4,0,182
rancher/mongodb-config,v0.1.1,2017/02/27,null
grafana/mimir-build-image,5335_d9796228c4f26ab68a87f048f39245de,2023/06/26,492,231,198,19,2,942
balenalib/via-vab820-quad-golang,20220714,2022/07/28,471,275,219,29,1,995
datadog/fake-datadog,20220621,2022/06/15,1,16,22,1,0,40
okteto/installer,75436354,2023/09/21,0,27,13,0,0,40
bitnami/pinniped,0.27.0,2023/12/06,0,4,4,0,0,8
astronomerinc/ap-alertmanager,0.26.0,2023/08/24,0,6,2,0,0,8
airbyte/source-auth0,0.5.1,2023/10/20,65,28,7,1,0,101
circleci/cci-demo-docker-primary,0.0.2,2017/03/15,153,470,416,136,53,1228
docker/aci-hostnames-sidecar,1.0,2020/10/28,null
rapidfort/redis,7.2.1,2023/10/17,29,6,1,0,0,36
balenalib/armv5e-golang,20200213,2020/02/19,674,546,492,64,10,1786
bitnami/kafka,3.6.0,2023/12/02,87,22,13,6,0,128
hashicorp/spark-nomad,2.1.1,2017/06/06,102,290,336,176,30,934
balenalib/fincm3-alpine-python,20230530,2023/06/21,2,19,6,2,0,29
rapidfort/etcd,3.5.9,2023/10/11,35,13,9,0,0,57
bitnami/vault-k8s,1.3.1,2023/12/07,87,23,13,4,0,127
mattermost/mattermost-cloud-e2e,9839667,2022/12/09,0,12,8,0,0,20
bitnami/gitlab-runner,16.5.0,2023/11/08,112,31,32,5,2,182
balenalib/kitra710-node,20230904,2023/09/09,121,47,43,6,0,217
jetbrains/upsource-frontend,2020.1.1992,2022/03/11,80,152,245,97,0,574
balenalib/odroid-c1-debian-openjdk,20210602,2021/06/05,222,249,144,39,9,663
airbyte/source-amazon-sqs,0.1.0,2021/10/26,0,21,50,8,0,79
cockroachdb/builder-arm64v8,20180403-041732,2018/04/03,445,767,44,0,0,1256
balenalib/aarch64,20231106,2023/11/07,110,29,22,4,0,165
balenalib/intel-nuc-fedora,20231103,2023/11/04,null
balenalib/stem-x86-32-python,20230904,2023/09/09,121,46,42,6,0,215
rancher/mirrored-cilium-cilium-etcd-operator,v2.0.7,2019/09/18,null
puppet/puppet-inventory,0.4.0,2018/05/09,113,148,12,0,0,273
balena/yocto-build-env,9980750,2022/08/11,90,296,14,0,0,400
docker/buildx-bin,0.12.0-rc2,2023/11/14,0,4,4,0,0,8
balenalib/artik710-alpine-node,20230811,2023/08/22,2,7,6,2,0,17
percona/everest-catalog,0.4,2023/11/17,1,8,9,0,0,18
rapidfort/memcached-official,1-bullseye,2023/06/14,21,7,3,0,0,31
airbyte/java-datadog-tracer-base,3.2,2022/10/07,23,131,175,4,0,333
rancher/mirrored-epinio-epinio-server,v1.10.0,2023/09/25,0,12,3,0,0,15
redislabs/vault-ca,1.8,2017/12/26,146,158,15,0,0,319
airbyte/destination-sftp-json,0.1.0,2021/11/24,83,68,59,24,1,235
ddosify/ddosify-docker-extension,0.2.3,2023/03/23,0,14,10,0,0,24
amazon/aws-sam-cli-emulation-image-ruby2.5,20220125,2022/01/25,1,132,87,16,0,236
balenalib/via-vab820-quad-alpine-golang,20220714,2022/07/27,8,45,38,12,0,103
balenalib/odroid-xu4,20230911,2023/09/11,121,45,42,6,0,214
solace/solace-pubsub-connector-jms,1.0.0,2023/10/16,75,45,6,1,0,127
objectscale/nginx,3.9.0.0-1588.729cf194,2023/04/25,4,40,28,0,0,72
hashicorp/tfc-agent,1.14,2023/12/19,16,22,0,0,0,38
astronomerinc/ap-keda,2.3.0,2021/06/30,0,5,12,0,5,22
balenalib/bananapi-m1-plus-ubuntu-node,20231026,2023/11/02,38,19,1,0,0,58
redislabs/redis-connect-mysql,0.5.0-13,2022/01/22,4,29,38,13,0,84
balenalib/kitra520-debian-golang,20220714,2022/07/22,471,278,225,29,1,1004
objectscale/object-control,0.71.3,2021/04/15,17,149,226,36,6,434
rancher/prometheus-auth,v0.3.0,2022/12/14,0,9,11,0,2,22
balenalib/apalis-imx6q-python,20220604,2022/06/12,127,90,78,20,0,315
kong/kong-operator,v0.9.0,2021/10/13,127,328,50,2,0,507
balenalib/i386-debian-node,16.19.1-20231106,2023/11/06,110,31,23,4,0,168
intel/intelligent_traffic_management_rule_engine_dev,2.0,2022/12/06,61,98,12,0,0,171
objectscale/mock-notifier,v2.74.0,2021/05/25,2,16,18,0,0,36
airbyte/source-acceptance-test,0.5.0,2023/01/30,0,19,26,1,0,46
airbyte/source-mailersend,0.1.0,2022/11/13,0,19,25,1,0,45
balenalib/bananapi-m1-plus-alpine-golang,20231106,2023/11/07,0,6,2,0,0,8
balenalib/bananapi-m1-plus-alpine-openjdk,8-20231106,2023/11/07,0,6,2,0,0,8
rancher/node-exporter,v0.17.0,2018/11/30,null
okteto/remote,0.4.2,2021/04/28,0,2,3,0,0,5
snyk/kubernetes-operator-bundle,1.100.2,2023/01/03,null
newrelic/k8s-nri-memcached,2.1.0,2019/11/25,null
google/apigee-emulator,1.9.1,2023/04/11,8,42,37,6,5,98
newrelic/k8s-nri-f5,2.1.0,2019/11/25,null
mirantis/ucp-node-exporter,3.7.1,2023/09/26,2,9,6,2,0,19
rancher/pushprox-client,v0.1.0-rancher2-client,2021/06/03,0,7,28,4,0,39
amazon/amazon-ecs-agent,78294847,2020/02/18,null
objectscale/postgres-operator,ubi8-5.2.0-114.c95664e-226,2023/08/29,64,35,10,1,0,110
balenalib/i386-nlp-node,6.17.1-20190503,2021/04/19,53,49,83,12,5,202
redislabs/kuber,4.5.0-18.1,2017/04/29,598,1068,65,1,0,1732
cockroachdb/cockroach-k8s-request-cert,0.4,2018/10/10,null
balenalib/artik530-debian,20220714,2022/07/22,127,77,76,18,0,298
accurics/cli-kubescan-arm64,1.0.41,2022/09/14,0,31,28,1,0,60
balenalib/nitrogen6x-alpine-node,20220714,2022/07/19,7,44,34,10,0,95
balenalib/raspberry-pi2-debian-openjdk,20230911,2023/09/12,132,73,46,6,0,257
mirantis/ucp-etcd,3.7.1,2023/09/26,2,18,14,2,0,36
balenalib/parallella-node,20230904,2023/09/09,121,47,43,6,0,217
balenalib/spacely-tx2,20231106,2023/11/07,117,29,31,4,0,181
rancher/brand-guidelines,2017-05-09,2017/05/10,71,115,156,56,12,410
docker/vpnkit-forwarder,76371f3a7a14e1f0412c719eea60990ff5938cf7,2019/09/06,null
newrelic/newrelic-k8s-metrics-adapter,0.8.0,2023/11/13,0,3,3,0,0,6
mongodb/apix_test,mongot-noauth,2023/08/22,154,53,15,0,0,222
okteto/crond,0.0.2,2020/10/10,2,10,32,4,0,48
kasmweb/gimp,1.14.0,2023/09/14,243,456,0,0,0,699
google/apigee-redis,1.8.1,2022/05/23,0,0,0,0,5,5
balenalib/artik5,20220714,2022/07/22,127,77,76,18,0,298
airbyte/source-appsflyer,0.1.0,2022/11/29,0,19,25,1,0,45
airbyte/source-shopify-singer,0.2.3,2021/06/09,563,345,294,40,8,1250
rancher/fluent-bit-out-syslog,0.1.0,2020/07/30,83,57,12,0,0,152
circleci/config-setup,0.869,2023/11/07,204,233,6,0,0,443
redislabs/redis,7.2.4-72,2023/10/03,null
dynatrace/dynatrace-operator,0.14.2,0001/01/01,null
redislabs/olmtest,100.0.6-1439.0,2023/11/15,null
balenalib/artik533s-alpine-node,20220803,2022/08/04,7,44,34,10,0,95
bitnami/mongodb-exporter,0.39.0,2023/11/15,77,19,8,2,0,106
grafana/prometheus-pulsar-remote-write-build-image,73484513,2020/08/06,138,252,298,33,10,731
rancher/hardened-cilium-runtime,v1.9.6-build20210526,2021/05/26,444,387,21,3,0,855
intel/rpbs_pipeline_builder_micro_frontend,1.0,2023/08/21,0,5,3,0,0,8
balenalib/raspberrypi3-ubuntu-node,20231026,2023/11/02,38,19,1,0,0,58
airbyte/source-vantage,0.1.0,2022/11/13,0,19,25,1,0,45
grafana/tns-app,842bd3b,2021/10/31,2,14,13,0,0,29
vmware/likewise-open-toolchain-photon,1.0.0,2018/04/10,21,212,227,87,0,547
airbyte/source-k6-cloud,0.1.0,2022/11/09,0,19,25,1,0,45
rancher/kim,v0.1.0-beta.7,2021/10/17,4,20,15,0,0,39
ambassador/telepresence-docker-extension,1.0.19,2023/11/14,0,25,39,0,0,64
intel/oneapi-aikit,2023.2.0-devel-ubuntu22.04,2023/08/09,189,201,42,4,0,436
google/apigee-cassandra-client,1.0.0-beta2,2019/04/06,91,90,37,8,0,226
rancher/rke2-upgrade,v1.28.3-rke2r2-s390x,2023/11/08,0,5,5,0,0,10
atlassian/bitbucket-server,8.15.1,2023/12/16,47,67,27,2,0,143
airbyte/source-kustomer,0.1.2,2021/12/24,0,21,51,8,0,80
bitnami/centos-base-buildpack,7-r9,2022/09/07,896,1019,52,0,0,1967
circleci/server-nomad,0.9-8443593,2019/08/16,312,1448,1022,138,12,2932
balenalib/raspberrypi3-debian-python,20230530,2023/06/27,121,46,42,6,0,215
circleci/server-keysets,v1.0-34-8c6e430,2020/09/14,75,68,2,0,0,145
astronomerinc/ap-certgenerator,0.1.6,2023/10/03,0,4,3,0,0,7
balenalib/revpi-core-3-debian-golang,20230530,2023/06/27,382,68,50,8,0,508
vmware/vs-ui,v0.0.1,2017/12/06,71,75,130,42,12,330
balenalib/asus-tinker-board-s-ubuntu-golang,20231026,2023/11/02,135,137,1,0,0,273
airbyte/source-mssql-strict-encrypt,3.0.0,2023/11/07,5,29,17,2,0,53
airbyte/source-surveycto,0.1.2,2023/07/27,78,42,32,3,0,155
hashicorp/vault-service-broker,0.2.0,2017/07/25,null
onlyoffice/4testing-ds-docservice,6.0.0,2020/10/21,563,574,32,3,0,1172
cimg/rlang,4.2.0,2022/06/13,477,1172,64,0,0,1713
docker/ucp-istio-pilot,3.3.1,2020/06/26,471,1163,150,1,0,1785
mirantis/ucp-metallb-controller,3.7.1,2023/09/26,0,4,3,0,0,7
rancher/mirrored-longhornio-longhorn-ui,v1.5.1,2023/07/19,5,24,19,0,10,58
okteto/calculate,golang,2020/10/01,703,525,491,64,12,1795
balenalib/parallella-openjdk,20230904,2023/09/09,132,73,46,6,0,257
rancher/mirrored-calico-operator,v1.31.1,2023/09/01,0,3,1,0,0,4
balenalib/asus-tinker-board-debian-golang,20230904,2023/09/09,446,124,78,10,0,658
kasmweb/ubuntu-jammy-dind,1.14.0,2023/09/14,308,475,33,0,0,816
airbyte/dst-sf-perf,18,2023/03/22,26,120,125,19,0,290
airbyte/source-cockroachdb,0.1.22,2023/03/22,25,174,193,6,0,398
cimg/aws,2023.09.1,2023/09/26,328,387,50,0,0,765
rancher/klipper-helm,v0.4.3,2021/01/08,12,38,68,15,0,133
hashicorp/consul-dataplane,1.3,2023/12/15,11,8,2,0,0,21
vmware/volume-metadata-syncer,v1.0.0,2019/08/16,14,55,70,30,0,169
kasmweb/almalinux-8-desktop,1.14.0,2023/09/14,3,137,951,0,0,1091
onlyoffice/4testing-docspace-people-server,2.0.0.33,2023/11/24,1024,156,211,13,0,1404
balena/armv7hf-supervisor-base,v1.4.7,2019/05/28,null
redislabs/rcp-deployer,94370089edddb8d42e02662046f94cdb,2021/10/03,205,508,60,1,0,774
airbyte/src-e2e-parallel-perf,partial-serde-1,2023/05/27,25,172,190,6,0,393
balenalib/amd64-ubuntu-golang,20230929,2023/10/07,148,141,13,0,0,302
balenalib/aarch64-ubuntu-openjdk,11-xenial-20231103,2023/11/06,null
airbyte/kpy-test,1,2021/05/20,140,103,114,34,8,399
balenalib/hummingboard-ubuntu-node,20230904,2023/09/09,43,20,5,0,0,68
balenalib/beaglebone-black-openjdk,20230911,2023/09/12,132,73,46,6,0,257
docker/devenv-vm-service,v0.2.5,2023/06/02,0,16,7,3,0,26
onlyoffice/docspace-healthchecks,1.1.4.1,2023/10/23,1024,158,215,13,0,1410
mirantis/ucp-secureoverlay-mgr,3.7.1,2023/09/26,2,8,6,2,0,18
onlyoffice/4testing-documentserver-ie,99.99.99.2412,2021/04/23,458,1881,88,0,0,2427
balenalib/artik10-ubuntu-openjdk,20210826,2021/09/21,136,435,10,0,0,581
rancher/opni-metrics-service,v0.7.0,2022/11/23,3,45,37,0,13,98
rancher/grafana-grafana,7.2.1,2020/10/08,4,30,66,9,0,109
objectscale/objectscale-capacity,1.4.0-397.adb0726,2023/11/13,0,5,4,0,0,9
balenalib/beaglebone-green-alpine-golang,20231106,2023/11/07,0,6,2,0,0,8
pachyderm/haberdashery,2.8.0-rc.2,2023/11/13,87,31,29,2,2,151
jetbrains/qodana-jvm,2023.2,2023/09/06,144,66,74,13,0,297
atlassian/stash,3.11,2016/08/22,107,307,352,166,34,966
bitnami/kong-ingress-controller,3.0.0,2023/11/14,77,16,7,2,0,102
balenalib/asus-tinker-board-s-ubuntu,20231026,2023/11/02,37,18,0,0,0,55
docker/ucp-kube-dns-s390x,3.1.0-beta3,2018/10/04,0,0,0,2,0,2
bitnami/azure-cli,2.54.0,2023/11/23,80,18,8,2,0,108
purestorage/node-config,v0.1.0,2020/12/15,2,10,32,4,0,48
bitnami/pytorch,2.1.0,2023/11/16,80,17,8,2,0,107
bitnami/sealed-secrets-kubeseal,v0.24.3,2023/11/02,0,1,0,0,0,1
airbyte/source-s3,4.2.1,2023/11/14,132,47,12,2,0,193
graphcore/ipu-operator-controller,1.2.0,2023/05/30,0,4,2,0,0,6
rancher/swarmkit,v1.13-1,2017/01/25,2,49,28,26,0,105
balenalib/parallella-fedora-openjdk,30-20210825,2021/09/03,null
intel/intel-gpu-resource-driver,v0.2.0,2023/09/29,0,4,4,0,0,8
docker/desktop-kubernetes-coredns,v1.10.1,2023/02/06,0,4,3,0,0,7
intel/intel-optimized-cassandra,jdk14,2023/02/13,250,431,14,0,0,695
bitnami/apache-exporter,1.0.3,2023/12/06,75,16,7,2,0,100
airbyte/destination-kinesis,0.1.5,2022/09/22,77,77,58,19,0,231
amazon/amazon-ecs-local-container-endpoints,1.3.0,2020/07/16,18,361,222,23,0,624
appdynamics/appdynamics-cloud-log-collector-agent,23.10.0-759,2023/10/24,0,11,6,0,0,17
rancher/istio-proxy_init,1.3.3,2019/10/11,363,521,36,0,0,920
airbyte/source-slack-singer,0.2.3,2021/06/09,564,349,294,40,8,1255
graphcore/tools,3.2.0,2023/03/14,42,19,0,0,0,61
objectscale/ons,0.71.3,2021/04/15,16,142,200,36,3,397
balenalib/i386-nlp-debian-python,20210225,2021/04/18,192,130,143,43,10,518
docker/ucp-interlock-proxy-s390x,3.1.0-beta3,2018/10/04,2,23,10,5,0,40
balenalib/odroid-c1-openjdk,20210602,2021/06/05,222,249,144,39,9,663
balenalib/parallella-golang,20230904,2023/09/09,446,124,78,10,0,658
circleci/node,17.2.0,2021/12/18,847,1055,806,102,5,2815
airbyte/destination-timeplus,0.1.0,2023/06/14,0,17,25,1,0,43
appdynamics/appdynamics-cloud-operator,23.10.0-1114,2023/10/16,0,2,2,0,0,4
balenalib/bananapi-m1-plus-node,20230904,2023/09/09,121,47,43,6,0,217
rapidfort/elasticsearch-official,8.6.2,2023/05/23,5,22,18,0,0,45
portainer/portainer,1.25.0,2022/05/09,5,21,21,0,0,47
vmware/photon-controller-seed,1.0.3,2017/01/12,10,84,108,57,0,259
rapidfort/apache,2.4.57,2023/10/12,48,14,4,1,0,67
balenalib/revpi-core-3-ubuntu-node,20231026,2023/11/02,38,19,1,0,0,58
airbyte/source-trustpilot,0.1.0,2023/03/16,0,16,17,0,0,33
rancher/pipeline-jenkins-boot,v1.0.0,2018/01/11,16,174,206,107,0,503
onlyoffice/4testing-docspace-files-services,2.0.0.33,2023/11/24,1024,156,211,13,0,1404
pachyderm/market_sentiment,dev0.25,2022/05/04,219,489,74,10,0,792
intel/pmem-csi-driver,v1.1.0,2022/12/19,89,40,48,3,4,184
nginxinc/nginmesh_proxy_init,0.7.1,2018/07/11,53,24,57,13,9,156
rancher/harvester-webhook,v1.2.1,2023/10/26,0,7,10,0,1,18
cockroachdb/cockroach-misc,v23.1.0-alpha.7,2023/03/15,73,50,6,0,0,129
rancher/mirrored-gmsa-webhook-k8s-gmsa-webhook,v0.7.0,2023/08/22,0,1,1,0,0,2
balenalib/artik530-fedora,20220714,2022/07/23,null
rapidfort/mongodb-official,6.0.4-focal,2023/11/17,26,52,10,0,0,88
amazon/aws-lambda-ruby,3.2.2023.11.03.14,2023/11/03,2,3,3,0,0,8
amazon/opendistro-for-elasticsearch-data-prepper,1.0.3,2021/12/20,16,183,205,16,0,420
redislabs/operator-internal,100.0.8-2088,2023/11/14,64,45,17,0,0,126
objectscale/csi-baremetal-operator,0.69.0,2021/03/07,121,234,47,3,0,405
netdata/netdata-debug,v1.43.2,2023/10/30,0,13,2,0,0,15
cimg/ruby,3.2.2,2023/08/30,413,522,48,0,0,983
vmware/cascade-event-toolchain-photon,1.0.7,2018/09/18,61,272,276,115,0,724
grafana/grizzly,0.2.1,2023/02/17,0,22,7,0,0,29
kasmweb/core-debian-bookworm,1.14.0,2023/09/09,418,160,132,17,2,729
balenalib/raspberry-pi2-debian-golang,20230911,2023/09/12,382,68,50,8,0,508
solaceiotteam/apim-portal,0.0.10,2021/09/06,199,262,313,42,8,824
ubuntu/mlflow,2.1.1_1.0-22.04,2023/10/02,27,29,6,11,0,73
google/apigee-cassandra,1.0.0-beta2,2019/05/08,95,189,189,48,6,527
onlyoffice/appserver,1.0.485b,2021/01/28,348,2009,1179,243,0,3779
portainer/portainer-docker-extension,2.19.2,2023/11/12,0,21,12,0,0,33
circleci/slanger,0.4,2022/02/23,50,77,101,12,3,243
hashicorp/nomad-autoscaler,0.3.7,2022/06/10,0,18,13,1,0,32
google/apigee-istio-kubectl,1.4.6,2020/02/22,648,1296,137,0,0,2081
newrelic/k8s-nri-kafka,2.9.2,2020/02/05,35,47,52,5,0,139
syncfusion/boldbi,6.16.12,2023/11/03,221,114,106,11,0,452
atlassian/pipelines-agent,1.80,2016/11/29,73,206,231,114,27,651
balena/i386-supervisor-base,v1.4.7,2019/05/28,null
bitnami/phpbb,3.3.11,2023/12/02,155,91,69,6,0,321
balenalib/amd64-ubuntu-openjdk,11-xenial-20230929,2023/10/07,null
intel/intel-sgx-admissionwebhook,0.28.0,2023/09/22,null
rancher/kubernetes-external-dns,v0.7.3,2020/08/05,4,22,46,4,0,76
rancher/mirrored-longhornio-backing-image-manager,v1.5.1,2023/07/19,4,24,27,0,10,65
rancher/os-preload,v0.7.1,2016/11/11,null
rancher/jenkins-plugins-docker,17.12,2018/02/21,0,8,3,3,0,14
pachyderm/issuesummarization,7927321a08ce4e62a42aa13f057b711c,2018/04/25,516,1492,1030,253,52,3343
docker/ucp-cfssl-s390x,3.1.0-beta3,2018/10/04,0,2,6,16,0,24
balenalib/generic-armv7ahf-ubuntu-golang,20230904,2023/09/09,143,152,23,0,0,318
airbyte/source-intruder,0.1.0,2022/11/14,0,19,25,1,0,45
pachyderm/cert-manager-acmesolver,v0.15.1,2020/05/27,0,0,0,0,6,6
datadog/agent-buildimages-system-probe_x64,v22885174-c6364642,2023/11/06,938,477,376,12,3,1806
vmware/postgresql,9.6.5-photon,2017/11/21,11,78,131,50,0,270
newrelic/cluster-api-controller-arm64,mv1a,2019/04/17,0,0,0,0,6,6
objectscale/objmt,0.71.3,2021/04/15,17,149,226,36,6,434
grafana/ebpf-autoinstrument,0.0.3,2023/07/21,22,14,4,0,0,40
rancher/gitwatcher,v0.4.5,2020/01/03,4,14,12,2,0,32
docker/kube-compose-e2e-tests,v0.5.0,2022/02/14,0,7,14,1,0,22
intel/evi-test-tool,master-ae213cd97d6931b1d44fc7689867cf5701e0f15d,2023/09/23,60,21,6,1,0,88
balenalib/nitrogen6x-ubuntu-python,20220622,2022/06/23,87,122,13,0,0,222
onlyoffice/docspace-files-services,1.1.4.1,2023/10/23,1024,157,214,13,0,1408
balenalib/jetson-tx2-debian-golang,20231106,2023/11/07,440,96,56,6,0,598
rancher/mirrored-grafana-grafana,9.1.5,2022/09/13,0,24,24,0,0,48
balenalib/nitrogen6x-ubuntu,20220714,2022/08/02,87,91,11,0,0,189
balenalib/up-board-ubuntu-golang,20230911,2023/09/12,149,152,23,0,0,324
objectscale/deos-fio,3.14,2020/06/15,10,33,65,6,0,114
docker/app,test.pr420,2018/11/21,0,0,0,2,0,2
vmware/vs-event-manager,v0.0.1,2017/12/05,15,81,98,70,0,264
snyk/kubernetes-operator,2.4.17,2023/11/07,72,59,11,0,0,142
objectscale/objs-pre-upgrade-crds,1.4.0-2770,2023/11/15,0,3,3,0,0,6
percona/everest-operator,0.4,2023/10/31,0,2,1,0,0,3
rancher/os-statescript,v0.7.1,2016/11/11,null
circleci/sshd,0.1,2023/01/16,0,0,0,1,0,1
rancher/mesos-master,0.28.1,2016/05/24,235,326,17,0,0,578
balenalib/stem-x86-32-openjdk,20230904,2023/09/09,132,73,46,6,0,257
intel/deep-learning,2023.2-py3.10,2023/09/20,168,193,26,2,0,389
redislabs/redisstatemachine,edge,2023/05/17,74,30,18,2,0,124
balenalib/i386-golang,20231106,2023/11/06,439,95,56,6,0,596
grafana/tempo,2.3.0,2023/10/30,0,4,3,0,0,7
rapidfort/zookeeper-official,3.8.3-jre-17,2023/12/16,4,0,2,0,0,6
bitnami/argo-cd,2.9.1,2023/11/15,120,29,34,3,2,188
airbyte/source-twilio,0.10.0,2023/07/27,153,96,64,10,0,323
puppet/puppetserver,7.9.2,2022/10/17,36,138,2,0,0,176
balenalib/imx6ul-var-dart-ubuntu-python,20231026,2023/11/02,37,19,0,0,0,56
airbyte/destination-clickhouse,0.2.5,2023/06/23,29,191,236,21,0,477
docker/doodle,summer2019,2019/06/19,null
bitnami/kubeapps-apis,2.9.0,2023/12/07,77,39,19,2,0,137
docker/hlb-backend,50b36877f5c4f4f9947837690a988f592450d1de,2018/10/23,1,0,14,11,0,26
google/apigee-hybrid-cassandra,1.8.1,2022/09/13,3,32,49,3,5,92
rancher/metrics-server-amd64,v0.3.1,2018/09/17,null
balenalib/qemux86-64-fedora,20231103,2023/11/04,null
rancher/mirrored-neuvector-scanner,latest-amd64,2023/12/19,0,1,0,0,0,1
okteto/movies-frontend,prod,2020/04/02,2,13,13,1,0,29
rancher/os-docker,19.03.15,2021/02/03,null
atlassian/jira-servicemanagement,5.11.3,2023/12/16,20,44,33,4,0,101
amazon/aws-lambda-python,3.12.2023.11.12.08,2023/11/12,0,3,0,0,0,3
opensearchproject/opensearch,2.11.0,2023/11/09,1,6,5,0,0,12
amazon/amazon-ec2-instance-selector,v2.0.3,2021/08/19,null
intel/intel-optimized-tensorflow-serving,2.8.0,2022/03/29,61,40,2,0,0,103
balenalib/rpi-debian-node,16.19.1-20231106,2023/11/07,110,45,31,4,0,190
rancher/harvester-bundle,v0.2.0,2021/04/30,114,194,11,0,0,319
rancher/mirrored-longhornio-longhorn-manager,v1.5.1,2023/07/19,4,30,35,0,10,79
snyk/snyk,swift,2023/12/17,0,1,0,0,0,1
airbyte/source-fastbill,0.2.0,2023/08/23,0,17,24,1,0,42
rancher/hardened-calico,v3.13.3,2020/09/25,468,537,104,4,0,1113
balenalib/via-vab820-quad-node,18.6-20220714,2022/07/21,127,79,77,18,0,301
balenalib/apalis-imx6q-debian-node,18.6-20220714,2022/07/21,127,79,77,18,0,301
docker/ecs-secrets-sidecar,1.0,2020/10/26,null
airbyte/source-freshsales,1.0.0,2023/11/13,0,15,24,1,0,40
balenalib/asus-tinker-board-fedora-node,36-build-20230911,2023/09/12,0,1,1,0,0,2
okteto/tfenv-ci,1.4,2022/04/28,9,52,62,17,0,140
newrelic/cluster-api-aws-controller,8325527a,1970/01/01,7,18,13,3,6,47
continuumio/repodb,main,2023/03/27,77,42,25,2,0,146
pachyderm/go-build,2.0.0-alpha.20,2021/06/01,686,444,398,63,12,1603
mattermost/rtcd,v0.12.0,2023/11/09,0,1,0,0,0,1
balenalib/qemux86-64-python,20231106,2023/11/06,117,30,31,4,0,182
bitnami/postgrest,11.2.2,2023/12/14,81,16,8,2,0,107
balenalib/artik710-node,20230904,2023/09/09,121,47,43,6,0,217
bitnami/harbor-notary-server,2.8.4,2023/09/15,86,196,228,2,0,512
balenalib/bananapi-m1-plus-debian-node,20230904,2023/09/09,121,47,43,6,0,217
balenalib/up-board-alpine-python,20231106,2023/11/07,0,7,2,0,0,9
grafana/cortex-tools,v0.11.0,2023/09/08,0,4,3,0,0,7
grafana/mt-gateway,v1.1,2021/01/14,4,14,9,3,0,30
onlyoffice/docspace-socket,1.1.4.1,2023/10/23,1011,173,221,19,0,1424
kasmweb/debian-bookworm-desktop,1.14.0,2023/09/14,664,342,281,51,4,1342
airbyte/source-zoom,0.1.1,2022/12/02,0,19,25,1,0,45
onlyoffice/gdrive-auth,1.0.0-rc15,2023/09/18,0,7,5,0,0,12
bitnami/redmine,5.1.0,2023/11/06,279,198,114,5,0,596
rancher/mirrored-coreos-etcd,v3.5.9,2023/05/11,0,12,9,0,0,21
bitnami/magento,2.4.6,2023/12/02,152,238,183,25,0,598
intel/intel-optimized-wordpress,src,2023/03/10,72,28,20,2,0,122
airbyte/destination-bigquery,2.3.15,2023/11/14,6,41,60,17,0,124
balenalib/artik530-alpine-python,20220803,2022/08/04,7,44,35,10,0,96
bitnami/moodle,4.3.0,2023/12/02,166,90,56,4,0,316
mattermost/platform,9.1.1,2023/11/01,109,26,16,1,0,152
airbyte/destination-selectdb,0.1.0,2023/04/05,25,175,192,6,0,398
balenalib/armv7hf-fedora,20221109,2022/12/03,null
onlyoffice/oform-config,1.0.3,2022/01/13,0,21,19,11,0,51
balenalib/aarch64-debian-openjdk,20231106,2023/11/07,121,52,24,4,0,201
astronomerinc/ap-awsesproxy,1.5.0-3,2023/11/09,0,4,0,0,0,4
rancher/helm-controller,v0.15.4,2023/08/16,0,4,3,0,0,7
grafana/cortex-cortex,v1.1.0-grafana-2,2020/06/08,2,16,18,0,0,36
airbyte/source-zoho-crm,0.1.2,2023/03/19,78,39,26,2,0,145
nginxinc/ingress-demo,latest-unprivileged,2021/01/10,163,172,167,47,8,557
balenalib/ts4900-alpine-node,20220714,2022/07/19,7,44,34,10,0,95
formio/formio-upload,1.0.0,2018/11/03,1,11,12,7,0,31
airbyte/metrics-reporter,0.50.34,2023/11/09,20,69,54,2,0,145
sysdig/orchestrator-agent,3.0.1-dev-ossl-debug,2022/08/19,82,98,24,0,0,204
vmware/pmd-toolchain-photon2,1.0.0,2018/07/22,45,321,376,140,0,882
balenalib/colibri-imx6dl-fedora-openjdk,30-20210825,2021/09/03,null
ubuntu/alertmanager,0.25.0-22.04,2023/12/12,12,8,4,0,0,24
redislabs/redisinsight,1.14.0,2023/05/02,81,70,45,5,0,201
rancher/system-upgrade-controller,v0.13.1,2023/08/28,0,2,1,0,0,3
grafana/cortex-test-exporter,v1.1.0-grafana-2,2020/06/08,0,6,9,0,0,15
pingidentity/pingone-ldap-gateway,3.0.1,2023/11/01,10,28,28,6,0,72
balenalib/artik10-fedora-python,20220714,2022/07/23,0,1,1,0,0,2
mirantis/ucp-hrm,2.2.22,2019/10/07,4,11,20,1,0,36
rancher/vm-fedora,27-1.6.x86_64,2018/04/11,null
balenalib/bananapi-m1-plus-fedora,20221210,2022/12/12,null
vmware/vs-image-manager,v0.0.1,2017/11/28,15,81,98,70,0,264
hashicorp/waypoint,0.11.4,2023/08/09,1,54,32,1,0,88
onlyoffice/4testing-appserver-webhooks-wervice,test-2022062807,2022/06/28,395,867,49,0,0,1311
amazon/aws-alb-ingress-controller,v2.4.5,2022/11/09,0,3,9,0,0,12
balenalib/artik5-fedora-node,36-build-20220803,2022/08/04,0,1,1,0,0,2
airbyte/airbyte-e2e-testing-tool,0.4.3,2022/09/30,77,77,60,17,0,231
onlyoffice/4testing-documentserver,99.99.99.2737,2021/12/03,429,1365,68,0,0,1862
couchbase/ubuntu-1404-sdk-build,20180806,2018/08/08,309,386,40,8,0,743
pingidentity/pingauthorize,2310,2023/11/01,3,15,10,0,0,28
vmware/kafka-slo-exporter,v1.1.0,2023/05/29,0,3,1,0,0,4
rancher/mirrored-longhornio-longhorn-share-manager,v1.5.1,2023/07/19,6,28,25,0,10,69
circleci/postgres-upgrade,9.4-to-9.5,2017/10/26,59,172,150,64,27,472
astronomerinc/ap-elasticsearch-exporter,1.6.0,2023/06/30,0,3,1,0,0,4
balenalib/amd64-python,20231106,2023/11/06,110,30,22,4,0,166
intel/intel-fpga-admissionwebhook,0.28.0,2023/09/22,null
bitnami/tensorflow-resnet,2.14.0,2023/11/16,321,34,14,4,0,373
portainer/open-amt-cloud-toolkit-postgres,v2.1.0,2022/02/03,117,69,68,26,0,280
rancher/harvester-seeder,v0.1.0,2023/08/29,4,12,17,0,8,41
rancher/longhornio-backing-image-manager,v3_20220808-s390x,2022/08/08,7,65,55,3,14,144
okteto/result,1,2020/02/19,35,39,65,13,7,159
kasmweb/blender,1.14.0,2023/09/14,217,451,2,0,0,670
balenalib/spacely-tx2-python,20231106,2023/11/07,117,30,31,4,0,182
objectscale/csi-baremetal-node-kernel-5.4,0.69.0,2021/03/07,117,263,32,0,0,412
newrelic/c-daemon,1.3.0,2020/01/08,2,10,9,1,0,22
balenalib/stem-x86-32-alpine,20230530,2023/06/29,2,12,6,2,0,22
onlyoffice/docspace-files,1.1.4.1,2023/10/23,1024,157,214,13,0,1408
bitnami/supabase-postgres,15.1.0,2023/12/18,105,37,15,4,0,161
ngrok/kubernetes-ingress-controller,0.10.1,2023/10/20,0,1,1,0,0,2
intel/oneapi-basekit,2023.2.1-devel-ubuntu22.04,2023/07/31,185,187,33,0,0,405
balenalib/beaglebone-black-python,20230911,2023/09/12,121,46,42,6,0,215
graphcore/poplar,3.3.0,2023/07/03,124,199,24,0,0,347
kasmweb/libre-office,1.14.0,2023/09/14,226,453,0,0,0,679
intel/fm-worker,evi-2.0.0,2022/10/31,32,18,0,0,0,50
docker/dtr-nginx-s390x,2.5.0-beta3,2018/01/17,0,16,41,34,0,91
bitnami/parse-dashboard,5.2.0,2023/11/16,90,28,15,5,0,138
airbyte/destination-qdrant-preview,dev,2023/08/31,65,32,11,4,0,112
kong/immunity,4.2.0,2021/08/03,599,377,336,44,15,1371
dynatrace/easytravel-loadgen,7.1,2018/05/11,184,260,190,46,14,694
datadog/dd-trace-ci,vegeta,1970/01/01,91,50,62,17,7,227
balenalib/orangepi-plus2-fedora-node,36-build-20230911,2023/09/11,0,1,1,0,0,2
circleci/java,8,2017/05/22,110,316,350,194,30,1000
amazon/aws-glue-libs,glue_libs_4.0.0_image_01,2023/11/15,86,209,297,93,0,685
grafana/grafana-oss-image-tags,10.3.0-146415-ubuntu-arm64,2023/11/15,24,17,0,0,0,41
vmware/lightwave-base-photon2,1.0.1,2018/08/24,37,136,237,67,0,477
grafana/usage-stats-handler,v9,2023/11/08,0,11,43,11,0,65
vmware/vs-openfaas-nodejs6-base,0.0.3-dev1,2017/12/12,15,111,151,85,0,362
adobecoldfusion/coldfusion2018,2018.0.18,2023/07/20,59,108,148,62,0,377
rancher/os-fedoraconsole,v1.5.8,2021/02/05,null
rancher/pipeline-jenkins-slave,v1.0.0,2018/01/11,278,496,32,2,0,808
balenalib/am571x-evm-fedora-python,20220622,2022/07/12,0,1,1,0,0,2
airbyte/source-mixpanel,2.0.0,2023/11/03,65,28,7,1,0,101
hashicorp/consul-terraform-sync,0.7.1,2023/10/30,0,5,2,0,0,7
cockroachdb/cdc-sink,pr-470,2023/09/12,0,3,2,0,0,5
balenalib/up-board-debian-node,20230712,2023/07/16,0,1,1,0,0,2
balenalib/kitra710-ubuntu-node,20230904,2023/09/09,43,20,5,0,0,68
atlassian/dcapt,7.6.0,2023/10/11,716,92,155,3,6,972
airbyte/source-commcare,0.1.0,2023/01/05,78,44,35,3,0,160
airbyte/source-square,1.6.1,2023/11/07,0,15,24,1,0,40
balenalib/zynq-xz702-alpine-openjdk,8-3.14-20220112,2022/01/19,2,50,42,13,0,107
graphcore/tensorflow-jupyter,2,2023/03/31,404,838,59,1,0,1302
balenalib/artik10-python,20220714,2022/07/22,127,78,78,18,0,301
rancher/migration-tools,v0.1.3,2020/01/31,38,27,0,0,0,65
intel/esp-gitea,v3.1.2,2023/07/25,0,7,11,0,0,18
rancher/terraform-operator-appliance,v0.0.5,2019/03/26,null
amazon/aws-efs-csi-driver,6954596,2023/03/01,2,34,11,2,0,49
airbyte/source-tvmaze-schedule,0.1.0,2022/10/27,0,19,25,1,0,45
mattermost/mattermost-build-webapp,v5.2.0,2018/08/07,412,1147,807,214,50,2630
balenalib/imx6ul-var-dart-debian-openjdk,20230911,2023/09/12,132,73,46,6,0,257
grafana/drone-vault,master-011e819,2023/04/14,0,18,15,0,0,33
docker/compose-tests,1.25.2-rc1,2020/01/17,144,365,372,68,10,959
hashicorp/consul-terraform-sync-enterprise,0.7.1-ent,2023/10/31,0,5,2,0,0,7
airbyte/cloud-airbyte-api-server,dev-97763408ca,2023/11/02,22,77,60,2,0,161
grafana/grafana-image-tags,10.3.0-146415-ubuntu-arm64,2023/11/15,24,17,0,0,0,41
mirantis/dtr-garant,3.0.0-alpha.2,2021/09/22,2,27,39,4,0,72
bitnami/dex,2.37.0,2023/12/06,87,27,15,4,0,133
airbyte/source-pendo,0.1.0,2023/03/30,0,18,25,1,0,44
intel/python,py310-full,2023/07/25,33,26,6,0,0,65
airbyte/source-wikipedia-pageviews,0.1.0,2022/11/03,0,19,25,1,0,45
rapidfort/envoy-official,v1.22.11,2023/04/12,null
kasmweb/workspaces,1.14.0,2023/09/18,53,60,27,1,0,141
balenalib/orangepi-plus2-alpine-openjdk,8-20231106,2023/11/07,0,6,2,0,0,8
datadog/operator-bundle,0.7.1,2021/10/22,null
intel/ai-structuring,evi-2.0.0,2022/10/31,32,18,0,0,0,50
hashicorp/consul-template,0.35,2023/11/08,0,4,2,0,0,6
snyk/snyk-container-demo,sha-654f899,2023/03/19,407,1129,788,200,50,2574
kong/ubi-kuma-init,2.4.4,2023/11/06,27,35,8,0,0,70
rancher/longhornio-csi-resizer,v1.2.0,2021/05/05,0,5,9,0,5,19
balenalib/i386-nlp-ubuntu-golang,20200213,2020/02/19,503,699,59,0,0,1261
airbyte/destination-amazon-sqs,0.1.0,2021/12/09,0,21,50,8,0,79
docker/tilt-golang-cross,1.19.3,2022/11/03,614,297,243,31,2,1187
pingidentity/pingauthorizepap,2310,2023/11/01,3,8,7,2,0,20
mattermost/kube-spot-termination-notice-handler,v1.23.4,2023/02/10,822,655,391,29,2,1899
docker/engine-community-dm,18.09.9,2019/09/04,null
balenalib/parallella-fedora-python,20221109,2022/11/16,0,1,0,0,0,1
vertica/verticasdk,ubuntu-v23.4.0,2023/11/06,181,186,4,0,0,371
balenalib/parallella-fedora-golang,20221210,2022/12/13,null
rancher/goharbor-harbor-portal,v1.7.5,2019/04/01,14,67,85,37,0,203
objectscale/fluxd,0.54.0,2020/11/06,2,55,65,6,2,130
newrelic/nri-kubernetes,3.20.0,2023/11/13,0,6,2,0,0,8
bitnami/vault,1.15.2,2023/12/02,87,25,14,4,0,130
google/apigee-diagnostics-runner,1.8.1,2022/09/20,0,0,0,0,5,5
datadog/dogstatsd,7.50.0-rc.2,2023/11/14,0,2,2,0,0,4
okteto/hello-job,golang,2020/08/14,94,46,55,16,7,218
jetbrains/upsource,2020.1.2006,2022/10/28,154,282,572,219,2,1229
bitnami/wordpress-nginx,6.4.1,2023/11/29,152,85,57,4,0,298
portainer/authenticator,develop,2023/06/29,null
balenalib/odroid-c1-golang,20220714,2022/07/28,471,275,219,29,1,995
cockroachdb/sql_efficiency_check,main,2022/06/22,0,2,4,0,0,6
objectscale/pravega,0.71.3,2021/03/30,216,275,266,76,9,842
rancher/mirrored-bats-bats,v1.4.1,2022/04/30,0,14,15,1,0,30
newrelic/kps,0.10.3,2019/09/02,4,14,9,1,0,28
airbyte/destination-heap-analytics,0.1.0,2023/01/04,0,18,25,1,0,44
balenalib/spacely-tx2-alpine-python,20231106,2023/11/06,0,7,2,0,0,9
objectscale/objectscale-gateway,0.71.3,2021/04/14,6,65,73,3,6,153
grafana/integration-grafana-publisher,v10,2023/09/13,7,33,23,7,0,70
rancher/clusterscan-operator,v0.0.1,2020/08/25,2,10,32,4,0,48
okteto/okteto,78462652,2023/03/28,1,37,18,0,0,56
rancher/nginx-ingress-controller-amd64,0.16.2-rancher1,2018/07/18,83,137,218,69,6,513
ubuntu/prometheus-alertmanager,0.23-22.04_edge,2023/02/13,33,34,18,0,0,85
datadog/cluster-agent-dev-amd64,7-27-0-snmp-batch-size-config,2021/04/09,8,28,20,2,0,58
airbyte/source-pypi,0.1.0,2022/11/07,0,19,25,1,0,45
rancher/prom-alertmanager,v0.21.0,2020/06/17,0,14,26,0,0,40
jetbrains/qodana-jvm-android,2023.2,2023/09/06,145,73,88,13,0,319
kasmweb/vs-code,1.14.0,2023/09/14,219,448,0,0,0,667
objectscale/livenessprobe,v2.6.0,2022/02/01,0,4,7,0,0,11
astronomerinc/ap-airflow-operator,0.0.1,2019/02/21,null
balenalib/am571x-evm-debian-golang,20220714,2022/07/28,471,275,219,29,1,995
objectscale/geoservice,0.71.3,2021/04/15,17,149,226,36,6,434
docker/ucp-interlock,3.3.1,2020/06/26,5,23,21,1,0,50
bitnami/dreamfactory-archived,4.12.0,2022/12/21,176,223,130,17,0,546
intel/proxyv2,1.19.0-intel.0,2023/09/27,29,20,6,0,0,55
vmware/notary-photon,signer-0.5.1,2017/11/21,8,60,81,49,0,198
objectscale/storageserver,0.71.3,2021/04/15,11,102,116,9,4,242
intel/pccs,v2.4,2023/10/15,22,11,0,0,0,33
rancher/os-bootstrap,3929481,2017/02/03,null
balenalib/aarch64-fedora-openjdk,8-20231106,2023/11/06,null
bitnami/spring-cloud-dataflow-composed-task-runner,2.11.1,2023/12/15,77,18,21,4,0,120
astronomerinc/ap-prometheus,2.45.1,2023/09/29,0,12,7,0,0,19
mathworks/matlab-deps,R2023b-ubuntu22.04,2023/12/18,29,5,0,0,0,34
rapidfort/python-chromedriver,7c9a7149476b73f54b17a674c2de4836bd252b70,2023/12/17,1480,1355,903,91,40,3869
airbyte/api-server,dev-5842ec8,2022/11/03,24,140,190,4,0,358
datadog/operator,1.3.0-rc.1,2023/11/13,18,15,2,0,0,35
vmware/audit-trail-toolchain,0.2.1,2018/09/26,16,162,183,93,0,454
rancher/opni-insights-service,v0.3.1,2022/03/07,8,88,83,4,17,200
astronomerinc/ap-houston-api,4650,2023/05/15,2,22,4,4,0,32
mirantis/ucp-dsinfo,3.7.1,2023/09/26,32,45,11,0,0,88
cimg/postgres,16.1,2023/11/10,324,356,43,0,0,723
vmware/photon-syslog,8.15.0,2017/10/23,10,81,101,57,0,249
grafana/tempo-vulture,2.3.0,2023/10/30,0,3,2,0,0,5
rancher/aks-operator,v1.2.1-rc1,2023/11/02,0,8,7,0,3,18
adobecoldfusion/pmt2018,2018.0.5,2022/12/02,60,95,62,27,0,244
balenalib/spacely-tx2-alpine,20231106,2023/11/06,0,6,2,0,0,8
airbyte/source-activecampaign,0.1.0,2022/10/27,0,19,25,1,0,45
rancher/goharbor-harbor-jobservice,v1.7.5,2019/04/01,14,63,88,37,0,202
appdynamics/nodejs-agent,23.10.0-20-slim,2023/11/06,56,9,2,1,0,68
bitnami/logstash,8.11.1,2023/11/13,79,45,18,8,0,150
circleci/build-image,ultra-minimal-01,2016/08/16,1535,2016,96,12,0,3659
bitnami/kibana,8.10.4,2023/10/17,99,28,18,6,0,151
datadog/agent-buildimages-windows_2004_x64,v3686353-1e75137,2021/01/12,8,50,134,12,0,204
balenalib/orangepi-plus2-fedora,20221210,2022/12/12,null
balenalib/generic-aarch64-ubuntu-python,20231103,2023/11/06,37,19,0,0,0,56
docker/dev-environments-java,639923ad2c5ce6f29a24ca8d11c8f38f9206c462,2021/06/21,556,306,457,69,16,1404
balenalib/hummingboard-fedora,20221210,2022/12/12,null
hashicorp/vault-secrets-operator,0.3.4,2023/10/20,0,2,0,0,0,2
bitnami/wordpress,6.4.1,2023/12/06,152,85,56,4,0,297
objectscale/targetmgr,3.9.0.0-139102.b4b5064355c,2023/05/03,2,16,11,0,0,29
solace/event-management-agent,1.3.1,2023/11/01,0,3,7,0,0,10
rancher/rio-cert-checker,v0.1.0,2019/05/21,6,20,9,2,0,37
grafana/consent-service,19789620,2020/02/06,2,16,38,4,0,60
mattermost/pgbouncer,v0.7.0,2023/11/10,0,3,0,0,0,3
docker/desktop-git-helper,706820a528d3553e3631118f8113adbce5c5f1db,2023/01/25,3,29,30,17,0,79
bitnami/chartmuseum,0.15.0,2023/05/21,78,75,35,5,0,193
appdynamics/secureapp-otel-java-extension,23.10.0-1153,2023/10/24,0,2,2,0,0,4
mattermost/cloud-blackbox-target-discovery,22696c7,2021/11/24,0,17,24,1,0,42
balenalib/raspberrypi3-ubuntu-openjdk,11-xenial-20231026,2023/11/02,null
airbyte/source-braintree-singer,0.2.3,2021/07/06,109,68,81,30,8,296
balenalib/odroid-xu4-ubuntu,20231026,2023/11/02,37,18,0,0,0,55
accurics/broker,9531878,2020/08/15,6,16,48,6,0,76
balenalib/beaglebone-green-wifi-ubuntu-node,20230911,2023/09/11,43,20,5,0,0,68
puppet/kerminator-build-image,474351,2018/11/09,4,30,50,15,0,99
intel/rpbs_gpu_telegraf,1.0,2022/11/29,39,36,3,0,0,78
intel/intelligent_traffic_management_dashboard_dev,2.0,2022/12/06,62,103,15,0,0,180
intel/evi-fm-worker,master-ae213cd97d6931b1d44fc7689867cf5701e0f15d,2023/09/23,56,13,4,1,0,74
rancher/hardened-flannel,v0.23.0-build20231109-s390x,2023/11/09,0,11,6,0,3,20
newrelic/nri-ecs,1.10.8,2023/10/19,8,39,16,2,0,65
rancher/opensearch,v0.11.0-rc1,2023/07/28,27,53,40,2,0,122
netdata/agent-sd,v0.2.9,2023/08/22,0,4,3,0,0,7
objectscale/object-service,0.71.3,2021/04/15,13,92,107,14,3,229
pachyderm/python-datum-batching-ci,937fe6fa62fc7108984071dce1a3639afe7064c4,2023/08/09,142,89,43,3,0,277
vmware/photon-2.0-flannel,v0.9.1-20180619,2018/06/19,17,84,105,59,0,265
mirantis/rethinkcli,v2.3.0,2016/11/28,55,174,168,65,22,484
bitnami/aspnet-core,7.0.14,2023/12/02,426,86,47,4,0,563
onlyoffice/4testing-documentserver-ee,99.99.99.3631,2023/11/12,125,120,2,1,0,248
sysdig/agent-slim,12.17.1,2023/10/24,89,59,16,0,0,164
grafana/har-to-k6,0.14.5,2023/10/13,56,11,3,2,0,72
balenalib/nitrogen6x-alpine-golang,20220714,2022/07/27,8,45,38,12,0,103
rancher/pause,3.6,2021/08/25,null
onlyoffice/4testing-docspace-studio,2.0.0.33,2023/11/24,1024,156,211,13,0,1404
astronomerinc/ap-nginx-es,3.13.5-4,2021/09/05,2,20,45,6,0,73
percona/proxysql2,2.5.5,2023/11/03,91,51,5,0,0,147
balenalib/kitra520-debian-openjdk,20220714,2022/07/22,160,136,87,18,0,401
adobecoldfusion/coldfusion2023,2023.0.5,2023/10/06,30,35,55,23,0,143
balenalib/odroid-c1-fedora-node,36-build-20220714,2022/07/22,0,1,1,0,0,2
portainer/template-swarm-monitoring,prometheus-v2.44.0,2023/05/24,0,12,7,0,0,19
rancher/mirrored-nginx-ingress-controller-defaultbackend,1.5-rancher1,2018/09/28,null
kumahq/kubectl,v1.20.15,2022/04/22,0,14,8,1,0,23
onlyoffice/communityserver,12.5.2.1848,2023/05/25,246,566,85,1,0,898
okteto/non-root,golang,2020/11/05,695,500,482,64,12,1753
mirantis/ucp-metrics,3.7.1,2023/09/26,2,12,7,2,0,23
intel/oneapi-hpckit,2023.2.1-devel-ubuntu22.04,2023/07/31,185,187,33,0,0,405
hashicorp/tfci,v1.1.1,2023/11/08,0,3,2,0,0,5
percona/proxysql,1.4.16,2020/02/05,38,33,25,5,2,103
vmware/cascade-toolchain,1.11.5-1,2019/02/05,18,175,232,105,0,530
balenalib/stem-x86-32-debian-node,16.19.1-20230904,2023/09/09,121,47,43,6,0,217
airbyte/source-launchdarkly,0.1.0,2022/11/10,0,19,25,1,0,45
rancher/mirrored-neuvector-prometheus-exporter,5.2.3,2023/11/14,0,2,2,0,0,4
airbyte/source-rki-covid,0.1.2,2022/12/05,0,19,25,1,0,45
balena/balena-generate-ami-env,9980750,2022/11/04,61,243,13,0,0,317
grafana/jmeter-to-k6,1.0.0,2020/05/22,9,36,47,8,0,100
vmware/govc,4561966a,2023/03/16,null
redislabs/redis-connect-cassandra,0.5.0-136,2022/01/22,1,32,34,7,0,74
rancher/mirrored-pstauffer-curl,v1.0.3,2018/07/11,0,0,6,18,0,24
onlyoffice/docs-converter-de,7.5.1-1,2023/11/09,16,3,0,0,0,19
cockroachdb/postgres-test,20190103-1358,2019/01/03,190,499,418,149,35,1291
objectscale/srs-notifier,2.0.51,2020/09/29,2,18,44,4,0,68
balenalib/aarch64-fedora-node,20231106,2023/11/06,0,1,1,0,0,2
bitnami/pgpool,4.4.4,2023/10/09,90,21,13,2,0,126
rancher/k8s-dns-kube-dns,1.15.10,2020/03/05,16,17,19,8,1,61
puppet/puppet-dev-tools,0.7,2020/02/25,641,546,512,60,11,1770
docker/mobywebsite,staging,2018/01/03,71,75,130,41,12,329
ddosify/golangtestapp,1.21.3-alpine3.18,2023/10/17,0,2,2,0,0,4
mirantis/dtr-notary-server,3.0.0-alpha.2,2021/09/22,0,6,26,3,0,35
airbyte/source-statuspage,0.1.0,2022/11/11,0,19,25,1,0,45
hashicorp/sentinel,0.23.1,2023/10/19,0,6,4,0,0,10
balenalib/armv7hf-fedora-openjdk,8-20221109,2022/12/05,null
bitnami/fluxcd-helm-controller,0.36.2,2023/12/06,77,21,9,2,0,109
rancher/istio-installer,0.1.7,2020/08/18,17,42,68,8,0,135
balenalib/jetson-tx2-fedora-golang,20231106,2023/11/06,null
redislabs/k8s-controller-internal,100.0.8-2088,2023/11/14,65,21,0,0,0,86
intel/its-query-web,master-ae213cd97d6931b1d44fc7689867cf5701e0f15d,2023/09/23,69,21,5,1,0,96
rancher/mirrored-k8s-dns-node-cache,1.22.20,2023/02/22,23,20,8,0,0,51
mirantis/dtr-nginx,3.0.0-alpha.2,2021/09/22,3,31,45,5,0,84
airbyte/source-smaily,0.1.0,2022/11/09,0,19,25,1,0,45
astronomerinc/ap-kubed,0.13.2,2022/03/25,0,6,10,1,0,17
onlyoffice/4testing-docspace-studio-notify,2.0.0.33,2023/11/24,1024,156,211,13,0,1404
objectscale/object-heads,0.71.3,2021/04/15,13,95,146,24,3,281
bitnami/reportserverenterprise-archived,4.2.0-6068,2022/08/02,100,84,82,17,0,283
greenbone/report-formats,community,2023/12/19,null
balenalib/asus-tinker-board-s-fedora,20221210,2022/12/12,null
okteto/cloudbin,1.10.11,2022/04/05,6,51,59,4,0,120
airbyte/destination-oracle,0.2.0,2023/06/29,29,190,236,21,0,476
pachyderm/cert-manager-cainjector,v0.15.1,2020/05/27,0,0,0,0,6,6
pingidentity/pingaccess,2310,2023/11/01,5,17,8,4,0,34
google/shaka-packager,v2.5.1,2021/06/22,null
balenalib/i386-python,20231106,2023/11/06,110,30,22,4,0,166
google/deepconsensus,1.2.0,2023/03/01,130,98,124,16,2,370
bitnami/minideb,stretch,2022/06/16,31,4,23,2,0,60
circleci/nomad-drainer,1.0.227-4ac789f,2019/12/13,2,10,9,1,0,22
balenalib/qemux86-64-node,20231106,2023/11/06,117,31,32,4,0,184
mirantis/k8s-netchecker-server,v1.2.2,2018/01/02,0,23,10,4,0,37
sysdig/agent,12.17.1,2023/10/24,173,76,16,0,0,265
rancher/longhornio-csi-snapshotter,v3.0.3,2020/12/15,0,7,12,0,5,24
airbyte/source-clockify,0.3.0,2023/08/31,0,17,24,1,0,42
okteto/backend,80907703,2023/02/02,0,13,8,0,0,21
rapidfort/nats-ib,v2.9.21,2023/09/08,0,1,1,0,0,2
balenalib/via-vab820-quad-debian,20220714,2022/07/20,127,77,76,18,0,298
amazon/aws-sam-cli-emulation-image-python3.9,20220125,2022/01/25,3,50,17,0,0,70
rancher/mirrored-flannel-flannel-cni-plugin,v1.2.0,2023/07/21,null
puppet/puppetdb,7.10.0,2022/04/04,83,226,2,0,0,311
rapidfort/slim-init,v1.0,2023/11/02,0,6,2,0,0,8
grafana/rollout-operator-boringcrypto,v0.9.0,2023/11/14,0,2,2,0,0,4
rancher/system-agent,v0.3.4,2023/10/30,1,20,15,1,0,37
balenalib/artik710-golang,20230904,2023/09/09,446,127,78,10,0,661
accurics/siac-bot,1.3.14,2021/06/04,2,16,43,4,0,65
astronomerinc/ap-vector,0.32.2-1,2023/11/06,0,4,0,0,0,4
pachyderm/opencv,2.6.0,2023/04/26,181,376,33,0,0,590
bitnami/reportserver,4.6.1-6098,2023/10/09,78,23,19,2,0,122
bitnami/kubeapps-chart-repo-archived,1.10.0,2020/04/01,null
rancher/os-ubuntuconsole,v1.5.8,2021/02/05,211,443,16,0,0,670
pachyderm/example-no-skip,12,2021/03/29,1451,1354,962,148,40,3955
dynatrace/easytravel-mongodb-content-creator,2.0.0.3599,2023/08/04,143,87,43,2,1,276
jetbrains/datalore-external,2023.5.1,1970/01/01,131,321,62,7,0,521
balenalib/colibri-imx6dl-alpine-golang,20220714,2022/07/27,8,45,38,12,0,103
jetbrains/code-with-me-lobby,1867,2023/01/23,138,67,52,5,4,266
couchbase/elasticsearch-connector,4.4.6,2023/05/17,86,79,11,0,0,176
balena/i386-supervisor,1299,2020/07/31,6,26,55,9,0,96
airbyte/source-rd-station-marketing,0.1.2,2023/07/07,0,17,25,1,0,43
docker/desktop-kine,v1.1,2020/04/15,3,18,39,4,0,64
onlyoffice/docspace-bin-share,1.1.4.1,2023/10/23,0,2,6,0,0,8
balenalib/hummingboard-golang,20230904,2023/09/09,446,124,78,10,0,658
bitnami/alertmanager,0.26.0,2023/12/06,77,22,9,2,0,110
intel/afxdp-plugins-for-kubernetes,23.02,2023/03/15,1,19,7,0,0,27
rancher/mirrored-cilium-startup-script,62bfbe88c17778aad7bef9fa57ff9e2d4a9ba0d8,2020/08/26,1,5,13,2,0,21
bitnami/configurable-http-proxy,4.6.0,2023/11/23,80,16,8,2,0,106
graphcore/popart,3.3.0,2023/07/03,136,200,24,0,0,360
newrelic/k8s-webhook-cert-manager,1.4.0,2021/04/14,0,7,30,5,0,42
grafana/cortex-querier,WIP-diskcache-220510df,2018/08/31,0,0,0,2,0,2
rancher/kubectld,v1.0.0,2017/09/21,354,434,24,0,0,812
intel/evi-ai-structuring,master-ae213cd97d6931b1d44fc7689867cf5701e0f15d,2023/09/23,56,13,4,1,0,74
objectscale/atlas,1.1.3,2021/02/23,2,12,17,0,0,31
rancher/harvester-network-helper,v0.3.5,2023/12/07,1,4,4,0,0,9
objectscale/config-upload,1.2.6,2021/03/05,15,61,78,11,0,165
kumahq/merbridge,0.8.5,2022/11/02,218,470,82,0,0,770
airbyte/source-opsgenie,0.3.0,2023/11/09,0,15,24,1,0,40
rapidfort/postgresql12-ib,12.16,2023/10/20,105,49,2,0,0,156
jetbrains/teamcity-server,2023.05.4,2023/09/19,58,95,41,5,0,199
percona/pmm-server,2.40.1,2023/10/20,8,83,44,0,0,135
rancher/kiwigrid-k8s-sidecar,1.1.0,2020/10/13,2,24,48,12,0,86
intel/dlstreamer-pipeline-server-k8s-controller,2022.2.0,2022/10/22,78,46,39,3,0,166
rancher/rio-controller,v0.8.0,2020/10/12,2,8,4,0,0,14
airbyte/source-recurly,0.4.1,2022/08/11,0,20,25,1,0,46
adobecoldfusion/apimanager2018,2018.0.1,2021/12/17,109,250,101,40,0,500
rancher/containerd,v1.3.6-k3s2,2020/08/27,256,407,18,3,0,684
circleci/postgres-script-enhance,0.1,2021/12/07,47,17,46,8,3,121
jetbrains/hub,2023.2.20300,2023/11/02,77,54,38,10,0,179
onlyoffice/4testing-docspace-router,2.0.0.33,2023/11/24,132,161,3,0,0,296
rancher/rke2-runtime,v1.28.3-rke2r2-windows-amd64,2023/11/08,0,34,28,0,0,62
rapidfort/fluentd-official,v1.14.0-1.0,2023/06/16,1,2,0,0,0,3
bellsoft/alpaquita-linux-python,3.11-stream-musl,2023/12/19,null
bitnami/bitnami-shell,11,2023/07/15,89,35,24,6,0,154
rancher/network-diagnostics,v0.1.2,2017/07/19,310,388,24,0,0,722
bellsoft/buildpacks.executable-jar,6.6.1,1980/01/01,null
airbyte/source-merge,0.1.0,2023/05/01,0,18,25,1,0,44
couchbase/centos-70-sdk-build,20180808,2018/08/08,1768,2774,358,8,1,4909
okteto/dotnetcore,6,2023/08/24,106,52,67,9,0,234
vertica/verticapy-jupyterlab,v0.1.5,2023/08/04,1129,429,286,32,11,1887
okteto/vote,1.3,2019/02/24,5,22,22,4,0,53
rapidfort/apache2-ib,2.4.53,2023/12/19,7,10,0,0,0,17
airbyte/source-stripe-abprotocol-singer,0.1.3,2020/10/20,144,121,165,35,8,473
amazon/aws-sam-cli-emulation-image-ruby2.7,20220125,2022/01/25,3,48,18,1,0,70
rancher/mirrored-epinio-epinio-unpacker,v1.10.0,2023/09/25,0,3,4,0,1,8
balenalib/zynq-xz702-debian-node,18.6-20220714,2022/07/21,127,79,77,18,0,301
docker/ucp-proxy,1.1.6,2017/01/18,0,42,21,8,0,71
airbyte/source-braintree,0.2.1,2023/11/08,65,13,3,1,0,82
hashicorp/jsii-terraform,0.19.1,2023/12/19,766,264,225,19,3,1277
bitnami/rails,7.1.2,2023/12/18,431,102,50,7,0,590
airbyte/cloud-temporal-migrator,0.39.27-alpha-2865c30,2022/06/29,80,89,60,18,0,247
balenalib/orbitty-tx2-fedora,20231106,2023/11/06,null
okteto/init-syncthing,0.4.1,2019/01/27,null
mirantis/ucp-kube-compose-api,3.5.3,2019/11/07,4,14,9,1,0,28
grafana/drone-downstream,linux-amd64,2023/10/04,0,4,4,0,0,8
astronomerinc/ap-orbit-ui,0.11.0,2020/01/19,12,105,97,32,0,246
objectscale/install-controller,2.0.52,2020/10/14,14,40,53,6,0,113
docker/disk-usage-extension,0.2.8,2023/08/31,null
syncfusion/word-processor-server,23.1.36,2023/09/15,74,25,20,4,0,123
pachyderm/kubeflow-worker,v13,2018/03/28,0,0,1,0,0,1
appdynamics/zfi-sample-app,demo,2018/11/14,743,713,84,3,0,1543
balenalib/up-board-fedora-golang,20231103,2023/11/04,null
balenalib/artik710-fedora-golang,20230530,2023/06/07,null
rancher/ansible-runner,v0.0.1,2016/07/29,1394,2203,237,7,0,3841
airbyte/source-dynamodb,0.1.2,2023/02/23,25,171,192,6,0,394
amazon/aws-fsx-csi-driver,v0.9.0,2022/11/25,29,123,199,3,0,354
rancher/longhorn-manager,5948788,2018/08/09,207,432,15,0,0,654
rancher/mirrored-longhornio-csi-provisioner,v3.4.1,2023/04/05,0,3,3,0,0,6
vmware/lightwave-proxy-toolchain,2.0.0,2018/02/21,18,212,270,117,0,617
objectscale/ecs-flex-graphql-debug,0.54.0,2020/11/10,4,19,20,1,0,44
balenalib/odroid-xu4-alpine-golang,20231106,2023/11/07,0,6,2,0,0,8
balenalib/via-vab820-quad-debian-python,20220604,2022/06/12,127,90,78,20,0,315
balena/armv7hf-supervisor,1299,2020/07/31,6,26,55,9,0,96
vmware/wavefront-adapter-for-istio,0.1.5,2020/09/02,14,49,60,25,0,148
balenalib/odroid-c1-debian-golang,20220714,2022/07/28,471,275,219,29,1,995
couchbase/cloud-native-gateway,0.1.0,2023/08/05,0,4,3,0,0,7
greenbone/openvas-scanner,22.7.6,2023/10/11,112,49,32,4,0,197
balenalib/artik710-alpine-python,20230803,2023/08/04,2,13,5,2,0,22
rapidfort/airflow-scheduler,2.7.1,2023/11/17,39,23,6,1,0,69
balenalib/raspberrypi3-alpine-openjdk,8-20231106,2023/11/07,0,6,2,0,0,8
cimg/rust,1.73.0,2023/10/05,328,370,47,0,0,745
amazon/aws-xray-daemon,3.3.9,2023/10/31,9,44,28,0,0,81
bitnami/supabase-postgres-meta,0.74.3,2023/11/16,80,18,8,2,0,108
grafana/cortex-ingester,w37-0193e7b7,2018/09/11,0,0,0,2,0,2
hashicorp/consul-telemetry-collector,0.0.2,2023/09/19,0,6,6,0,0,12
cimg/cimg-orb,2023.09.1,2023/09/28,328,387,50,0,0,765
mathworks/matlab-runtime-deps,R2023b-ubuntu22.04,2023/12/18,34,34,0,0,0,68
airbyte/source-outbrain-amplify,0.1.2,2023/08/18,0,15,16,0,0,31
balenalib/asus-tinker-board-node,20230904,2023/09/09,121,47,43,6,0,217
airbyte/python-connector-base,1.2.0,2023/10/30,132,47,12,1,0,192
balenalib/parallella-fedora,20221210,2022/12/12,null
cimg/mysql,8.0.33,2023/08/14,328,370,47,0,0,745
datadog/datadog-agent-runner-circle,1.11.5,2019/02/05,201,481,526,98,15,1321
rapidfort/prometheus-ib,v2.44.0,2023/11/17,22,18,6,0,0,46
bitnami/apisix-dashboard,3.0.1,2023/12/12,77,21,9,2,0,109
ubuntu/telegraf,1.21-22.04_edge,2022/04/18,48,52,5,0,0,105
airbyte/source-gitlab,2.0.0,2023/10/26,65,28,7,1,0,101
okteto/github-runner,2.273.0,2020/09/10,187,157,251,47,12,654
airbyte/source-monday,1.1.3,2023/10/04,0,16,24,1,0,41
kasmweb/ubuntu-bionic-dind-rootless,develop-rolling,2022/03/18,272,881,25,0,0,1178
rancher/mirrored-coreos-prometheus-config-reloader,v0.40.0,2020/06/18,0,1,0,0,0,1
adobecoldfusion/fortuna,beta,2023/03/07,59,70,89,49,0,267
vmware/clair-db,9.6.3,2017/07/19,11,93,139,51,0,294
balenalib/qemux86-64-ubuntu,20230911,2023/09/11,42,19,4,0,0,65
balenalib/beaglebone-green-fedora-golang,20220523,2022/06/05,null
newrelic/tfd-kps,1.0.0,2019/07/19,4,14,9,3,0,30
rancher/mirrored-istio-kubectl,1.5.9,2020/08/07,405,1076,128,0,0,1609
onlyoffice/4testing-docspace-urlshortener,test-2022112110,2022/11/21,1028,317,334,27,0,1706
rancher/mirrored-cilium-operator-generic,v1.14.4,2023/11/13,0,2,0,0,0,2
bitnami/pgbouncer,1.21.0,2023/12/06,98,23,9,2,0,132
sysdig/kube-psp-advisor,1.8.0,2020/05/20,2,10,27,4,0,43
mirantis/ucp-swarm,3.7.1,2023/09/26,3,9,6,2,0,20
docker/ssd,bump_18.09,2019/01/28,192,425,432,74,12,1135
bitnami/harbor-clair-archived,2.5.1,2022/06/10,142,124,73,19,0,358
onlyoffice/4testing-appserver-clear-events,test-2022081607,2022/08/16,1045,346,362,25,1,1779
balenalib/asus-tinker-board-openjdk,20230904,2023/09/09,132,73,46,6,0,257
bitnami/fluxcd-image-automation-controller,0.36.1,2023/12/06,77,18,8,2,0,105
ubuntu/cortex,1.11-22.04_edge,2023/01/16,45,65,30,0,0,140
balenalib/artik530-fedora-golang,20220714,2022/07/23,null
rancher/coreos-etcd,v3.2.24,2018/07/24,0,2,2,2,0,6
docker/buildkit-syft-scanner,1.2,2023/04/18,0,7,3,0,0,10
airbyte/source-exchangeratesapi-singer,0.2.2,2021/04/03,109,68,81,30,8,296
kasmweb/core-cuda-focal,1.14.0,2023/09/09,287,571,15,0,0,873
objectscale/control-service,0.71.3,2021/04/15,17,149,226,36,6,434
rancher/mirrored-longhornio-support-bundle-kit,v0.0.27,2023/08/22,4,13,17,0,2,36
graphcore/pytorch-paperspace-early-access,3.3.0-EA.1-ubuntu-20.04-20230504,2023/05/04,287,497,36,0,0,820
mirantis/virtlet-build,v1-2759075286cbf6a20ac746a342b61c11,2018/05/24,547,832,57,0,0,1436
balenalib/odroid-c1-node,18.6-20220714,2022/07/21,127,79,77,18,0,301
airbyte/source-alpha-vantage,0.1.1,2023/01/05,0,18,25,1,0,44
balenalib/revpi-core-3-ubuntu-python,20231026,2023/11/02,37,19,0,0,0,56
objectscale/secondary-scheduler-operator,1.4.0-124.541af8d,2023/11/13,639,684,83,4,0,1410
google/deepvariant,1.6.0,2023/10/23,115,179,8,0,0,302
amazon/amazon-ec2-metadata-mock,v1.9.2,2021/08/26,0,1,2,0,0,3
sysdig/sysdig-inspect,0.7.3.20230622.151714-dev,2023/06/22,664,508,480,63,8,1723
okteto/vote-queue,0.1,2019/02/26,1,16,13,4,0,34
rancher/mirrored-calico-cni,v3.26.3,2023/10/06,0,14,6,0,0,20
balenalib/imx6ul-var-dart-fedora-node,36-build-20230530,2023/06/29,0,1,1,0,0,2
balenalib/i386-alpine-python,3.8.10-3.13-20210506,2021/06/15,6,42,57,15,0,120
rancher/mirrored-thanosio-thanos,v0.21.1,2021/06/04,0,9,11,0,0,20
puppet/ezbake,2.2.1,2020/08/21,1089,1679,129,4,0,2901
appdynamics/cluster-agent-operator,23.9.0-552,2023/09/20,0,5,3,0,0,8
tenable/cns-onprem-scanner,2.5.9,2022/12/06,8,120,142,14,0,284
airbyte/source-visma-economic,0.2.0,2023/10/20,0,15,24,1,0,40
hashicorp/dashboard-service,0.0.4,2019/01/24,0,0,0,2,0,2
bitnami/kubeapps-pinniped-proxy,2.9.0,2023/11/25,77,16,7,2,0,102
mirantis/ucp-metallb-speaker,3.7.1,2023/09/26,0,6,4,0,0,10
objectscale/k8s-kubectl,2.70.0,2020/05/21,2,10,27,4,0,43
circleci/mysql,8.0.28,2022/02/22,141,78,81,22,7,329
balenalib/zynq-xz702-ubuntu,20220714,2022/08/02,87,91,11,0,0,189
rancher/mirrored-epinio-epinio-ui,v1.10.0-0.0.1-s390x,2023/09/07,0,6,9,1,0,16
onlyoffice/dropbox-gateway,1.0.0-rc7,2023/09/04,0,7,6,0,0,13
balenalib/artik5-fedora-golang,20220714,2022/07/23,null
intel/nginx,v2.4,2023/10/15,32,29,0,0,0,61
balenalib/raspberry-pi2-golang,20230911,2023/09/12,382,68,50,8,0,508
rancher/vm-novnc,v0.2.0,2018/12/21,123,215,12,0,0,350
airbyte/source-n8n,0.1.0,2022/11/08,0,19,25,1,0,45
rancher/mirrored-istio-node-agent-k8s,1.5.9,2020/08/07,405,1085,143,0,0,1633
vmware/resource-checker-codebuild,1.0,2019/01/30,18,230,277,120,0,645
qualys/qiac_security_cli,2.1.1,2023/11/01,12,25,3,0,0,40
airbyte/source-mongodb-strict-encrypt,0.2.5,2023/07/27,25,163,191,6,0,385
rancher/vault-volume-driver,v0.0.6,2017/12/13,58,97,13,0,0,168
vmware/vs-function-manager,v0.0.1,2017/11/28,15,81,98,70,0,264
appdynamics/zfi-service,demo,2018/11/14,15,87,196,109,0,407
balenalib/beaglebone-green-wifi-ubuntu-openjdk,11-xenial-20230911,2023/09/11,null
rancher/goharbor-registry-photon,v2.6.2-v1.7.5,2019/04/01,14,63,88,37,0,202
grafana/loki-build-image,0.32.0,2023/11/06,550,184,164,16,2,916
appdynamics/customer-support-images,java-nonroot-65532,2022/04/26,2,32,29,1,0,64
vmware/vcsim,4561966a,2023/03/16,null
rancher/container-crontab,v0.5.0,2018/03/08,0,10,2,0,0,12
airbyte/keycloak,0.50.34,2023/11/09,19,38,7,0,0,64
kasmweb/ubuntu-bionic-desktop,1.10.0,2021/11/16,341,1184,26,0,0,1551
rancher/mirrored-cilium-clustermesh-apiserver,v1.14.4,2023/11/13,null
grafana/k6-httpbin,v0.8.4,2023/08/18,1,5,9,3,0,18
amazon/aws-sam-cli-emulation-image-dotnetcore2.1,20220125,2022/01/25,1,138,92,15,0,246
rancher/mirrored-sig-storage-csi-resizer,v1.9.2,2023/11/09,null
intel/esp-web,v3.1.2,2023/07/25,null
airbyte/integration-singer-csv-destination,0.1.1,2020/10/07,108,83,89,30,8,318
balenalib/colibri-imx6dl-golang,20220714,2022/07/28,471,275,219,29,1,995
balenalib/artik530-node,20220714,2022/07/20,127,79,77,18,0,301
balenalib/kitra710-ubuntu-openjdk,11-xenial-20230904,2023/09/09,null
balenalib/kitra710-ubuntu,20230904,2023/09/09,42,19,4,0,0,65
newrelic/nri-statsd,2.8.0,2023/09/12,0,4,3,0,0,7
balenalib/qemux86-64-debian-node,20231106,2023/11/06,117,31,32,4,0,184
kong/incubator,gateway-wasmtime-3.0.0.0,2022/09/23,139,297,39,0,0,475
cimg/elixir,1.15.4,2023/08/28,259,331,30,0,0,620
pachyderm/pachdclustermetrics,1.08,2021/07/08,1439,1288,880,89,40,3736
balenalib/asus-tinker-board-ubuntu-golang,20231026,2023/11/02,135,137,1,0,0,273
bitnami/kubeapps-dashboard,2.9.0,2023/12/02,87,22,13,4,0,126
redhat/ubi9-minimal,9.3-1361,2023/11/01,18,15,2,0,0,35
bitnami/postgresql,16.1.0,2023/11/30,99,23,10,2,0,134
mattermost/ponos,v0.0.3,2022/07/08,1,11,16,3,0,31
mattermost/mattermost-push-proxy-amd64,5.26.0,2023/11/01,0,5,2,0,0,7
airbyte/destination-doris,0.1.0,2022/11/14,24,173,203,6,0,406
balenalib/raspberrypi3-node,20230530,2023/07/02,121,47,43,6,0,217
airbyte/source-toggl,0.1.0,2022/11/10,0,19,25,1,0,45
bitnami/phabricator-archived,2021.26.0,2021/09/29,370,336,216,43,21,986
kasmweb/core-debian-bullseye,1.14.0,2023/09/09,905,256,281,24,2,1468
onlyoffice/elasticsearch,7.16.3,2022/07/05,235,446,36,0,0,717
rancher/hardened-cni-plugins,v1.2.0-build20231009-s390x,2023/10/10,2,8,12,0,5,27
intel/fm-master,evi-2.0.0,2022/10/31,32,18,0,0,0,50
docker/dtr-jobrunner,2.8.1,2020/06/17,7,73,99,18,1,198
balenalib/artik533s-fedora-python,20220714,2022/07/23,0,1,1,0,0,2
jetbrains/datalore-connection-checker,2022.1.4,1970/01/01,120,441,29,0,0,590
balenalib/generic-armv7ahf-ubuntu-openjdk,11-xenial-20230904,2023/09/09,null
rancher/harvester-vm-import-controller,v0.1.6,2023/12/07,0,5,0,0,1,6
datadog/extendeddaemonset-check,0.5.0-rc.1,2020/12/24,109,228,33,1,0,371
pachyderm/example-rabbitmq-spout,2.1.0-rc.1,2022/02/15,0,5,14,1,0,20
bitnami/dotnet-sdk,7.0.404,2023/12/02,432,98,54,7,0,591
graphcore/pytorch-geometric,3.3.0,2023/07/03,139,202,27,0,0,368
airbyte/source-fauna,0.1.1,2022/12/14,0,18,26,1,0,45
docker/artifactory-agent,v1.0.45,2023/10/02,0,8,5,0,0,13
balenalib/hummingboard-ubuntu-golang,20230904,2023/09/09,143,152,23,0,0,318
qualys/qagent-rhcos,4.2.1-5,2023/08/24,10,23,22,0,0,55
percona/percona-server-mysql-operator,0.6.0,2023/09/04,29,50,12,0,0,91
okteto/kubelet-reconfig,1.0.2,2023/08/03,0,8,2,3,0,13
astronomerinc/ap-git-sync-relay,0.0.2-1,2023/06/12,1,11,4,4,0,20
rancher/drone-exporter,v0.0.2-amd64,2020/05/06,2,14,36,4,0,56
balenalib/generic-armv7ahf,20230904,2023/09/09,121,45,42,6,0,214
appdynamics/ad-air-mock-services,java,2021/01/15,124,149,108,32,0,413
objectscale/event-service,0.71.3,2021/04/15,17,149,226,36,6,434
balenalib/artik530-debian-openjdk,20220714,2022/07/22,160,136,87,18,0,401
objectscale/prometheus,3.9.0.0-1588.729cf194,2023/04/25,5,50,38,0,0,93
rancher/fluentd-geoip,v0.7.0,2020/01/02,145,329,339,44,10,867
astronomerinc/ap-kube-replicator,0.10.0-rc.8,2019/08/16,null
objectscale/dthealth,0.52.0,2020/10/14,0,9,12,0,0,21
onlyoffice/4testing-docspace-login,2.0.0.33,2023/11/24,350,89,71,2,0,512
airbyte/source-fullstory,0.1.0,2023/05/01,0,18,25,1,0,44
vmware/vs-event-driver,v0.0.1,2017/11/28,15,81,98,70,0,264
grafana/wix-toolset-ci,v3,2019/04/11,236,795,758,199,19,2007
newrelic/synthetics-ping-runtime,1.33.0,2023/10/17,43,21,2,0,0,66
cimg/android,2023.11.1,2023/11/06,228,317,30,1,0,576
intel/evi-clustering-archiving,master-ae213cd97d6931b1d44fc7689867cf5701e0f15d,2023/09/23,84,78,94,29,0,285
astronomerinc/ap-default-backend,0.28.21,2023/11/08,0,6,0,0,0,6
balenalib/fincm3-ubuntu-openjdk,11-xenial-20230712,2023/07/18,null
okteto/helm-installer,1.0.12,2021/02/18,99,72,77,22,7,277
okteto/mail,0.3.3,2018/11/19,0,3,11,11,0,25
mirantis/ucp-multus-cni,3.7.1,2023/09/26,56,22,10,1,0,89
atlassian/pipelines-auth-proxy,stg,2020/08/11,2,20,7,5,0,34
intel/test-hello-world-2,1.0.1,2022/02/24,53,25,0,0,0,78
balenalib/raspberry-pi2-fedora-openjdk,8-20221031,2022/11/04,null
balenalib/hummingboard-debian-node,20230904,2023/09/09,121,47,43,6,0,217
vmware/secureclouds-remediation-worker,437-python3.8-alpine3.12,2023/01/12,70,247,176,29,0,522
okteto/tfh,0.1.0,2023/09/28,null
balenalib/via-vab820-quad-ubuntu-node,20220715,2022/07/19,88,113,12,0,0,213
dynatrace/dynatrace-aws-s3-log-forwarder,v0.4.5-x86_64,2023/09/12,2,25,27,2,0,56
onlyoffice/controlpanel,3.5.0.516,2023/04/17,113,176,13,0,0,302
pachyderm/pachyderm_tflite_ex,v1,2019/04/11,350,535,124,7,0,1016
bitnami/influxdb-relay-archived,0.20200717.0,2022/04/20,null
bitnami/zookeeper,3.9.1,2023/12/02,88,25,18,4,0,135
vmware/go-kcl-toolchain,0.1.4,2021/10/22,500,447,348,62,4,1361
mirantis/ucp-interlock,3.7.1,2023/09/26,2,10,7,2,0,21
onlyoffice/docspace-migration-runner,1.1.4.1,2023/10/23,74,45,99,3,0,221
balenalib/artik533s-fedora-node,36-build-20220803,2022/08/04,0,1,1,0,0,2
rapidfort/nginx,1.25.2,2023/10/17,40,8,1,1,0,50
grafana/loki-helm-test,canary-test-9084cc9-WIP,2022/10/04,0,12,8,0,0,20
balenalib/parallella-debian-openjdk,20230904,2023/09/09,132,73,46,6,0,257
balenalib/artik533s-debian-node,20220714,2022/07/20,127,79,77,18,0,301
google/apigee-watcher,1.8.1,2022/09/12,0,3,6,0,0,9
couchbase/mobile-testkit,fix_update-docker-repo-path,2017/06/22,1591,2365,398,16,1,4371
jetbrains/teamcity-agent,2023.05.4,2023/09/19,59,118,107,10,0,294
onlyoffice/docspace-backup-background,1.1.4.1,2023/10/23,1024,157,214,13,0,1408
docker/dev-environments-go,639923ad2c5ce6f29a24ca8d11c8f38f9206c462,2021/06/21,1010,580,666,79,15,2350
bitnami/harbor-exporter,2.9.1,2023/12/06,77,17,7,2,0,103
balenalib/generic-armv7ahf-debian,20230904,2023/09/09,121,45,42,6,0,214
cimg/node,21.1.0,2023/10/26,328,370,47,0,0,745
balenalib/colibri-imx6dl-fedora-python,20220622,2022/07/12,0,1,1,0,0,2
rancher/opni-drain-service,v0.12.1-rc1,2023/11/10,2,10,19,0,10,41
balenalib/artik533s-python,20220714,2022/07/22,127,78,78,18,0,301
bitnami/spring-cloud-dataflow,2.11.1,2023/12/07,77,18,21,4,0,120
rancher/sonobuoy-sonobuoy,v0.19.0,2020/09/15,34,17,45,6,7,109
cockroachdb/kitsune,main,2023/02/13,0,1,1,0,0,2
balenalib/orangepi-plus2-debian,20230911,2023/09/11,121,45,42,6,0,214
airbyte/source-google-workspace-admin-reports,0.1.8,2022/02/24,0,22,52,8,0,82
rancher/os-syslog,v1.5.8,2021/02/05,null
mirantis/ucp-kube-state-metrics,3.7.1,2023/05/31,0,3,1,0,0,4
rancher/jenkins-boot,v0.1.1,2017/12/20,16,174,206,107,0,503
grafana/grafana-docs-dev,arm,2021/05/19,672,1788,162,5,0,2627
okteto/slack-notifier,0.1.1,2019/01/23,11,33,53,9,0,106
intel/hsm-sds-server,1.19.0,2023/09/06,24,21,6,0,0,51
balenalib/amd64-fedora-openjdk,8-20231103,2023/11/04,null
airbyte/source-zenloop,0.1.10,2023/06/29,0,17,25,1,0,43
datadog/trace-paketo-buildpack,1.0.0,1980/01/01,null
airbyte/source-newsdata,0.1.0,2022/11/10,0,19,25,1,0,45
airbyte/source-harvest,0.1.20,2023/10/15,65,28,7,1,0,101
bitnami/grafana-tempo,2.3.0,2023/11/08,77,20,9,2,0,108
apachepinot/zookeeper,3.7.0,2023/02/14,877,384,413,33,0,1707
balenalib/nitrogen6x-node,18.6-20220714,2022/07/21,127,79,77,18,0,301
intel/crypto-reference-stack,1.0,2021/04/14,241,352,45,0,1,639
pachyderm/ide-hub,2.0.0-b4,2021/08/26,492,1162,79,1,0,1734
pachyderm/worker-amd64,97276071e371d5b1ea221437e99cfd87b5599ddf,2023/11/03,1,10,8,0,0,19
docker/ucp-metrics-s390x,3.1.0-beta3,2018/10/04,0,2,6,16,0,24
mattermost/podman,1.8.0,2020/03/10,228,177,245,47,12,709
couchbase/observability-stack,dp2,2022/06/10,17,145,156,13,0,331
okteto/php,8,2023/08/24,242,111,60,9,2,424
rancher/mirrored-minio-mc,RELEASE.2023-06-28T21-54-17Z-s390x,2023/06/29,81,62,10,0,0,153
balenalib/aarch64-ubuntu-node,20231103,2023/11/06,35,16,1,0,0,52
objectscale/supportassist-ese-notifier,2.71.3,2021/04/14,2,19,23,0,0,44
balenalib/generic-armv7ahf-alpine-openjdk,8-20230904,2023/09/09,8,14,6,2,0,30
grafana/drone-grafana-docker,0.3.2,2020/09/29,3,24,46,5,0,78
balenalib/amd64-debian-python,20231106,2023/11/06,110,30,22,4,0,166
jetbrains/datalore-introspection,2022.1.4,1970/01/01,120,441,29,0,0,590
mirantis/ucp-auth-store,3.7.1,2023/09/26,3,15,7,2,0,27
okteto/weaver-sidecar,0.1.10,2023/01/17,66,50,10,0,0,126
rancher/pushprox-proxy,v0.1.0-rancher2-proxy,2021/06/03,0,7,28,4,0,39
balenalib/raspberrypi3-openjdk,20230530,2023/07/04,146,81,48,6,0,281
balenalib/am571x-evm-ubuntu,20220714,2022/08/02,87,91,11,0,0,189
lacework/container-auto-scan-inline,1.1.2,2023/03/28,185,103,93,12,2,395
balenalib/zynq-xz702-alpine-node,20220714,2022/07/19,7,44,34,10,0,95
airbyte/mssql_ssltest,dev,2021/05/12,139,264,14,0,0,417
balenalib/apalis-imx6q-debian-golang,20220714,2022/07/28,471,275,219,29,1,995
vmware/vsan-prometheus-servicediscovery,v20210225,2021/02/26,14,102,109,45,0,270
bitnami/dataplatform-exporter-archived,1.0.1,2022/05/18,0,1,1,0,0,2
amazon/aws-sagemaker-kfp-components,20200402,2020/04/02,22,385,233,26,0,666
balenalib/artik5-openjdk,20220714,2022/07/22,160,136,87,18,0,401
grafana/cortex-query-tee,v1.1.0-grafana-2,2020/06/08,2,16,36,4,0,58
intel/istioctl,1.19.0-intel.0,2023/09/27,29,21,6,0,0,56
balenalib/rpi-alpine-golang,20231026,2023/11/01,0,6,2,0,0,8
rancher/hardened-coredns,v1.7.1,2020/09/25,257,416,32,3,0,708
adobecoldfusion/pmt,latest-2021,2022/12/02,60,95,60,27,0,242
onlyoffice/docspace-router,1.1.4.1,2023/10/23,144,230,10,0,0,384
onlyoffice/docspace-people-server,1.1.4.1,2023/10/23,1024,157,214,13,0,1408
ubuntu/mysql,8.0-22.04_edge,2023/12/13,12,2,0,0,0,14
grafana/grafana-enterprise-arm64v8-linux,7.0.6,2020/07/09,4,32,54,9,0,99
balenalib/raspberrypi3-fedora-python,20221109,2022/12/02,0,1,0,0,0,1
redislabs/redistimeseries,99.99.98,2023/10/08,73,23,17,2,0,115
rancher/rancher-ecr-credentials,v3.0.0,2018/03/08,78,100,15,0,0,193
atlassian/jira-software,9.11.3,2023/12/16,17,32,28,2,0,79
rancher/mirrored-cluster-api-controller,v1.4.4,2023/06/27,0,3,1,0,0,4
balenalib/generic-armv7ahf-ubuntu,20230904,2023/09/09,42,19,4,0,0,65
kasmweb/parrotos-5-desktop,1.14.0,2023/09/14,0,6,6,0,0,12
amazon/aws-for-fluent-bit,2.32.0.20231031,2023/11/03,16,5,0,0,0,21
bellsoft/liberica-openjre-alpine-musl,21.0.1-12,2023/11/14,0,2,2,0,0,4
balenalib/asus-tinker-board-alpine-openjdk,8-20231106,2023/11/07,0,6,2,0,0,8
mirantis/ucp-istio-mixer,3.4.15,2023/05/11,1,13,18,0,6,38
airbyte/source-zoom-singer,0.2.4,2021/07/06,559,326,284,40,8,1217
balenalib/beaglebone-green-wifi-fedora-openjdk,30-20210825,2021/09/03,null
airbyte/source-amazon-ads,3.4.1,2023/10/15,65,28,7,1,0,101
bitnami/envoy,1.28.0,2023/12/15,77,16,7,2,0,102
onlyoffice/documentserver-ucs,7.5.1.1,2023/11/08,113,128,4,1,0,246
mattermost/elrond,9775779,2023/07/06,0,17,13,2,0,32
balenalib/kitra710-golang,20230904,2023/09/09,446,127,78,10,0,661
balenalib/raspberry-pi2-fedora-node,36-build-20230911,2023/09/12,0,1,1,0,0,2
bitnami/opencart,4.0.2-3,2023/12/02,155,88,60,5,0,308
grafana/smtprelay,v1.5.0-0-gd399838,2021/10/05,76,64,46,17,0,203
balenalib/beaglebone-black-fedora-python,20220928,2022/10/04,0,1,1,0,0,2
onlyoffice/4testing-ds-example,6.0.0,2020/10/21,563,574,32,3,0,1172
balenalib/aarch64-alpine,20231106,2023/11/06,0,6,2,0,0,8
bellsoft/buildpacks.alpaquita-build,musl,2023/04/17,null
airbyte/actions-runner,test,2023/08/18,55,51,47,3,0,156
balenalib/colibri-imx6dl-fedora,20220604,2022/06/12,null
rancher/mirrored-calico-apiserver,v3.26.3,2023/10/06,0,3,5,0,0,8
rancher/mirrored-cloud-provider-vsphere-csi-release-driver,v3.1.1,2023/10/24,3,10,13,3,0,29
onlyoffice/telegram-github-changes-bot,v1.0.0-298-g01a9e56,2023/11/09,0,3,2,0,0,5
airbyte/source-tidb,0.3.0,2023/03/16,25,172,190,6,0,393
airbyte/source-salesloft,1.2.0,2023/07/11,0,17,25,1,0,43
bitnami/mariadb-galera,11.1.3,2023/12/19,93,22,15,2,0,132
objectscale/objectscale-health,1.4.0-397.adb0726,2023/11/13,0,5,4,0,0,9
balenalib/generic-armv7ahf-alpine,20230904,2023/09/09,2,6,5,2,0,15
appdynamics/agent-config-client,23.8.0-721,2023/08/24,0,2,2,0,0,4
balenalib/aarch64-golang,20231106,2023/11/07,439,96,56,6,0,597
cockroachdb/builder,20230830-211921,2023/08/30,189,263,15,0,0,467
airbyte/source-copper,0.3.0,2023/08/29,0,17,24,1,0,42
balenalib/apalis-imx6q-ubuntu-openjdk,20210826,2021/09/04,136,435,10,0,0,581
solace/docker-qpid-proton,ubuntu,2018/06/19,644,792,92,0,0,1528
mattermost/pgbouncer-config-reload,v1.1.1,2023/09/28,0,16,9,0,0,25
cockroachdb/acceptance,20221005-223354,2022/10/06,84,347,68,34,0,533
vmware/photon-2.0-k8s-dns-kube-dns-amd64,1.14.10-20180619,2018/06/19,15,72,90,57,0,234
balenalib/beaglebone-black-fedora-openjdk,30-20210825,2021/09/03,null
airbyte/source-confluence,0.2.0,2023/08/18,0,17,24,1,0,42
bitnami/phpmyadmin,5.2.1,2023/12/02,152,87,56,4,0,299
hashicorp/consul-replicate,0.4.0-scratch,2017/08/10,null
kasmweb/remmina,1.14.0,2023/09/14,220,454,0,0,0,674
mattermost/mattermost-push-proxy-arm64,5.26.0,2023/11/01,0,5,2,0,0,7
objectscale/alertmanager,3.7.0.0-1334.45d1715e,2021/09/22,6,59,94,3,5,167
kasmweb/java-dev,1.14.0,2023/09/14,255,600,0,0,0,855
kasmweb/pinta,1.14.0,2023/09/14,246,515,0,0,0,761
balenalib/generic-aarch64-ubuntu-golang,20231103,2023/11/06,141,137,1,0,0,279
sysdig/dockerfile-benchmarker,0.0.1,2020/03/16,2,10,29,4,0,45
mirantis/dtr-trivy-adapter,0.14.0,2020/07/31,10,50,78,15,0,153
okteto/civo-webhook,0.5.3,2023/10/18,0,3,4,0,0,7
newrelic/synthetics-node-api-runtime,1.2.1,2023/11/07,99,142,3,0,0,244
docker/imagefs,0.4.0-alpha,0001/01/01,null
rancher/mirrored-longhornio-longhorn-engine,v1.5.1,2023/07/19,5,42,70,0,10,127
rancher/slackin-extended,v2.1.3,2020/10/22,3,77,71,14,0,165
grafana/oncall,v1.3.58,2023/11/14,3,18,8,0,0,29
rancher/terraform-controller-executor,v0.0.13-alpha1,2020/11/19,11,58,105,14,0,188
appdynamics/dl-proxy,23.10.0,2023/10/31,26,12,0,0,0,38
newrelic/newrelic-fluentbit-output,1.17.3,2023/06/20,27,30,17,1,0,75
balenalib/artik5-fedora-python,20220714,2022/07/23,0,1,1,0,0,2
percona/everest-operator-bundle,0.4,2023/10/31,null
balenalib/intel-nuc-alpine-golang,20231106,2023/11/07,0,6,2,0,0,8
balenalib/via-vab820-quad,20220714,2022/07/20,127,77,76,18,0,298
circleci/picard,1.0.196890-89790297,2023/08/10,0,48,16,0,0,64
adobecoldfusion/coldfusionaddons,latest-2023,2023/05/19,268,452,124,46,0,890
mirantis/dtr-rethink,2.9.14,2023/09/28,2,44,27,2,0,75
airbyte/source-callrail,0.1.0,2022/11/15,0,19,25,1,0,45
balena/amd64-balena-multibuild-scripts,0.1.0,2019/10/01,4,14,9,1,0,28
rancher/harvester-csi-driver,v0.1.6,2023/10/18,1,14,17,0,5,37
newrelic/k8s-nri-mongodb,2.4.1,2020/02/10,2,11,29,4,0,46
vmware/likewise-open-toolchain-photon3,1.0.0,2019/12/04,24,216,236,65,0,541
snyk/kubernetes-scanner,v0.20.3,2023/10/16,null
datadog/extendeddaemonset,v0.9.0-rc.2,2022/09/27,71,79,14,1,0,165
airbyte/source-spacex-api,0.1.1,2023/11/07,0,15,24,1,0,40
hashicorp/waypoint-odr,0.11.4,2023/08/09,1,43,26,0,0,70
docker/dtr-registry,2.8.1,2020/06/17,2,9,8,1,0,20
newrelic/nri-forwarder,1.48.1,2023/11/02,0,10,0,0,0,10
balenalib/armv7hf-debian-golang,20230929,2023/10/02,445,124,79,10,0,658
objectscale/qualification-service-tools,0.69.0,2021/03/15,18,141,169,6,6,340
balenalib/raspberrypi3-alpine,20231106,2023/11/07,0,6,2,0,0,8
cockroachdb/loadgen-kv,0.2,2018/03/08,null
balenalib/up-board-fedora-openjdk,8-20231103,2023/11/04,null
okteto/buildkit-proxy,v0.0.1,2022/11/21,0,3,6,0,0,9
bitnami/appsmith,1.9.44,2023/11/08,90,35,30,4,0,159
balenalib/asus-tinker-board-s-python,20230911,2023/09/12,121,46,42,6,0,215
atlassian/default-image,4.20230906,2023/09/06,173,223,33,0,0,429
grafana/grafana-build,main,2023/12/19,0,9,5,0,0,14
vmware/photon-2.0-k8s-heapster-amd64,1.4.2-20180619,2018/06/19,15,72,90,57,0,234
airbyte/destination-google-sheets,0.2.3,2023/09/25,65,29,7,1,0,102
pachyderm/cert-manager-webhook,v0.15.1,2020/05/27,0,0,0,0,6,6
kong/pulp-api,1.1.38,2022/08/24,4,14,10,4,0,32
balenalib/jetson-tx1-ubuntu-node,20230530,2023/06/26,55,30,5,0,0,90
rancher/helm-locker,v0.0.1,2022/05/11,0,17,10,0,2,29
objectscale/confd-sidecar,3.9.0.0-1588.729cf194,2023/04/25,4,35,28,0,0,67
balenalib/generic-armv7ahf-fedora-node,36-build-20230530,2023/06/29,0,1,1,0,0,2
airbyte/workload-launcher,final-8,2023/11/15,20,75,61,2,0,158
datadog/dd-appsec-php-ci,toolchain,2023/08/23,495,213,128,25,2,863
kasmweb/retroarch,1.14.0,2023/09/14,229,458,0,0,0,687
intel/rpbs_app,1.0,2023/08/21,0,5,3,0,0,8
cockroachdb/cockroach-k8s-init,0.2,2017/05/31,132,246,16,0,0,394
rancher/network-policy-manager,v0.2.8,2018/07/08,306,388,24,0,0,718
onlyoffice/box-callback,1.0.1,2023/09/12,0,8,6,0,0,14
kasmweb/share,1.14.0,2023/09/14,28,15,1,0,0,44
balenalib/fincm3-alpine-golang,20221109,2022/11/25,6,36,28,9,0,79
airbyte/source-polygon-stock-api,0.1.1,2023/02/27,0,18,25,1,0,44
astronomerinc/ap-nats-server,2.10.2-1,2023/11/08,0,5,1,0,0,6
lacework/lacework-admission-controller,0.23.2,2023/11/10,0,2,1,0,0,3
balenalib/artik10,20220714,2022/07/22,127,77,76,18,0,298
airbyte/source-punk-api,0.1.0,2022/11/16,0,19,25,1,0,45
jetbrains/code-with-me-relay,1161,2023/01/23,0,21,18,0,0,39
objectscale/kube-scheduler,v0.26.7,2023/07/25,0,10,8,0,0,18
balenalib/revpi-core-3-fedora-golang,20220523,2022/06/04,null
bitnami/drupal-nginx,10.1.6,2023/12/02,166,88,58,5,0,317
mattermost/mattermost-test-team,9f6859c,2020/03/28,6,46,77,9,0,138
datadog/docker-library,zookeeper_3_4_10,2017/11/09,16,51,40,22,0,129
balenalib/zynq-xz702-ubuntu-openjdk,20210826,2021/09/04,136,435,10,0,0,581
graphcore/simple-server-framework,1.0.0,2023/07/20,161,272,32,0,0,465
airbyte/source-ringcentral,0.1.0,2023/05/18,0,18,25,1,0,44
intel/cri-resmgr-agent,v0.8.4,2023/08/25,0,6,4,0,0,10
couchbase/centos-69-sdk-nodevtoolset-build,20180809,2018/08/09,1621,2019,258,7,0,3905
percona/percona-distribution-postgresql,16,2023/12/18,null
onlyoffice/docspace-api-system,1.1.4.1,2023/10/23,1024,157,215,13,0,1409
balenalib/zynq-xz702-ubuntu-node,20220715,2022/07/19,88,113,12,0,0,213
pachyderm/pdk,train-9195916,2023/10/03,511,298,88,10,2,909
jetbrains/datalore-database-command,2023.5.1,1970/01/01,63,112,9,0,0,184
balenalib/raspberrypi3-fedora,20221031,2022/11/04,null
objectscale/record-manager,0.71.3,2021/04/15,17,149,226,36,6,434
newrelic/k8s-operator,snapshot,2020/05/29,0,7,11,0,6,24
syncfusion/boldreports,5.3.8,2023/10/26,50,59,20,0,0,129
kong/statsd-exporter-advanced,0.3.1,2020/04/20,null
pachyderm/pachyderm,2.7.0-test.2,0001/01/01,null
airbyte/source-zendesk-talk,0.1.9,2023/08/03,142,91,44,3,0,280
airbyte/destination-pinecone,0.0.20,2023/11/13,65,29,10,4,0,108
rapidfort/couchdb_3-ib,3.3.2,2023/12/03,22,7,1,0,0,30
mattermost/mattermost-prod-db,v5.33.3,2021/03/31,9,27,42,7,0,85
rancher/goharbor-harbor-adminserver,v1.7.5,2019/04/01,14,63,88,37,0,202
objectscale/objectstore-pre-update,0.71.3,2021/03/24,2,18,22,0,0,42
objectscale/ecs-service-broker,2.3.1,2023/04/12,61,41,15,2,0,119
airbyte/source-gitlab-singer,0.1.3,2021/07/06,559,327,283,40,8,1217
airbyte/mirrored-keycloak-amd,21.1,2023/06/28,19,38,7,0,0,64
datadog/agent-dev,7-48-1-usm-extended-http-capturing-py3-jmx,2023/10/15,27,61,17,0,0,105
rancher/pipeline,v0.1.1,2018/01/11,161,285,17,0,0,463
vmware/hcx-helm,3.2,2021/01/07,20,145,173,64,0,402
portainer/portainer-ee,2.19.2,2023/11/12,0,22,13,0,0,35
rancher/harvester-network-controller,v0.3.5,2023/12/07,1,7,4,0,1,13
airbyte/airbyte-workload-api-server,final-0,2023/11/14,20,69,54,2,0,145
airbyte/source-news-api,0.1.1,2023/04/30,0,18,25,1,0,44
dynatrace/dynatrace-configuration-as-code,2.9.2,2023/11/06,0,2,2,0,0,4
balenalib/amd64-ubuntu-node,20230929,2023/10/07,40,17,5,0,0,62
balenalib/artik5-ubuntu-openjdk,20210826,2021/09/21,136,435,10,0,0,581
bitnami/jaeger,1.51.0,2023/12/06,77,20,11,2,0,110
airbyte/destination-bitdotio,0.1.0,2022/10/14,28,192,249,21,0,490
rapidfort/couchdb,3.3.2,2023/11/15,61,16,11,3,0,91
mirantis/gpu-example,cuda-10.2,2020/02/16,153,207,15,0,0,375
snyk/runtime-fixtures,ubuntu,2022/03/14,87,167,4,0,0,258
balenalib/qemux86-64-fedora-python,20231103,2023/11/04,null
rapidfort/nats,2.9.18,2023/06/20,24,11,5,0,0,40
docker/ucp-init-azure,2.1.0,2017/02/09,18,117,93,51,0,279
graphcore/pytorch-minimal-early-access,3.3.0-EA.1-ubuntu-20.04-20230504,2023/05/04,173,282,34,0,0,489
hashicorp/boundary,0.14.2,2023/10/31,0,5,0,0,0,5
astronomerinc/ap-cli-install,0.26.20,2023/11/08,0,6,0,0,0,6
balenalib/amd64-alpine-openjdk,8-20231106,2023/11/07,0,6,2,0,0,8
pachyderm/compile,go1.13.8,2020/02/14,616,875,78,0,0,1569
airbyte/destination-typesense,0.1.1,2023/08/23,0,17,24,1,0,42
balenalib/revpi-core-3-fedora-openjdk,8-20221031,2022/11/04,null
adobecoldfusion/coldfusionaddons2023,2023.0.0,2023/05/19,268,452,124,46,0,890
balenalib/hummingboard-fedora-openjdk,30-20210825,2021/09/03,null
ubuntu/dotnet-deps,7.0_beta,2023/11/01,null
dynatrace/edgeconnect,1.46.0,2023/11/06,12,4,0,0,0,16
redis/redis-stack-server,7.2.0-RC3,2023/07/10,27,27,2,0,0,56
primekey/ejbca-ce,8.0.0,2023/06/29,5,49,32,6,0,92
hashicorp/terraform,1.7.0-alpha20231108,2023/11/08,0,5,2,0,0,7
newrelic/synthetics-minion,3.0.95,2023/11/25,38,23,6,0,0,67
percona/percona-orchestrator,3.2.6-10,2023/09/19,133,38,9,0,0,180
okteto/react-getting-started,dev,2020/05/06,518,1483,1197,250,12,3460
balena/balena-redis,0.0.4,2021/01/06,2,6,32,4,0,44
bitnami/chartmuseum-archived,0.15.0,2023/05/21,78,75,35,5,0,193
rancher/mirrored-bci-busybox,15.4.11.2,2022/09/26,0,3,2,0,2,7
airbyte/source-gridly,0.1.1,2022/12/08,0,16,17,0,0,33
intel/apphsm,v2.4,2023/10/15,37,31,2,0,0,70
okteto/registry,2.7.2-dev2,2021/02/05,0,7,8,3,0,18
rancher/mirrored-longhornio-longhorn-instance-manager,v1.5.1,2023/07/19,4,40,62,0,10,116
airbyte/source-google-pagespeed-insights,0.1.1,2023/05/26,0,17,25,1,0,43
bitnami/ksql,7.5.2,2023/12/09,77,22,13,7,0,119
newrelic/kubernetes-operator,v0.0.8,2021/07/10,0,7,13,0,5,25
balenalib/am571x-evm-alpine-openjdk,8-3.14-20220112,2022/01/19,2,50,42,13,0,107
balenalib/asus-tinker-board-debian-openjdk,20230904,2023/09/09,132,73,46,6,0,257
rancher/longhorn-manager-test,5766348,2018/07/10,650,2165,1782,380,40,5017
portainer/pause,3.9,2023/08/30,null
okteto/wasp,alpha,2021/02/26,434,512,452,93,9,1500
adobecoldfusion/apimanageraddons,latest-2023,2023/05/17,37,32,8,3,0,80
balenalib/spacely-tx2-golang,20231106,2023/11/07,440,96,56,6,0,598
stackhawk/hawkscan,3.4.7,2023/11/10,48,66,5,0,0,119
mirantis/ucp-istio-pilot,3.4.15,2023/05/11,471,1163,150,1,0,1785
google/apigee-deployment-admissionhook,1.1.1,2020/02/05,0,0,0,0,6,6
rancher/storage-secrets-bridge-v2,v0.9.7,2018/07/09,125,218,12,0,0,355
balenalib/artik530-debian-golang,20220714,2022/07/22,471,278,225,29,1,1004
airbyte/source-surveymonkey,0.2.3,2023/10/15,65,28,7,1,0,101
nginxinc/nginx-unprivileged,1.25.3,2023/12/18,83,26,11,1,0,121
kasmweb/nginx,1.25.1,2023/06/16,2,15,9,2,0,28
okteto/test,2,2022/04/20,115,133,79,23,0,350
atlassian/fisheye,4.8.13,2023/12/17,129,155,27,6,0,317
airbyte/destination-mqtt,0.1.3,2022/09/07,77,80,63,19,0,239
balenalib/artik710-alpine,20230904,2023/09/09,2,6,5,2,0,15
balenalib/raspberrypi3-python,20230530,2023/06/27,121,46,42,6,0,215
airbyte/source-nytimes,0.1.1,2023/03/02,0,18,25,1,0,44
airbyte/source-pagerduty,0.2.0,2023/10/23,0,15,24,1,0,40
onlyoffice/4testing-docspace-api,2.0.0.33,2023/11/24,1024,156,211,13,0,1404
kong/fpm,0.8.1,2023/03/01,814,553,345,24,2,1738
balenalib/asus-tinker-board-ubuntu-python,20231026,2023/11/02,37,19,0,0,0,56
balenalib/beaglebone-green-node,20230911,2023/09/11,121,47,43,6,0,217
rancher/machine,v0.15.0-rancher106-s390x,2023/10/04,3,13,16,0,5,37
intel/intel-optimized-mysql,src,2023/02/11,212,313,49,0,0,574
cockroachdb/acceptance-gss-psql,20230920-104814,2023/09/20,116,49,23,3,0,191
docker/containerd-shim-process,6244e3d,2018/08/10,null
onlyoffice/docspace-proxy,1.1.1.1,2023/07/27,173,51,44,3,2,273
vertica/vertica-k8s,23.4.0-0,2023/09/21,79,170,19,0,0,268
hashicorp/vault-enterprise-fips,1.15.2-ent.fips1402,2023/11/07,74,22,0,0,0,96
docker/ucp-pause,3.3.1,2020/02/04,null
airbyte/source-yahoo-finance-price,0.2.0,2023/08/22,0,17,24,1,0,42
rapidfort/keycloak-official,22.0.5-0,2023/10/24,2,2,0,0,0,4
docker/ucp-hyperkube,3.3.1,2020/06/26,6,24,24,1,0,55
kong/kong-gateway,3.5.0.0,2023/11/07,22,10,0,0,0,32
docker/ucp-containerd-shim-process,3.3.1,2019/12/16,null
pingidentity/ldap-sdk-tools,2310,2023/11/01,0,3,1,0,0,4
calcom/cal.com,v3.4.7,2023/11/07,488,301,79,9,2,879
rancher/rpardini-docker-registry-proxy,0.6.1,2020/12/02,3,13,38,5,0,59
rancher/hardened-cilium-llvm,4c18d06f1d545ed6fde810c2b97935dc8938ddc8-build20210521,2021/05/21,544,498,32,3,0,1077
docker/ucp-kube-dns-sidecar,3.2.7,2020/06/26,0,0,0,2,0,2
balenalib/artik533s-debian-openjdk,20220714,2022/07/22,160,136,87,18,0,401
onlyoffice/4testing-docspace-socket,2.0.0.33,2023/11/24,350,91,71,2,0,514
mattermost/sync-helpwanted-tickets,1.1.2,2023/07/26,525,326,127,17,6,1001
balenalib/artik533s-ubuntu,20220714,2022/08/02,87,91,11,0,0,189
grafana/pentagon,62,2022/01/25,0,24,31,1,0,56
redhat/ubi8-init,8.8-15,2023/09/13,157,45,6,0,0,208
balenalib/amd64-golang,20231106,2023/11/06,439,97,56,6,0,598
pachyderm/ubuntu_with_s3_clients,0.1,2021/05/02,487,619,58,0,0,1164
graphcore/pytorch-geometric-paperspace,3.3.0,2023/07/03,245,373,28,0,0,646
airbyte/source-oura,0.1.0,2022/10/28,0,19,25,1,0,45
airbyte/source-microsoft-dataverse,0.1.2,2023/08/25,0,15,16,0,0,31
balenalib/artik5-ubuntu-python,20220715,2022/08/02,87,92,13,0,0,192
balenalib/am571x-evm-alpine-python,20220714,2022/07/19,7,44,35,10,0,96
datadog/agent-buildimages-rpm_arm64,v20433308-6861270,2023/09/25,16,103,228,4,0,351
bitnami/rabbitmq-cluster-operator,2.5.0,2023/11/09,0,1,1,0,0,2
ubuntu/kafka,3.1-22.04_edge,2023/07/06,33,43,11,5,0,92
dynatrace/dynatrace-oneagent,1.277.165.20231024-150054,2023/10/25,7,2,0,0,0,9
redislabs/gesher,0.6,2022/01/05,0,5,11,1,0,17
balenalib/spacely-tx2-node,20231106,2023/11/07,117,31,32,4,0,184
airbyte/source-mongodb-internal-poc,0.0.1,2023/08/01,25,163,191,6,0,385
rapidfort/fluentd-ib,1.15.3,2023/06/28,29,13,4,0,0,46
rancher/agent-base,v0.3.0,2016/12/22,306,388,24,0,0,718
rancher/curlimages-curl,7.73.0,2020/10/14,2,10,27,4,0,43
rancher/git-logrotate,v0.7.0,2020/01/02,null
