onlyoffice/4testing-docspace-doceditor,2.0.0.33,2023/11/15,343,72,58,2,2,477
vmware/kube-fluentd-operator,v1.18.1,2023/11/07,0,2,2,0,0,4
vmware/vs-openfaas-watchdog,revbf667b8,2017/12/11,211,543,569,143,35,1501
balenalib/parallella-debian-golang,20230904,2023/09/09,442,111,73,9,0,635
vmware/vsan-prometheus-exporter,v20210717,2021/07/17,15,96,110,45,0,266
rancher/vm-frontend,v0.2.0,2019/03/07,232,803,873,256,33,2197
circleci/builder-base,1.1,2017/01/11,304,355,22,2,0,683
bitnami/redis-exporter,1.55.0,2023/11/09,74,12,8,2,0,96
balena/rpi-supervisor-base,v1.4.7,2019/05/28,null
balenalib/qemux86-64-alpine-node,20231106,2023/11/07,0,1,5,0,0,6
ubuntu/apache2,2.4-23.04_edge,2023/11/16,13,4,0,0,0,17
rancher/hardened-cluster-autoscaler,v1.8.6-build20231010-s390x,2023/10/10,2,5,13,1,2,23
graphcore/poplar-minimal,3.3.0,2023/07/03,32,11,0,0,0,43
airbyte/destination-elasticsearch-strict-encrypt,0.1.6,2022/10/26,60,180,145,2,0,387
bitnami/express,4.18.2,2023/11/03,98,92,91,30,0,311
greenbone/boreas,v22.5.0,2023/05/02,90,36,30,4,0,160
rancher/nginx-ingress-controller-chroot,nginx-1.9.4-hardened1rc6-s390x,2023/10/26,2,2,14,0,0,18
balenalib/spacely-tx2-debian,20231106,2023/11/07,114,20,29,4,0,167
vmware/vs-secret-store,v0.0.1,2017/11/28,15,81,98,70,0,264
circleci/nomad-metrics,1.0,2020/11/17,0,1,0,0,0,1
balenalib/colibri-imx6dl-openjdk,20210602,2021/06/05,230,232,145,39,8,654
balenalib/i386-alpine-openjdk,8-20230911,2023/09/11,8,8,8,2,0,26
circleci/ecr-login,0.1.0-circle8,2020/05/27,null
intel/trusted-certificate-issuer,0.5.0,2023/03/10,51,45,1,0,0,97
balenalib/nitrogen6x-debian-python,20220604,2022/06/12,124,81,76,20,0,301
grafana/loki-canary-test,canary-test-58315f7-WIP,2022/09/23,0,12,16,0,0,28
rancher/docker,v1.11.2-3,2017/09/01,null
hashicorp/nomad-autoscaler-enterprise,0.3.6,2022/02/18,0,5,11,1,0,17
astronomerinc/ap-cadvisor,0.11.1,2020/01/23,0,10,2,0,0,12
balenalib/raspberrypi3,20230911,2023/09/11,118,36,40,6,0,200
balenalib/intel-nuc-ubuntu-openjdk,11-xenial-20230911,2023/09/11,null
vmware/vs-openfaas-python3-base,0.0.5-dev1,2017/12/12,15,128,162,93,0,398
datadog/apigentools,1.6.6,2023/09/21,2,3,3,2,0,10
bitnami/kafka-exporter,1.7.0,2023/11/08,74,14,9,2,0,99
jetbrains/qodana-python,2023.2,2023/09/06,142,60,68,11,0,281
airbyte/source-google-analytics-v4,0.2.2,2023/10/15,64,21,8,1,0,94
lacework/codesec,v1.0.4,2023/10/02,57,52,15,0,0,124
objectscale/throttler,0.54.0,2020/11/06,2,50,56,6,2,116
airbyte/source-convertkit,0.1.0,2022/10/27,0,17,27,1,0,45
onlyoffice/docspace-webhooks-service,test,2022/09/08,1037,333,357,22,1,1750
docker/dockerfile,1.6,2023/07/12,0,4,5,0,0,9
rancher/autoscale,v0.0.1,2016/06/23,0,27,24,10,0,61
airbyte/source-sendinblue,0.1.0,2022/11/10,0,17,27,1,0,45
airbyte/source-clickhouse-strict-encrypt,0.1.17,2023/03/22,61,185,134,2,0,382
balenalib/imx6ul-var-dart-alpine-openjdk,8-20231106,2023/11/07,0,0,4,0,0,4
balenalib/kitra520-fedora-golang,20220714,2022/07/23,null
balenalib/intel-nuc-ubuntu-node,20230911,2023/09/11,43,11,5,0,0,59
rancher/jenkins-jenkins,2.107-slim,2018/02/14,205,351,361,117,18,1052
balenalib/generic-armv7ahf-node,20230904,2023/09/09,118,38,41,6,0,203
airbyte/destination-rabbitmq,0.1.1,2022/09/09,0,17,27,1,0,45
bellsoft/buildpacks.native-image,5.9.0,1980/01/01,null
pachyderm/iris-infer,rstats,2017/04/20,234,640,709,121,40,1744
pachyderm/ubuntus3clients,v0.0.1,2020/03/05,705,1052,116,7,0,1880
docker/desktop-kubernetes-scheduler,v1.28.2,2023/09/13,0,2,4,0,0,6
pachyderm/pachyderm_jupyter,2019,2019/04/09,36,40,69,16,8,169
pachyderm/housing-prices,1.11.0,2020/07/23,455,956,191,20,0,1622
rancher/git-analyze,v0.7.0,2020/01/02,null
jetbrains/qodana-jvm-community,2023.2,2023/09/06,140,51,58,10,0,259
bitnami/fluxcd-kustomize-controller,1.1.1,2023/11/08,116,16,27,3,0,162
bitnami/postgres-exporter,0.15.0,2023/11/09,74,12,8,2,0,96
grafana/carbon-relay-ng,1.4.4,2023/07/27,0,9,8,3,0,20
mirantis/ucp-csi-resizer,3.5.3,2022/04/05,0,8,14,0,6,28
mirantis/ucp-interlock-proxy,3.7.1,2023/09/26,2,2,4,2,0,10
balenalib/jetson-tx2-debian-openjdk,20231106,2023/11/07,125,43,31,4,0,203
docker/dtr-content-cache-s390x,2.5.0-beta3,2018/01/17,0,2,2,2,0,6
kasmweb/tor-browser,1.14.0,2023/09/14,185,385,5,0,0,575
rancher/mirrored-calico-pod2daemon-flexvol,v3.26.3,2023/10/06,null
lacework/gcp-cfg-cli,v1.0,2019/01/21,837,1616,90,1,0,2544
balenalib/jetson-tx2-fedora,20231106,2023/11/06,null
balenalib/asus-tinker-board-fedora,20221210,2022/12/12,null
airbyte/destination-mysql-strict-encrypt,0.2.0,2023/06/29,65,199,176,17,0,457
cockroachdb/cockroach-unstable,v23.2.0-alpha.6,2023/11/08,16,11,0,0,0,27
airbyte/source-tiktok-marketing,3.9.2,2023/11/02,64,21,8,1,0,94
rancher/mirrored-elemental-seedimage-builder,1.3.4,2023/09/12,null
balenalib/revpi-core-3-python,20230530,2023/06/27,118,37,40,6,0,201
newrelic/k8s-nri-redis,1.4.0,2020/01/17,null
rapidfort/consul-official,1.16,2023/10/31,null
docker/dtr-s390x,2.4.12,2019/05/06,9,33,53,11,0,106
balenalib/odroid-xu4-ubuntu-node,20231026,2023/11/02,38,10,1,0,0,49
rapidfort/traefik,v2.9.10,2023/04/06,0,9,4,0,0,13
intel/esp-dyn-profile,v3.1.2,2023/07/25,null
onlyoffice/gdrive-builder,1.0.0-rc15,2023/09/18,0,4,7,0,0,11
objectscale/fabric-proxy,0.71.3,2021/04/05,2,17,23,0,0,42
balenalib/i386-nlp-debian-openjdk,20210225,2021/04/19,242,240,159,48,10,699
objectscale/ecs-flex-graphql,0.71.3,2021/04/14,11,33,31,1,0,76
balena/ca-private,0.0.13,2023/05/19,470,215,167,14,0,866
ubuntu/cassandra,4.0-22.04_edge,2023/05/17,38,61,10,0,0,109
rancher/hyperkube-base,v0.0.18,2023/10/16,39,34,0,0,0,73
grafana/agent-operator,v0.37.4,2023/11/06,14,4,0,0,0,18
rancher/longhornio-longhorn-ui,v1.3.1,2022/08/11,7,45,41,3,11,107
objectscale/snmp-notifier,2.114.0-264.7f91db2,2023/08/25,2,5,6,0,0,13
balenalib/generic-armv7ahf-ubuntu-node,20230904,2023/09/09,43,11,5,0,0,59
rancher/tiller,v2.11.0,2018/09/25,0,0,0,2,0,2
datadog/cws-instrumentation-dev,will-inject-k8s-user-info,2023/11/06,null
balenalib/odroid-c1-ubuntu-openjdk,20210826,2021/09/04,136,435,10,0,0,581
balenalib/spacely-tx2-ubuntu-python,20231103,2023/11/06,37,10,0,0,0,47
rancher/mirrored-kube-state-metrics-kube-state-metrics,v2.6.0,2022/08/24,0,3,4,1,0,8
balenalib/jetson-tx2-ubuntu-python,20230530,2023/06/11,54,21,4,0,0,79
intel/intelligent_traffic_management_video_inference,1.0,2022/06/17,445,1322,60,0,0,1827
docker/desktop-kubernetes-apiserver,v1.28.2,2023/09/13,0,2,4,0,0,6
bitnami/rabbitmq,3.12.8,2023/11/17,98,18,15,4,0,135
pachyderm/example-joins-inner-outer,2.1.0,2022/02/10,824,950,731,95,5,2605
airbyte/destination-databricks,1.1.0,2023/06/08,65,199,179,17,0,460
greenbone/scap-data,202311150504,2023/11/15,null
amazon/amazon-keyspaces-toolkit,0.7.8,2021/12/14,37,259,92,1,0,389
airbyte/cron,0.50.34,2023/11/09,5,72,56,0,0,133
mattermost/fleet-controller,7549599,2022/09/16,0,13,16,1,0,30
pachyderm/mount-server-arm64,97276071e371d5b1ea221437e99cfd87b5599ddf,2023/11/03,94,16,28,2,0,140
balenalib/generic-armv7ahf-fedora-openjdk,30-20210825,2021/09/03,null
atlassian/forge-tunnel,0.8.0-next.4,2020/02/11,591,831,93,6,0,1521
redislabs/redis-bionic,5.0.5,2019/06/06,93,72,2,0,0,167
vmware/photon-2.0-kube-proxy-amd64,v1.10.2-20180619,2018/06/19,17,94,117,76,0,304
balenalib/beaglebone-black-fedora-node,36-build-20230712,2023/07/17,0,1,1,0,0,2
airbyte/destination-iceberg,0.1.4,2023/07/27,68,191,181,15,0,455
balenalib/revpi-core-3-node,20230530,2023/07/02,118,38,41,6,0,203
onlyoffice/docs-proxy-de,7.5.1-1,2023/11/09,0,2,1,1,0,4
mattermost/release-bot,v0.0.1,2022/12/28,0,0,1,0,0,1
balenalib/fincm3-debian-python,20230530,2023/06/27,118,37,40,6,0,201
docker/resource-usage-extension,1.0.3,2023/05/25,0,8,4,3,0,15
balenalib/fincm3-openjdk,20230530,2023/07/04,143,72,46,6,0,267
bellsoft/liberica-openjdk-alpine-musl,21.0.1-12,2023/11/14,0,0,4,0,0,4
rancher/kibana,5.6.4,2017/11/08,50,130,107,42,20,349
google/dart-runtime,2.16-beta,2021/12/13,190,104,123,39,9,465
cockroachdb/example-orms-builder,20200729-1723,2020/07/29,922,1012,916,175,26,3051
airbyte/source-secoda,0.1.0,2022/11/08,0,17,27,1,0,45
rancher/library-traefik,2.4.9,2021/06/22,4,18,37,4,0,63
snyk/snyk-iac-rules,1.8.0,2023/06/05,0,4,2,0,0,6
airbyte/source-bamboo-hr,0.2.2,2022/10/06,77,38,40,3,0,158
astronomerinc/ap-configmap-reloader,0.12.0,2023/10/04,null
onlyoffice/docs-proxy,7.5.1-1,2023/11/09,0,2,1,1,0,4
rancher/confd,v0.12.0-alpha3,2017/02/10,1,36,13,3,0,53
balenalib/zynq-xz702-python,20220604,2022/06/12,124,81,76,20,0,301
intel/intel-optimized-clickhouse,23.11_oh,2023/04/24,48,53,6,0,0,107
grafana/enterprise-logs,v1.8.4,2023/10/18,0,2,5,0,0,7
objectscale/dell-supportassist-ese,2.71.3,2021/04/14,264,611,13,0,0,888
bitnami/wavefront-proxy-archived,12.4.0,2023/06/14,75,24,18,2,0,119
onlyoffice/documentserver-develop,develop,2022/10/24,364,1125,79,0,0,1568
rancher/mirrored-prom-prometheus,v2.18.2,2020/06/09,2,22,28,0,0,52
balenalib/armv7hf-golang,20230929,2023/10/02,441,111,74,9,0,635
grafana/otel-lgtm,0.1.0,2023/11/03,157,80,29,0,0,266
okteto/nginx,alpine,2018/11/13,2,18,6,5,0,31
airbyte/source-teradata,0.1.0,2023/04/06,61,183,134,2,0,380
onlyoffice/doc-builder-testing,next-release,2023/11/21,501,222,56,3,2,784
cockroachdb/visus,v0.2.0,2023/11/05,null
airbyte/airbyte-csv-destination-abprotocol,0.1.0,2020/10/20,100,73,79,24,6,282
rancher/mirrored-cilium-hubble-ui-backend,v0.12.1,2023/10/11,0,1,4,0,0,5
pachyderm/sentimentalist,1.11,2020/09/03,1473,1451,1076,153,39,4192
pachyderm/go-test-results,0.0.11,2023/08/10,0,4,12,0,0,16
vmware/vs-identity-manager,v0.0.1,2017/11/28,15,81,98,70,0,264
balenalib/bananapi-m1-plus,20230911,2023/09/11,118,36,40,6,0,200
airbyte/source-infinite-feed,dev,2021/05/07,105,85,94,27,6,317
balenalib/aarch64-ubuntu-golang,20231103,2023/11/06,139,131,0,0,0,270
jetbrains/upsource-cassandra,2020.1.1992,2022/03/11,97,153,200,63,11,524
rancher/mirrored-jetstack-cert-manager-controller,v0.8.1,2019/06/18,0,0,0,2,0,2
balenalib/hummingboard-node,20230904,2023/09/09,118,38,41,6,0,203
portainer/dev-toolkit,2023.10,2023/10/19,180,163,18,3,0,364
balenalib/parallella,20230904,2023/09/09,118,36,40,6,0,200
balenalib/parallella-debian-node,20230904,2023/09/09,118,38,41,6,0,203
balenalib/aarch64-fedora-python,20231106,2023/11/06,null
mattermost/mattermost-prod-web,v5.33.3,2021/03/31,8,31,55,9,0,103
okteto/codefresh-installer,1.0.2,2020/07/30,102,75,82,22,6,287
balenalib/zynq-xz702-debian-openjdk,20210602,2021/06/05,230,232,145,39,8,654
balenalib/qemux86-64-alpine-openjdk,8-20231106,2023/11/07,0,0,4,0,0,4
appdynamics/ad-air-load,java,2021/01/15,53,104,130,34,17,338
balenalib/beaglebone-green-ubuntu,20231026,2023/11/02,37,9,0,0,0,46
bitnami/sealed-secrets,0.24.3,2023/11/09,null
bitnami/postgresql-repmgr,16.1.0,2023/11/20,96,19,11,2,0,128
balenalib/via-vab820-quad-fedora,20220604,2022/06/12,null
intel/esp-smb,v3.1.2,2023/07/25,null
pachyderm/breast_cancer_classifier,1.11.6,2022/05/04,232,548,80,8,0,868
onlyoffice/4testing-documentserver-de,7.5.1.35,2023/11/15,123,89,1,1,0,214
balenalib/asus-tinker-board-s-alpine-node,18.14.1-20231106,2023/11/07,0,1,5,0,0,6
balenalib/via-vab820-quad-ubuntu-golang,20220523,2022/06/03,222,536,46,0,0,804
kong/kong-mesh-ecs-controller,0.1.0,2022/02/16,0,16,22,1,0,39
docker/dockerfile-copy-arches,v0.1.3.x86_64,2018/08/20,0,1,0,3,0,4
balenalib/apalis-imx6q-alpine,20220714,2022/07/19,7,37,35,10,0,89
balenalib/beaglebone-green-wifi-ubuntu,20231026,2023/11/02,37,9,0,0,0,46
astronomerinc/ap-dind-golang,24.0.6,2023/09/21,2,12,24,2,0,40
accurics/cli-kubescan-amd64,1.0.41,2022/09/01,0,28,30,1,0,59
airbyte/source-omnisend,0.1.0,2022/10/30,0,17,27,1,0,45
rancher/opni-opensearch-update-service,v0.12.1-rc1,2023/11/10,0,1,3,0,0,4
balenalib/beaglebone-black-ubuntu-node,20230530,2023/07/02,55,21,5,0,0,81
datadog/system-tests,uwsgi-poc.base-v1,2023/10/18,252,65,32,2,2,353
bitnami/wavefront-proxy,12.4.0,2023/06/14,75,24,18,2,0,119
lacework/datacollector-windows,1.7.2.3973,2023/11/14,null
balenalib/qemux86-64-debian-golang,20231103,2023/11/05,436,83,52,5,0,576
airbyte/source-shortio,0.2.0,2023/08/03,0,15,26,1,0,42
onlyoffice/gdrive-callback,1.0.0-rc15,2023/09/18,0,4,8,0,0,12
okteto/worker,1,2020/02/19,107,81,29,4,0,221
ubuntu/nginx,1.24-23.10_edge,2023/11/16,11,2,0,0,0,13
rancher/dns-windows,v0.17.0,2017/12/11,null
balenalib/raspberry-pi2-alpine-node,18.14.1-20231106,2023/11/07,0,1,5,0,0,6
airbyte/source-lemlist,0.2.0,2023/09/01,0,15,26,1,0,42
airbyte/secrets-migration,dev-28,2021/10/19,103,102,101,27,6,339
astronomerinc/ap-blackbox-exporter,0.24.0-3,2023/11/06,0,3,5,0,0,8
bitnami/harbor-core,2.9.1,2023/11/08,74,12,8,2,0,96
onlyoffice/docspace-migration,test,2022/09/08,1037,333,357,22,1,1750
amazon/aws-sam-cli-emulation-image-python3.7,20220125,2022/01/25,1,166,75,1,0,243
balenalib/hummingboard-alpine-python,20230904,2023/09/09,2,1,7,2,0,12
okteto/go-todo-list,dev,2021/03/11,720,503,476,75,16,1790
rancher/portainer-agent,v0.1.0,2017/03/03,0,1,5,2,0,8
pachyderm/gh-sum,v8,2018/05/02,511,1478,1010,241,53,3293
lacework/win-golang,1.21.0,2023/08/31,null
bitnami/aws-cli,2.13.30,2023/11/16,80,12,10,2,0,104
airbyte/source-outreach,0.5.0,2023/09/21,0,15,26,1,0,42
bitnami/mysql,8.2.0,2023/10/29,308,24,8,2,0,342
newrelic/k8s-nri-haproxy,2.1.0,2019/11/25,null
greenbone/pg-gvm-build,22.4,2022/07/25,522,296,252,30,1,1101
rancher/opni-python-base,3.9,2023/11/21,0,1,1,0,0,2
rancher/submariner,v0.0.1,2019/03/12,65,125,12,0,0,202
mirantis/ucp-kube-dns-dnsmasq-nanny,3.2.15,2021/06/29,0,0,0,2,0,2
vmware/sources-for-knative-adapter,v0.29.0,1970/01/01,0,4,7,0,0,11
rancher/storage-example,v0.6.1,2017/01/13,97,113,18,0,0,228
balenalib/spacely-tx2-fedora-python,20231106,2023/11/06,null
objectscale/crunchy-pgbackrest,ubi8-2.38-2,2022/07/05,262,179,47,0,0,488
graphcore/tensorflow,2,2023/03/14,167,363,59,1,0,590
kasmweb/ubuntu-focal-desktop,1.14.0,2023/09/14,270,587,0,0,0,857
airbyte/source-orb,1.1.0,2023/04/04,0,16,27,1,0,44
google/apigee-cert-manager-controller,v0.12.0,2019/11/28,0,0,0,0,6,6
solaceiotteam/solace-amplify-discovery-agent,0.2.4,2022/11/03,0,14,16,0,0,30
airbyte/source-google-directory,0.2.1,2023/06/22,0,15,27,1,0,43
airbyte/ci-runner,dev,2023/09/21,55,29,16,0,0,100
intel/intel-dlb-initcontainer,0.28.0,2023/09/22,null
circleci/welcome-config-image,0.2.1,2021/03/30,560,1526,1271,286,14,3657
balenalib/generic-armv7ahf-alpine-node,18.14.1-20230904,2023/09/09,2,1,8,2,0,13
intel/evi-ai-inference-cpu,master-ae213cd97d6931b1d44fc7689867cf5701e0f15d,2023/09/24,55,10,3,1,0,69
mattermost/chewbacca-bot,v0.1.7,2021/06/01,0,8,29,4,0,41
intel/classical-ml,2023.2-py3.10,2023/09/20,100,91,9,1,0,201
amazon/aws-otel-collector,v0.35.0,2023/11/02,0,0,1,0,0,1
rancher/prom-prometheus,v2.22.0,2020/10/15,6,34,34,0,0,74
couchbase/sdk-doctor,v1.0.5,2018/11/15,0,0,0,2,0,2
airbyte/source-gocardless,0.1.0,2022/10/19,0,17,27,1,0,45
balenalib/amd64-debian-node,20231106,2023/11/06,107,22,24,4,0,157
pachyderm/python-sdk-ci-testing,97276071e371d5b1ea221437e99cfd87b5599ddf,2023/11/03,64,7,4,1,0,76
airbyte/airbyte-api-server,0.50.34,2023/11/09,5,70,55,0,0,130
balenalib/kitra520-golang,20220714,2022/07/22,467,265,220,28,1,981
bitnami/spring-cloud-dataflow-shell,2.11.1,2023/11/15,88,16,10,4,0,118
amazon/opendistro-for-elasticsearch-kibana,1.13.2,2021/04/05,554,528,99,13,0,1194
percona/haproxy,2.8.1,2023/11/03,134,24,3,0,0,161
mattermost/circleci-weblate-client,521a212,2020/07/30,1531,1550,1240,185,39,4545
rancher/rio-dashboard,preview,2019/11/18,203,360,38,3,0,604
rancher/mirrored-prometheus-operator-prometheus-config-reloader,v0.65.1,2023/05/05,null
cimg/deploy,2023.09.1,2023/09/25,294,340,51,0,0,685
bitnami/open-service-broker-azure-archived,1.8.4,2022/01/16,130,77,79,23,6,315
balenalib/armv7hf-fedora-node,36-build-20230911,2023/09/11,0,1,1,0,0,2
balenalib/asus-tinker-board-s-fedora-golang,20221210,2022/12/13,null
balenalib/artik533s-debian,20220714,2022/07/22,124,68,74,18,0,284
kasmweb/steam,1.14.0,2023/09/14,187,380,0,0,0,567
grafana/loki-canary,2.9.2,2023/10/25,0,1,5,0,0,6
objectscale/postgresql-repmgr,11.11.0-debian-10-r43,2021/03/30,158,110,122,35,6,431
netdata/netdata,v1.43.2,2023/10/30,2,3,5,0,0,10
onlyoffice/trello-client,1.0.7,2023/11/15,0,2,3,0,0,5
balenalib/fincm3-alpine,20230904,2023/09/09,2,0,7,2,0,11
rancher/kiali-kiali,v1.29.0,2021/01/22,242,335,30,3,0,610
kong/statsd-exporter,0.3.1,2020/04/20,null
intel/esp-aws-cli,v3.1.2,2023/07/25,0,1,0,1,0,2
intel/power-node-agent_ocp-4.13,v2.3.1,2023/09/08,30,29,8,0,0,67
balenalib/orangepi-plus2-debian-node,20230911,2023/09/11,118,38,41,6,0,203
balenalib/colibri-imx6dl-alpine,20220714,2022/07/19,7,37,35,10,0,89
balenalib/jetson-tx1-ubuntu-python,20230530,2023/06/26,54,21,4,0,0,79
datadog/chaos-injector,8.3.0,2023/10/26,39,26,27,5,0,97
cockroachdb/acceptance-gss-python,20221214-141947,2022/12/14,800,733,542,37,2,2114
balenalib/colibri-imx6dl-ubuntu,20220714,2022/08/02,87,82,11,0,0,180
continuumio/ap-git-storage,1.3.0,2018/05/31,0,28,16,31,0,75
rapidfort/mysql-official,8.0.35-debian,2023/11/21,22,6,3,0,0,31
rancher/mirrored-cilium-operator-azure,v1.14.4,2023/11/13,0,1,0,0,0,1
cimg/go,1.21.4,2023/11/07,294,325,45,0,0,664
puppet/gogrpc,go-1.17,2021/11/01,497,409,330,61,2,1299
docker/ucp-kube-compose-api,3.3.1,2019/11/07,4,14,9,1,0,28
balenalib/fincm3-fedora-python,20221109,2022/12/02,0,1,0,0,0,1
purestorage/log-upload,1.1.2,2023/10/31,0,7,8,0,0,15
airbyte/mirrored-keycloak-arm,21.1,2023/06/28,17,34,7,0,0,58
kasmweb/ubuntu-jammy-desktop,1.14.0,2023/09/14,323,524,35,0,0,882
redislabs/redis-connect,0.10.5.1,2023/10/04,1,11,6,1,0,19
bitnami/whereabouts,0.6.2,2023/11/09,74,16,10,2,0,102
balena/amd64-supervisor-base,v1.4.7,2019/05/28,null
rancher/channelserver,v0.6.0,2023/07/28,0,7,5,0,1,13
airbyte/source-kafka,0.2.3,2022/12/06,60,182,143,2,0,387
puppet/cd4pe-beta,3.13.7-rc,2021/04/16,52,74,83,16,7,232
okteto/java-gradle-getting-started,1.0.0,2023/02/27,111,78,115,36,0,340
docker/ucp-init-aws,2.1.0,2017/02/09,2,51,32,31,0,116
grafana/loki-operator,2.8.6,2023/10/17,0,5,2,0,0,7
newrelic/nri-kube-events,2.4.0,2023/11/13,0,0,2,0,0,2
google/apigee-canary-deployment-controller,1.0.0-rc4,2019/08/15,143,105,37,4,0,289
airbyte/destination-databend,0.1.2,2023/03/27,0,16,27,1,0,44
balenalib/spacely-tx2-ubuntu-node,20231103,2023/11/06,38,10,1,0,0,49
balenalib/nitrogen6x-fedora,20220604,2022/06/12,null
airbyte/cloud-cron,dev-97763408ca,2023/11/02,5,72,57,0,0,134
balenalib/armv5e-debian,20200221,2020/02/29,173,128,168,30,6,505
newrelic/k8s-nri-elasticsearch,4.2.0,2019/11/25,null
rancher/harvester-ui,v1.2.1,2023/10/25,0,102,56,17,0,175
vertica/vertica-ce,23.4.0-0,2023/09/21,618,512,6,0,0,1136
intel/intel-vpu-plugin,0.27.1,2023/06/20,55,10,3,1,0,69
airbyte/source-pexels-api,0.1.0,2022/11/18,0,17,27,1,0,45
grafana/cortex-alertmanager,w37-0193e7b7,2018/09/11,0,0,0,2,0,2
grafana/grafana-arm64v8-linux,7.0.6,2020/07/09,4,30,54,9,0,97
newrelic/fluentd,3.0.0,2020/03/26,55,215,179,13,8,470
google/apigee-authn-authz,1.8.0-preview.2,2021/08/29,0,0,0,0,4,4
balenalib/artik5-node,20220714,2022/07/20,124,70,75,18,0,287
tenable/was-scanner,2.6.1-1170,2023/11/14,1,5,1,0,0,7
airbyte/source-always-works-shim,dev,2021/05/18,104,60,79,30,7,280
rancher/lb-service-rancher,v0.9.14,2020/05/01,135,141,14,0,0,290
docker/compose,1.29.2,2021/05/10,0,2,25,4,0,31
bellsoft/buildpacks.gradle,6.11.0,1980/01/01,null
amazon/aws-lambda-go,1.2023.11.12.10,2023/11/12,null
rancher/pipeline-ui,v1.0.1,2018/01/11,71,75,130,41,12,329
vmware/photon-2.0-k8s-dns-sidecar-amd64,1.14.10-20180619,2018/06/19,15,72,90,57,0,234
airbyte/source-gong,0.1.0,2022/11/10,0,17,27,1,0,45
newrelic/infrastructure-k8s,2.13.11,2023/09/16,8,33,23,2,0,66
bitnami/kube-rbac-proxy,0.15.0,2023/11/08,0,1,3,0,0,4
solace/solace-pubsub-connector-tibcoems,1.0.0,2023/08/25,73,56,7,1,0,137
rancher/server-base,v1.0.0,2017/12/17,66,55,7,0,0,128
bellsoft/liberica-openjdk-centos,21.0.1-12,2023/11/14,551,497,32,3,0,1083
okteto/private,1,2022/09/09,672,304,280,42,8,1306
objectscale/nvmetargetviewer,3.9.0.0-139102.b4b5064355c,2023/05/03,3,36,26,1,0,66
balenalib/up-board-ubuntu-node,20230911,2023/09/12,43,11,5,0,0,59
balenalib/artik530-ubuntu,20220714,2022/08/02,87,82,11,0,0,180
balenalib/ts4900-ubuntu-golang,20220523,2022/06/03,222,536,46,0,0,804
grafana/mimir-continuous-test,2.10.4,2023/11/13,0,0,4,0,0,4
pachyderm/tweet-scraper,v3,2020/06/22,708,562,526,65,9,1870
rancher/hardened-kube-proxy,v1.20.2,2021/01/22,444,390,21,3,0,858
docker/assemble-backend,v0.5.0,2019/05/01,6,14,25,5,0,50
balenalib/jetson-tx2-alpine-openjdk,8-20231106,2023/11/06,8,8,4,0,0,20
rancher/mirrored-banzaicloud-logging-operator,3.17.10,2022/11/25,0,3,7,0,0,10
balenalib/asus-tinker-board-s-ubuntu-node,20231026,2023/11/02,38,10,1,0,0,49
hashicorp/vault-website,0.1.23,2019/10/16,12,186,106,14,0,318
rancher/windows-scheduler,v0.0.2,2017/02/17,306,388,24,0,0,718
objectscale/nds,0.71.3,2021/04/15,16,142,197,36,3,394
rancher/hardened-containerd,v1.7.7-k3s1-build20231010-s390x-linux,2023/10/11,2,13,19,0,2,36
rancher/rancher-agent,v2.8.0-rc3,2023/10/26,0,8,16,0,1,25
mirantis/ucp-nvidia-gpu-feature-discovery,3.7.1,2023/09/26,32,31,9,0,0,72
formio/pdf-server,5.3.5-rc.1,2023/11/14,206,172,1,0,0,379
balenalib/bananapi-m1-plus-debian,20230911,2023/09/11,118,36,40,6,0,200
docker/telemetry,1.0.0.linux-x86_64-test,0001/01/01,0,1,3,0,0,4
rancher/mirrored-flannelcni-flannel,v0.20.2,2022/11/30,3,22,24,2,0,51
airbyte/source-delighted,0.2.3,2023/09/08,64,23,8,1,0,96
cockroachdb/docs-builder,20210405-130258,2021/03/24,4,16,37,2,0,59
mattermost/mattermost-oncall-handler,v0.1.2,2023/05/11,3,16,5,0,0,24
rancher/goharbor-redis-photon,v1.7.5,2019/04/01,16,77,103,38,0,234
nginx/unit-preview,wasm-wasi-http,2023/11/02,83,13,19,4,0,119
okteto/compose,18.09.1,2019/01/17,4,15,16,10,0,45
balenalib/i386-debian-openjdk,20231106,2023/11/06,118,43,25,4,0,190
solace/pubsubplus-eventbroker-operator,1.0.2,2023/11/14,16,10,0,0,0,26
airbyte/source-psl-test,0.1.5-dev.db682fcfb4,2023/07/19,151,86,62,10,0,309
airbyte/source-freshservice,1.2.0,2023/08/16,0,15,26,1,0,42
bitnami/opensearch,2.11.0,2023/11/16,84,19,20,4,0,127
kasmweb/vmware-horizon,1.11.0,2022/07/06,416,1264,3,0,0,1683
onlyoffice/4testing-docs-docservice-de,7.5.1-1-saas,2023/11/08,0,2,1,1,0,4
grafana/grafana-dev-arm32v7-linux,master-91219227-4f9f-465a-8ea0-70670344aaaa-ubuntu,2020/05/15,129,278,40,4,0,451
docker/labs-debug-tools-extension,0.0.44,2023/11/14,13,38,20,4,0,75
cimg/openjdk,21.0.0,2023/10/17,299,326,49,0,0,674
balenalib/rpi-alpine,20231026,2023/11/01,0,0,4,0,0,4
bitnami/jasperreports,8.2.0,2023/11/15,116,53,69,17,0,255
objectscale/dellmon-pre-upgrade-crds,3.9.0.0-1588.729cf194,2023/04/25,2,10,4,0,0,16
rancher/docs,staging,2023/01/09,4,59,40,4,0,107
bitnami/discourse,9.0.4,0001/01/01,null
intel/multimodal-data-visualization,3.0,2022/07/27,0,54,86,1,0,141
balenalib/artik530-alpine,20220803,2022/08/03,7,37,35,10,0,89
airbyte/source-aws-cloudtrail,0.1.5,2023/02/28,77,33,28,2,0,140
tenable/terrascan,1.18.3,2023/08/03,1,14,7,1,0,23
docker/compose-bin,v2.23.0,2023/10/18,0,2,4,0,0,6
rancher/mirrored-k8scsi-csi-resizer,v1.1.0,2020/12/18,0,5,12,0,5,22
opensearchproject/logstash-oss-with-opensearch-output-plugin,8.9.0,2023/08/10,34,33,13,2,0,82
objectscale/bookkeeper,0.71.3,2021/03/30,634,805,85,11,0,1535
mirantis/ucp-calico-cni,3.7.1,2023/09/26,0,16,7,0,0,23
docker/dtr-registry-s390x,2.5.0-beta3,2018/01/17,0,16,41,34,0,91
balenalib/i386-alpine,20231106,2023/11/07,0,0,4,0,0,4
airbyte/source-babelforce,0.2.0,2023/08/24,0,15,26,1,0,42
okteto/chat,dev,2020/07/22,1386,1132,1068,120,21,3727
rancher/opni-ui,v0.3.1,2022/01/25,188,374,438,116,3,1119
balenalib/hummingboard-alpine,20230904,2023/09/09,2,0,7,2,0,11
airbyte/temporal,0.50.34,2023/11/09,5,39,33,2,0,79
objectscale/nvmeengine,3.9.0.0-139102.b4b5064355c,2023/05/03,3,36,26,1,0,66
balenalib/nitrogen6x-alpine-python,20220714,2022/07/19,7,38,37,10,0,92
docker/pilot,1.1.2,2019/04/12,446,623,51,0,0,1120
percona/percona-server-mongodb-operator,1.15.0,2023/10/06,29,18,5,0,0,52
percona/percona-xtradb-cluster-operator,1.13.0,2023/07/06,32,32,7,0,0,71
intel/ai-inference-cpu,evi-2.0.0,2022/10/31,34,18,0,0,0,52
rancher/storage-longhorn,v0.9.7,2018/07/09,88,163,12,0,0,263
kong/pulp-core,1.1.38,2022/08/24,4,11,9,4,0,28
balenalib/raspberrypi3-fedora-node,36-build-20230911,2023/09/12,0,1,1,0,0,2
newrelic/kube-webhook-certgen,v1.5.2-1-g18cfc89,2021/08/10,0,3,6,0,4,13
atlassian/bamboo,9.4.1,2023/11/07,102,144,10,6,0,262
airbyte/source-jira,0.10.2,2023/10/26,64,21,8,1,0,94
balenalib/artik5-debian-node,20220714,2022/07/20,124,70,75,18,0,287
okteto/buildkit,v0.7.2-6,2020/11/30,12,33,68,5,0,118
onlyoffice/4testing-docspace-ssoauth,2.0.0.33,2023/11/15,345,77,63,2,2,489
balenalib/jetson-tx1-debian-node,20230712,2023/07/18,118,41,42,6,0,207
amazon/dynamodb-local,2.1.0,2023/10/24,0,9,9,0,0,18
circleci/runner,9292817-dev,2022/12/26,74,136,2,0,0,212
rancher/etcd-tools,319,2023/11/15,6,53,39,8,0,106
rancher/opni,0.12.1-rc1,0001/01/01,null
mirantis/gerrit,2.14.11,2018/09/03,131,254,91,49,0,525
balenalib/via-vab820-quad-fedora-python,20220622,2022/07/12,0,1,1,0,0,2
jetbrains/upsource-psi-broker,2020.1.1992,2022/03/11,79,148,245,95,0,567
rapidfort/yourls,1.9.2-apache,2023/11/22,51,7,5,1,0,64
intel/evi-storage-rest,master-ae213cd97d6931b1d44fc7689867cf5701e0f15d,2023/09/23,140,47,18,1,0,206
airbyte/connector-acceptance-test,2.0.1,2023/09/08,541,284,93,10,2,930
atlassian/opsgenie-edge-encryption,2.3,2021/12/20,158,156,163,60,1,538
okteto/rails-blog,0.1.3,2019/01/29,583,1578,1303,272,14,3750
balenalib/apalis-imx6q-debian-python,20220604,2022/06/12,124,81,76,20,0,301
balenalib/aarch64-ubuntu-python,20231103,2023/11/06,34,10,0,0,0,44
sysdig/sdc-cli,0.2.8,2020/05/07,4,19,44,6,0,73
balenalib/zynq-xz702-fedora-python,20220622,2022/07/12,0,1,1,0,0,2
rancher/k8s,v1.12.10-rancher1-1,2019/09/03,414,613,35,0,0,1062
intel/intelligent_traffic_management_cloud_connector,2.0,2022/11/10,61,92,13,0,0,166
kasmweb/audacity,1.14.0,2023/09/14,199,394,0,0,0,593
redislabs/pcf-tile-manager-tests,100.0.9000481,2020/05/13,562,1545,1377,247,14,3745
mattermost/cloud-db-factory-horizontal-scaling,323a159,2020/06/16,3,15,27,4,0,49
intel/intel-sgx-plugin,0.28.0,2023/09/22,null
docker/ucp,3.3.1,2020/06/26,2,8,9,1,0,20
rancher/banzaicloud-logging-operator,3.9.0,2021/01/20,0,5,11,0,4,20
puppet/facter,5.5.1,2018/05/09,113,148,12,0,0,273
circleci/filebeat,console,2016/12/05,41,93,101,22,20,277
redhat/ubi8,8.8-1067,2023/09/13,152,38,6,0,0,196
couchbase/centos-72-jenkins-core,20170613,2017/07/06,713,875,130,12,0,1730
balenalib/armv7hf-debian-node,20230929,2023/10/02,111,38,36,6,0,191
docker/ucp-istio-mixer,3.3.1,2020/06/26,1,12,18,0,6,37
airbyte/source-jdbc,0.3.4,2022/06/17,76,76,65,19,0,236
objectscale/storagemanagement-service,0.71.3,2021/04/15,17,149,215,36,6,423
datadog/dd-lib-python-init,v2.1.7,2023/11/15,0,0,4,0,0,4
balenalib/parallella-alpine-node,18.14.1-20230904,2023/09/09,2,1,8,2,0,13
rancher/mirrored-sig-storage-csi-snapshotter,v6.2.1,2023/01/04,0,3,3,0,0,6
balenalib/armv7hf-fedora-golang,20221109,2022/12/03,null
grafana/shipwright,93616b8,2022/06/11,0,39,64,11,0,114
airbyte/source-github-test,0.3.9,2022/12/08,77,37,34,3,0,151
mirantis/ucp-csi-attacher,3.5.3,2022/04/05,0,8,14,0,6,28
grafana/plugin-builds,83986700d258dae901ead75668ed5d910256aee5pre,2023/10/04,2,5,10,2,0,19
okteto/ruby-getting-started,1.0.0,2023/02/27,775,594,345,23,2,1739
onlyoffice/4testing-ds-converter-de,6.2.0-eu-r2,2021/03/04,544,491,32,3,0,1070
balenalib/armv7hf-ubuntu-python,20231026,2023/11/02,34,10,0,0,0,44
grafana/test.k6.io,v0.0.5,2023/08/18,null
greenbone/gvm-tools,v23.11.0,2023/11/14,70,14,11,1,0,96
grafana/vectorapi,61165515c6,2023/10/30,77,13,13,3,0,106
mirantis/dtr-registry,3.0.0-alpha.2,2021/09/22,3,25,39,5,0,72
rancher/k8s-metrics-server,v0.3.6,2020/08/11,258,400,18,3,0,679
balenalib/zynq-xz702-golang,20220714,2022/07/28,467,262,214,28,1,972
mirantis/cluster,v1.9.0,2020/11/05,13,49,74,17,0,153
rancher/fleet,v0.9.0,2023/11/07,2,7,14,0,3,26
rancher/mirrored-k8s-dns-sidecar,1.22.20,2023/02/22,0,2,1,0,0,3
tenable/nessus,10.6.2-ubuntu-20231113,2023/11/13,25,27,0,0,0,52
rancher/mirrored-squareup-ghostunnel,v1.5.2,2019/11/20,5,17,34,2,0,58
docker/ucp-kube-dns-dnsmasq-nanny,3.2.7,2020/06/26,0,0,0,2,0,2
kong/go-echo,0.4.0,2023/10/25,null
kasmweb/core-ubuntu-bionic,1.14.0,2023/09/09,null
rancher/os,437034c,2017/06/20,0,19,15,6,0,40
balenalib/odroid-c1-debian-python,20220604,2022/06/12,124,81,76,20,0,301
rancher/mirrored-pause,3.7,2022/03/12,null
balenalib/spacely-tx2-fedora-openjdk,8-20231106,2023/11/06,null
percona/percona-xtradb-cluster,8.0.34,2023/10/24,75,30,0,0,0,105
onlyoffice/4testing-docspace-backup,2.0.0.33,2023/11/15,1016,142,207,12,0,1377
balenalib/beaglebone-black-fedora-golang,20220523,2022/06/05,null
rapidfort/memcached,1.6.21,2023/10/09,21,2,2,0,0,25
mirantis/rudder-federation,v0.1,2017/08/01,0,1,5,2,0,8
kasmweb/edge,1.14.0,2023/09/14,187,380,0,0,0,567
rancher/k3d-tools,5.3,2022/02/03,3,13,17,1,0,34
airbyte/destination-redis,0.1.4,2022/10/31,60,180,144,2,0,386
sysdig/sysdig,0.34.1,2023/11/07,297,193,16,0,0,506
bitnami/sonarqube,10.2.1,2023/11/17,89,46,37,4,0,176
circleci/runner-agent,machine-3.0.14-4844-3a4f06d,2023/11/09,24,10,0,0,0,34
balenalib/ts4900-alpine-openjdk,8-3.14-20220112,2022/01/19,2,50,42,13,0,107
datadog/agent-arm64,7.29.1,2021/07/12,34,118,102,5,0,259
objectscale/grafana,0.54.0,2020/11/06,2,70,81,11,3,167
rancher/mirrored-git-sync,v3.5.0,2022/03/11,122,60,79,23,3,287
atlassian/confluenec-servert,7.0.3,2021/03/29,150,389,418,128,0,1085
apachepinot/pinot-base-build,17-ms-openjdk,2023/06/14,201,258,25,0,0,484
balenalib/apalis-imx6q-alpine-python,20220714,2022/07/19,7,38,37,10,0,92
rancher/os-centosconsole,v1.5.8,2021/02/05,849,677,48,3,0,1577
okteto/go-getting-started,1.0.0,2023/02/27,653,231,209,14,3,1110
balenalib/artik530-golang,20220714,2022/07/22,467,265,220,28,1,981
airbyte/source-notion,2.0.8,2023/11/01,64,21,8,1,0,94
balenalib/artik710-debian,20230904,2023/09/09,118,36,40,6,0,200
rancher/mirrored-neuvector-enforcer,5.2.3,2023/11/10,0,0,2,0,0,2
bitnami/phppgadmin-archived,7.13.0,2022/01/13,297,278,173,31,14,793
rancher/flannel,v0.11.0,2020/08/11,475,527,26,3,0,1031
airbyte/source-partnerstack,0.1.0,2022/11/09,0,17,27,1,0,45
kasmweb/core-rockylinux-8,1.14.0,2023/09/09,0,14,806,0,0,820
puppet/puppet-agent-ubuntu,7.20.0,2022/10/11,31,30,2,0,0,63
balenalib/orangepi-plus2-ubuntu-python,20231026,2023/11/02,37,10,0,0,0,47
bitnami/kubeapps-asset-syncer,2.9.0,2023/11/08,0,5,2,0,0,7
vmware/vke-canary,1.2,2019/01/11,15,124,156,82,0,377
grafana/grafana-plugin-ci,1.9.5,2023/10/17,207,45,70,2,0,324
airbyte/source-timely,0.3.0,2023/10/25,0,13,26,1,0,40
balenalib/ts4900-openjdk,20210602,2021/06/05,230,232,145,39,8,654
rapidfort/nginx-ib,1.25.2,2023/09/21,null
purestorage/dbdeployer,v1.2.2,2022/01/28,0,8,14,1,0,23
grafana/logstash-output-loki,2.9.2-amd64,2023/10/25,546,503,82,5,0,1136
accurics/terrascan,9814799,2020/08/16,2,14,43,4,0,63
rancher/vm,v0.2.0,2018/12/20,120,109,18,0,0,247
hashicorp/consul-smi-controller,v0.0.0-alpha.2,2019/07/17,4,14,9,3,0,30
google/apigee-istio-sidecar-injector,1.4.6,2020/02/22,650,1305,152,0,0,2107
snyk/snyk-cli,1.1228.0-gradle-5.4,2023/09/28,153,92,155,32,0,432
grafana/cloudsql-proxy,v1.18.1-prometheus2,2020/10/20,13,35,29,10,4,91
dynatrace/dynatrace-synthetic,1.275.47.20231003-143936,2023/10/03,23,17,5,0,0,45
rancher/mirrored-k8scsi-csi-attacher,v3.1.0,2020/12/16,0,5,13,0,5,23
percona/dbaas-operator,0.1.17,2023/07/04,0,2,1,0,0,3
balenalib/nitrogen6x-python,20220604,2022/06/12,124,81,76,20,0,301
google/apigee-istio-node-agent-k8s,1.4.6,2020/02/22,651,1312,158,0,0,2121
mattermost/mm-ee-cloud,21227_6978bb53_d6e98f0f,2023/11/02,52,30,6,0,0,88
balenalib/odroid-c1-ubuntu-golang,20220523,2022/06/03,222,536,46,0,0,804
atlassian/pipelines-docker-daemon-tini-init,stg-stable,2018/08/01,0,8,3,3,0,14
airbyte/destination-milvus-preview,dev,2023/08/31,64,24,11,4,0,103
balenalib/amd64-debian-golang,20231106,2023/11/06,435,83,52,5,0,575
portainer/extract-matomo,test-dockerfile,2023/02/13,0,14,4,0,0,18
vmware/notary-signer-photon,v0.5.1-v1.5.2,2018/07/18,8,54,72,36,0,170
balena/balena-push-env,9980750,2022/08/11,86,257,14,0,0,357
amazon/aws-sam-cli-emulation-image-python3.6,20220125,2022/01/25,1,165,76,1,0,243
balenalib/ts4900-ubuntu-python,20220622,2022/06/23,87,113,13,0,0,213
circleci/nomad-gc,0.0.87-74a5faf,2020/01/08,2,8,9,1,0,20
balenalib/fincm3-ubuntu-golang,20230712,2023/07/14,173,176,39,0,0,388
balenalib/armv7hf-alpine-golang,20231106,2023/11/07,0,0,4,0,0,4
astronomerinc/ap-curator,8.0.8-4,2023/11/06,0,0,3,0,0,3
newrelic/k8s-nri-apache,1.5.0,2019/12/10,null
airbyte/destination-snowflake,3.4.10,2023/11/08,5,45,59,17,0,126
okteto/movies,frontend,2019/09/09,560,1567,1267,266,14,3674
lacework/iac-scanner-jenkins,20220921,2022/09/21,228,647,65,1,0,941
google/apigee-istio-mixer,1.4.6,2020/02/22,1,12,18,0,6,37
kasmweb/core-almalinux-8,1.14.0,2023/09/09,0,17,820,0,0,837
objectscale/zookeeper,0.30.0,2019/10/09,153,222,289,59,8,731
airbyte/np-dest,dev,2021/05/21,97,37,49,16,6,205
vmware/cascade-cli-toolchain,0.0.3,2018/10/23,198,433,451,96,14,1192
balenalib/artik530-ubuntu-golang,20220803,2022/08/03,245,463,67,0,0,775
intel/esp-dnsmasq,v3.1.2,2023/07/25,0,0,1,0,0,1
airbyte/connector-atelier-server,0.50.8,2023/07/17,10,83,104,0,0,197
intel/dlstreamer-pipeline-server,0.7.1,2022/02/22,445,1322,60,0,0,1827
launchdarkly/ld-find-code-refs-bitbucket-pipeline,2.11.4,2023/10/16,0,0,4,0,0,4
circleci/elixir,1.13.1,2022/01/01,853,1049,770,100,5,2777
redislabs/service-broker-internal,72_b401787,2019/01/08,0,0,4,2,0,6
cimg/unity,9.9.9,2022/02/11,235,663,360,39,0,1297
amazon/aws-sam-cli-emulation-image-nodejs12.x,20220125,2022/01/25,1,54,21,3,0,79
intel/query-rest,evi-2.0.0,2022/10/31,48,53,40,17,0,158
balena/cert-manager,0.1.17,2023/06/27,4,16,36,9,0,65
google/apigee-istio-proxy-init,1.2.0,2019/06/18,40,33,0,0,0,73
bellsoft/alpaquita-linux-gcc,13.2-stream-musl,2023/11/17,null
grafana/e2ealerting,master-63bd62ca,2020/11/09,2,18,42,4,0,66
grafana/bigtable-backup,master-418c0dd,2019/08/02,4,14,6,2,0,26
airbyte/cloud-worker,test,2022/10/13,66,191,150,1,0,408
cimg/testing,2023.10,2023/09/05,207,231,32,0,0,470
rapidfort/mongodb-ib,6.0.5,2023/10/25,98,39,8,0,0,145
balena/open-balena-s3,2.28.15,2023/11/02,357,94,63,5,0,519
balena/arm64-balena-multibuild-scripts,0.1.0,2019/10/01,6,22,33,3,0,64
bitnami/mastodon,4.2.1,2023/11/16,280,186,112,8,2,588
balenalib/fincm3-python,20230530,2023/06/27,118,37,40,6,0,201
launchdarkly/ld-gh-actions-pr-starts-with-verb,1.0,2019/03/03,51,54,86,21,9,221
passbolt/passbolt,3.12.0-3,2023/04/11,176,124,98,22,0,420
rancher/harvester-cluster-repo,v1.2.1,2023/10/26,0,2,6,0,0,8
rancher/hardened-sriov-cni,v2.6,2021/02/24,241,324,18,3,0,586
rancher/hardened-sriov-network-device-plugin,v3.3.1,2021/02/26,444,389,33,3,0,869
objectscale/objectscale-restapi,1.3.0-144.697e704,2023/09/07,2,7,8,0,0,17
pachyderm/mount-server,2.8.0-rc.2,2023/11/13,94,16,28,2,0,140
portainer/portable-env,1.0.3,2023/07/28,4,28,24,5,0,61
airbyte/source-alloydb-strict-encrypt,3.1.5,2023/08/23,63,176,134,2,0,375
balenalib/orangepi-plus2-node,20230911,2023/09/11,118,38,41,6,0,203
okteto/api,1.5.73,2020/03/27,3,18,43,4,0,68
rancher/lb-service-haproxy,v0.9.14,2020/05/01,263,490,23,0,0,776
airbyte/source-twilio-taskrouter,0.1.0,2022/11/18,0,17,27,1,0,45
hashicorp/demo-webapp,v3,2018/10/04,0,0,0,2,0,2
balenalib/rpi-alpine-python,20231026,2023/11/01,0,1,4,0,0,5
kasmweb/rockylinux-9-desktop,1.14.0,2023/09/14,0,5,4,0,0,9
airbyte/source-waiteraid,0.1.0,2022/10/28,0,17,27,1,0,45
airbyte/destination-postgres,0.4.0,2023/06/29,65,199,176,17,0,457
okteto/math,0.1.0,2019/05/01,6,15,25,6,0,52
portainer/portainer-extension,2.13.0-alpha.1,2022/04/28,4,35,33,1,0,73
circleci/fakes3,0.2.4,2016/09/07,504,3040,1867,503,75,5989
balena/arm-balena-multibuild-scripts,0.1.0,2019/10/01,6,22,33,3,0,64
bitnami/contour-operator,1.24.0,2023/05/15,0,2,3,0,0,5
balena/aarch64-supervisor-node,1244-update-lock-weirdness,2020/03/31,717,609,599,76,9,2010
objectscale/csi-baremetal-basemgr,0.69.0,2021/03/07,68,67,10,0,0,145
balenalib/intel-nuc-debian-golang,20231106,2023/11/06,436,83,52,5,0,576
circleci/php,8.0.12,2021/11/18,545,446,387,71,2,1451
okteto/webhook,1.5.73,2020/03/26,2,20,41,4,0,67
balenalib/beaglebone-green-wifi-fedora-python,20220928,2022/10/04,0,1,1,0,0,2
airbyte/normalization,0.6.1-alpha,2020/12/04,161,116,176,44,9,506
sysdig/sysdig-image-scanning-trigger,0.1.2,2020/05/06,2,10,27,4,0,43
jetbrains/datalore-server,2023.5.1,2023/10/18,58,104,11,0,0,173
kong/kong,20231115,2023/11/15,20,4,0,0,0,24
mirantis/ucp-csi-liveness-probe,3.5.3,2022/04/05,0,0,0,0,6,6
kong/kuma-cp,2.4.4,2023/11/06,0,1,2,0,0,3
bitnami/thanos,0.32.5,2023/11/09,0,1,2,0,0,3
airbyte/destination-mssql-strict-encrypt,0.2.0,2023/07/26,68,191,184,17,0,460
lacework/test-latest-dockerhub-tag,2023-11-15_pre-release_149e6f82c8e39153cfdffbc7f1fadc593436a7f5_RA,2023/11/15,0,0,4,0,0,4
bitnami/opensearch-dashboards,2.11.0,2023/11/17,84,18,15,8,0,125
kasmweb/desktop,1.14.0,2023/09/14,189,397,0,0,0,586
pingidentity/pingdatasync,2310,2023/11/01,3,15,10,0,0,28
portainer/k2d,1.0.0,2023/10/31,0,1,1,0,0,2
balenalib/kitra710-alpine-golang,3.16-20230904,2023/09/09,2,0,5,2,0,9
kasmweb/remnux-focal-desktop,1.14.0,2023/09/14,520,1104,145,12,0,1781
balenalib/artik533s-debian-python,20220714,2022/07/22,124,69,76,18,0,287
balenalib/zynq-xz702-ubuntu-python,20220622,2022/06/23,87,113,13,0,0,213
rancher/mirrored-k8scsi-livenessprobe,v2.2.0,2020/12/18,0,5,8,0,5,18
onlyoffice/4testing-docspace-dotnet-runtime,v1.0.0,2023/09/04,1018,175,229,15,0,1437
appdynamics/cluster-agent,23.9.0-107,2023/09/26,0,2,5,0,0,7
newrelic/nri-statsd-alpha,0.5.0,2020/04/23,3,17,21,1,0,42
airbyte/destination-langchain,0.1.1,2023/09/11,64,25,9,4,0,102
balenalib/raspberrypi3-alpine-node,18.14.1-20231106,2023/11/07,0,1,5,0,0,6
airbyte/source-appsflyer-singer,0.1.3,2021/07/06,611,348,336,49,9,1353
portainer/kubectl-shell,latest-v1.21.1-arm64,2021/11/14,7,51,48,6,0,112
appdynamics/servox,23.10.0,2023/10/06,96,76,76,28,1,277
airbyte/source-trello,1.0.2,2023/10/13,0,14,26,1,0,41
airbyte/source-braze,0.3.0,2023/11/04,0,13,26,1,0,40
rancher/os-modemmanager,v1.6.4-1,2018/12/12,76,50,93,26,12,257
kasmweb/ubuntu-focal-dind-rootless,1.14.0,2023/09/14,220,498,13,0,0,731
rancher/eks-operator,v2.0.1-rc1,2021/04/27,106,223,30,0,0,359
greenbone/vulnerability-tests,202311150559,2023/11/15,null
balenalib/orbitty-tx2-debian-python,20231106,2023/11/07,114,21,29,4,0,168
jetbrains/qodana,2022.2-eap,2022/10/26,75,157,12,2,0,246
airbyte/airbyte-base-java-image,2.0.3,2023/05/25,2,65,52,0,0,119
balenalib/odroid-c1-ubuntu-node,20220715,2022/07/19,88,104,12,0,0,204
datadog/lambda-extension,50,2023/11/02,0,0,1,0,0,1
mattermost/mattermost-elasticsearch-docker,7.17.3,2022/05/02,184,389,26,0,0,599
balenalib/hummingboard-ubuntu,20230904,2023/09/09,42,10,4,0,0,56
balena/i386-supervisor-node,1244-update-lock-weirdness,2020/03/31,717,609,599,76,9,2010
balenalib/artik533s-fedora,20220714,2022/07/23,null
airbyte/source-sap-fieldglass,0.1.0,2022/11/11,0,17,27,1,0,45
airbyte/integration-base-java,20230210,2023/02/10,59,163,120,0,0,342
docker/sso-sample-extension,0.0.2,2023/07/11,0,6,4,3,0,13
onlyoffice/4testing-ds-docservice-de,6.2.0-eu-r2,2021/03/04,544,491,32,3,0,1070
balenalib/intel-nuc-fedora-python,20231103,2023/11/04,null
balenalib/artik10-ubuntu-node,20220715,2022/08/02,88,83,12,0,0,183
rancher/rio-autoscaler,v0.1.6,2019/12/23,2,12,29,4,0,47
puppet/r10k,3.15.2,2022/10/05,1,27,22,4,0,54
balenalib/jetson-tx2-golang,20231106,2023/11/07,436,82,52,5,0,575
vmware/resource-checker-toolchain,0.2.1,2018/12/18,18,190,245,105,0,558
airbyte/normalization-oracle,0.4.3,2023/05/12,660,429,406,59,17,1571
jetbrains/qodana-python-community,2023.2,2023/09/06,142,58,68,11,0,279
docker/node-agent-k8s,1.1.2,2019/04/12,50,41,2,0,0,93
okteto/coder-python,dev,2020/04/25,1158,727,886,112,11,2894
grafana/cortex-blocksconvert,r111-453cbfce3,2020/11/03,2,18,47,4,0,71
balenalib/artik5-golang,20220714,2022/07/22,467,265,220,28,1,981
balenalib/rpi-openjdk,8-20190705,2019/07/06,155,187,175,34,12,563
balenalib/i386-nlp-ubuntu-python,20210225,2021/04/20,121,246,17,0,0,384
airbyte/source-google-adwords-singer,0.2.6,2021/07/07,143,96,112,34,7,392
okteto/openfaas,golang,2020/06/12,723,619,551,80,9,1982
onlyoffice/4testing-docspace-telegram-service,test-2022112110,2022/11/21,1033,308,328,19,0,1688
graphcore/popart-minimal,3.3.0,2023/07/03,137,181,23,0,0,341
grafana/metrics-enterprise,v2.10.4,2023/11/14,0,1,4,0,0,5
airbyte/destination-scylla,0.1.3,2022/08/09,76,75,64,19,0,234
pachyderm/pachd,2.8.0-rc.2,2023/11/13,0,7,4,0,0,11
rancher/change-nodetemplate-owner,319,2023/11/15,30,4,0,0,0,34
balenalib/ts4900-fedora-openjdk,30-20210825,2021/09/03,null
datadog/fips-proxy,0.6.1,2023/10/26,19,8,0,0,0,27
balenalib/asus-tinker-board-s-openjdk,20230911,2023/09/12,129,64,44,6,0,243
balenalib/armv5e-openjdk,20200221,2020/02/29,259,275,214,44,8,800
bitnami/blackbox-exporter,0.24.0,2023/11/08,74,15,10,2,0,101
balenalib/orbitty-tx2-fedora-node,20231106,2023/11/06,0,1,1,0,0,2
kong/kuma-dp,2.4.4,2023/11/06,7,4,5,0,0,16
newrelic/cluster-api-controller,79dda1d3,2019/07/01,0,0,0,0,6,6
kasmweb/qbittorrent,1.14.0,2023/09/14,201,394,0,0,0,595
rancher/hardened-cilium-iproute2,4c18d06f1d545ed6fde810c2b97935dc8938ddc8-build20210521,2021/05/21,544,474,29,3,0,1050
ambassador/ambassador-agent,1.0.21,2023/11/10,0,6,9,0,0,15
kong/kong-gateway-dev,20231113-2,2023/11/13,22,4,0,0,0,26
vmware/ovs-secure-toolchain-photon,1.0.0,2018/06/23,21,215,224,93,0,553
bitnami/nginx,1.25.3,2023/11/09,74,12,8,2,0,96
rancher/mirrored-elemental-operator,1.3.4,2023/09/12,null
rancher/heapster-influxdb-amd64,v1.3.3,2017/09/05,null
airbyte/source-hubspot-singer,0.2.0,2021/03/03,105,70,81,31,7,294
atlassian/pipelines-dvcstools,1.13,2016/11/17,1,59,35,18,0,113
datadog/agent,7.50.0-rc.2,2023/11/14,10,2,2,0,0,14
circleci/container-agent,3.0,2023/03/30,0,13,3,0,0,16
mattermost/rtcd-daily,v0.11.0,2023/06/22,0,2,1,0,0,3
amazon/aws-node-termination-handler,4a12725,2019/11/26,0,8,14,0,0,22
circleci/frontend,0.2.33217-7008444,2023/10/13,46,34,1,0,0,81
rancher/cluster-register,v0.1.0,2017/09/19,null
rancher/jettech-kube-webhook-certgen,v1.5.0,2020/10/29,0,13,16,2,6,37
rancher/opni-agent,0.12.1-rc1,0001/01/01,null
airbyte/np-src,dev,2021/05/21,0,6,27,4,0,37
cimg/gcp,2023.09.1,2023/09/07,302,357,51,0,0,710
docker/runc-arches,v1.0.0-rc5.x86_64,2018/08/07,null
objectscale/geo-receiver,0.71.3,2021/04/15,15,108,130,15,6,274
balenalib/up-board-debian-openjdk,20230712,2023/07/16,null
balenalib/fincm3-fedora-golang,20220523,2022/06/04,null
bitnami/elasticsearch-exporter,1.6.0,2023/11/08,74,14,9,2,0,99
rancher/harvester-load-balancer-webhook,v0.2.2,2023/08/29,1,6,10,0,1,18
balenalib/orangepi-plus2-alpine-python,20231106,2023/11/07,0,1,4,0,0,5
rancher/k8s-dns-kube-dns-amd64,1.15.0,2018/11/12,0,0,0,2,0,2
grafana/k6,0.47.0,2023/10/10,0,2,6,0,0,8
rancher/flannel-cni,v0.3.0-rancher9-linux-arm64,2023/08/29,null
appdynamics/appdynamics-cloud-k8s-monitoring,23.10.0-1780,2023/10/23,1,13,9,0,0,23
ambassador/aes-wafsvc,v4.0.0-preview.2.dev.1,2023/10/27,0,1,1,0,0,2
objectscale/influxdb-operator,0.52.0,2019/07/30,null
snyk/kubernetes-monitor,2.4.17,2023/11/07,0,5,4,0,0,9
astronomerinc/ap-node-exporter,1.6.1,2023/07/17,0,2,1,0,0,3
google/apigee-prometheus-adapter,v0.9.1,2021/10/15,0,4,12,1,0,17
rapidfort/airflow-worker,2.5.1,2023/04/09,42,49,31,9,0,131
amazon/aws-sam-cli-emulation-image-java8,20220125,2022/01/25,1,156,102,18,0,277
balenalib/imx6ul-var-dart-fedora-golang,20221210,2022/12/13,null
hashicorp/nomad,1.7.0-beta.1,2023/11/01,0,3,1,0,0,4
formio/mongotest,1.0.0,2020/07/16,4,27,53,7,0,91
balenalib/hummingboard-debian-openjdk,20230904,2023/09/09,129,64,44,6,0,243
qualys/redis-client-for-jira-integration,1.2.0,2023/09/29,0,0,4,0,0,4
rancher/os-alpineconsole,v1.5.8,2021/02/05,5,8,9,1,0,23
hashicorp/consul-k8s-control-plane,1.3,2023/11/07,0,3,5,0,0,8
atlassian/pipelines-agent-metric-sidecar,stg-stable,2019/11/12,114,135,140,41,8,438
balenalib/via-vab820-quad-debian-golang,20220714,2022/07/28,467,262,214,28,1,972
bellsoft/liberica-openjdk-alpine,21.0.1-12,2023/11/14,0,0,4,0,0,4
amazon/aws-secrets-manager-secret-adm-controller,v0.1.5,2021/02/24,39,322,99,8,0,468
intel/rpbs_mips,1.0,2023/03/23,812,1182,61,0,0,2055
kasmweb/fedora-38-desktop,1.14.0,2023/09/14,0,3,2,0,0,5
snyk/snyk-kubernetes-operator,discardable-59116385da844f3bc116c77c893f24e55d019d20,2020/02/17,131,314,58,2,0,505
mattermost/mattermost-apps-cloud-deployer,8951213,2023/03/20,4,35,23,3,0,65
balenalib/bananapi-m1-plus-alpine-node,18.14.1-20231106,2023/11/07,0,1,5,0,0,6
puppet/pdk,3.0.0.0,2023/07/04,37,38,3,0,0,78
balenalib/beaglebone-green-fedora,20221109,2022/12/04,null
datadog/cluster-agent-dev-arm64,7-27-0-snmp-batch-size-config,2021/04/09,8,26,20,2,0,56
docker/ucp-istio-node-agent-k8s,3.3.1,2020/05/09,472,1164,149,0,0,1785
intel/esp-git,v3.1.2,2023/07/25,null
airbyte/source-airtable,4.1.5,2023/10/19,64,21,8,1,0,94
vmware/event-service-toolchain-photon,1.0.4,2019/02/21,59,267,266,102,0,694
bitnami/parse,6.3.1,2023/11/16,79,27,10,4,0,120
airbyte/destination-oracle-strict-encrypt,0.2.0,2023/06/29,65,199,176,17,0,457
balenalib/nitrogen6x-fedora-python,20220622,2022/07/12,0,1,1,0,0,2
grafana/cortex-table-manager,w37-0193e7b7,2018/09/11,0,0,0,2,0,2
balenalib/armv7hf-openjdk,20230929,2023/10/02,122,64,39,6,0,231
balenalib/imx6ul-var-dart,20230911,2023/09/11,118,36,40,6,0,200
okteto/pipeline-runner,1.0.3,2023/06/26,155,38,27,10,3,233
balenalib/intel-nuc-debian-python,20231106,2023/11/06,114,21,29,4,0,168
kumahq/kuma-injector,0.5.0-rc2,2020/04/27,2,8,7,1,0,18
rancher/kubernetes-dashboard,v0.0.1,2017/05/03,null
balenalib/parallella-fedora-node,36-build-20230530,2023/06/29,0,1,1,0,0,2
okteto/django,okteto,2020/03/24,1461,1771,1415,181,39,4867
continuumio/miniconda2,4.7.12,2019/10/16,217,214,283,60,10,784
pachyderm/kafka_spout,1.11.2,2020/08/28,165,396,405,66,12,1044
balenalib/colibri-imx6dl-debian-golang,20220714,2022/07/28,467,262,214,28,1,972
pachyderm/kubeflow_demo_trigger,v1.0.0,2020/04/10,0,19,0,0,0,19
kumahq/kuma-tcp-echo,0.4.0,2020/02/28,2,8,9,1,0,20
rancher/cert-manager-acmesolver,v0.11.0-rio.1,2019/10/22,0,0,0,0,6,6
redislabs/ng-redis-raft,966152886c0a5744ad6406b064d53aac4f20f04d,2023/01/20,71,26,24,2,0,123
rapidfort/apache-official,2.4.58-alpine3.18,2023/10/19,0,0,4,0,0,4
airbyte/source-apple-search-ads,0.1.1,2023/07/11,0,15,27,1,0,43
datadog/libddwaf,toolchain,2023/08/11,357,142,72,9,2,582
onlyoffice/docs-docservice,7.5.1-1,2023/11/09,0,2,1,1,0,4
rancher/pre-pull-images,v0.2.2,2018/06/01,306,388,24,0,0,718
airbyte/source-twitter,0.1.2,2023/03/07,0,16,27,1,0,44
balenalib/artik10-debian-python,20220714,2022/07/22,124,69,76,18,0,287
balenalib/kitra710-debian-golang,20230904,2023/09/09,442,114,73,9,0,638
intel/trusted-attestation-controller,0.4.0,2022/11/08,11,28,27,0,0,66
balenalib/colibri-imx6dl-ubuntu-python,20220622,2022/06/23,87,113,13,0,0,213
balenalib/orangepi-plus2-ubuntu,20231026,2023/11/02,37,9,0,0,0,46
jetbrains/runtime,ubuntu1804_arm64v8_clang,2021/06/22,1063,1435,142,3,1,2644
grafana/grafana-enterprise-image-tags,10.3.0-63462-arm64,2023/11/15,0,1,4,0,0,5
objectscale/influxdb,0.33.0,2020/07/06,5,53,67,6,2,133
docker/ucp-s390x,3.1.0-beta3,2018/10/04,0,2,6,16,0,24
continuumio/nginx-ingress-ws,1.5.2,2019/07/31,145,164,115,42,8,474
astronomerinc/ap-prisma,1.34.8,2020/04/08,2,19,60,26,0,107
mongodb/mongodb-enterprise-server,7.0.3-ubuntu2204-20231115T085919Z,2023/11/15,142,140,0,0,0,282
balenalib/raspberrypi3-debian-openjdk,20230530,2023/07/04,143,72,46,6,0,267
rancher/kube-proxy,v1.18.8,2020/08/28,463,464,22,3,0,952
google/apigee-cert-manager-cainjector,v0.12.0,2019/11/28,0,0,0,0,6,6
pachyderm/sqs-spout,1.9.8,2019/11/13,552,1488,1164,245,14,3463
rancher/hardened-multus-cni,v3.6,2021/02/23,244,343,38,3,0,628
airbyte/source-harness,0.1.0,2023/10/23,0,13,26,1,0,40
balenalib/artik533s,20220714,2022/07/22,124,68,74,18,0,284
kasmweb/core-opensuse-15,1.14.0,2023/09/09,5,20,33,0,1,59
mirantis/ucp-istio-proxyv2,3.4.15,2023/05/11,471,1159,140,1,0,1771
mattermost/focalboard,7.11.4,2023/09/26,97,48,44,12,6,207
okteto/dev,go1.17,2021/09/23,221,490,33,0,0,744
hashicorp/nomad-pack,0.1,2023/11/01,0,0,2,0,0,2
bitnami/cert-manager-webhook,1.13.2,2023/11/08,74,12,8,2,0,96
grafana/docker-puppeteer,1.1.0,2022/07/28,241,207,155,29,6,638
rancher/dns,v0.17.4,2018/07/09,306,388,24,0,0,718
astronomerinc/ap-postgres-exporter,3.14.2-1,2021/10/06,0,13,37,1,0,51
amazon/aws-sam-cli-emulation-image-python2.7,20220125,2022/01/25,1,163,77,1,0,242
rancher/calico-pod2daemon-flexvol,v3.18.1,2021/03/10,null
rancher/hardened-cilium-compilers,4c18d06f1d545ed6fde810c2b97935dc8938ddc8-build20210521,2021/05/21,923,1003,92,3,0,2021
balenalib/i386-nlp-python,20210225,2021/04/18,195,121,141,43,9,509
airbyte/source-bing-ads,1.13.0,2023/11/14,64,21,8,1,0,94
solaceiotteam/async-apim-admin-portal,0.4.5,2022/10/19,113,120,76,16,0,325
rancher/thanosio-thanos,v0.15.0,2020/09/07,5,24,19,0,0,48
datadog/synthetics-private-location-worker,1.41.0,2023/11/02,39,31,1,0,0,71
pachyderm/lb-interview,1.0,2022/05/27,0,12,16,1,0,29
rancher/vm-tools,v0.2.0,2018/12/21,472,657,44,0,0,1173
rancher/crictl,v1.19.0,2020/08/31,261,417,36,3,0,717
okteto/frontend,80907703,2023/02/03,4,57,36,4,0,101
bitnami/airflow-exporter,0.20220314.0,2023/11/08,74,13,8,2,0,97
bitnami/osclass,8.1.2,2023/10/11,152,91,55,5,2,305
balenalib/bananapi-m1-plus-fedora-node,36-build-20230530,2023/06/29,0,1,1,0,0,2
datadog/agent-buildimages-deb_arm64,v20433308-6861270,2023/09/25,3,24,19,0,0,46
qualys/crs-instrumenter,2.5.2.0-9,2022/09/28,0,4,15,0,0,19
rancher/istio-1.5-migration,0.1.1,2020/07/09,10,24,52,6,0,92
kasmweb/core-cuda-bionic,1.10.0,2022/06/07,234,883,20,0,0,1137
astronomerinc/ap-postgresql,15.4.0-1,2023/10/10,96,19,11,2,0,128
okteto/devtools,0.1.0,2019/01/19,710,1042,73,0,0,1825
airbyte/source-google-webfonts,0.1.0,2022/10/27,0,17,27,1,0,45
continuumio/ae-conda-packages,v3,2019/02/04,95,115,208,72,12,502
bitnami/photon-base-buildpack,4-r6,2023/06/16,5,62,36,5,0,108
objectscale/csi-resizer,v1.4.0,2022/01/21,0,4,7,0,0,11
newrelic/nr-otel-collector,0.6.0-rc,2023/11/13,0,1,5,0,0,6
vmware/clair,v2.0.1-photon,2017/11/23,11,78,117,69,0,275
balenalib/asus-tinker-board-s-debian-openjdk,20230911,2023/09/12,129,64,44,6,0,243
redislabs/redisgraph,2.12.10,2023/09/27,1,2,1,0,0,4
docker/ucp-coredns,3.3.1,2019/04/07,null
newrelic/nri-prometheus,2.19,2023/11/02,0,0,3,0,0,3
bitnami/prestashop,8.1.2,2023/10/11,149,88,72,4,2,315
balenalib/ts4900,20220714,2022/07/20,124,68,74,18,0,284
astronomerinc/ap-kibana,8.9.2,2023/10/31,21,14,1,1,0,37
balenalib/artik533s-ubuntu-node,20220715,2022/08/02,88,83,12,0,0,183
grafana/synthetic-monitoring-agent,v0.0.3,2020/08/26,98,71,81,22,6,278
circleci/cci-demo-go-primary,0.0.2,2017/03/15,209,611,633,166,36,1655
objectscale/objectscale-oktool,0.1.0-146.7ccfc1e,2023/04/20,7,60,60,4,6,137
balenalib/artik533s-openjdk,20220714,2022/07/22,157,127,85,18,0,387
redhat/ubi8-minimal,8.8-1072,2023/09/13,61,23,4,0,0,88
couchbase/analytics-demo,5.0.0-671,2017/08/22,83,79,7,0,0,169
pachyderm/pachtf,2.2.8,2022/08/18,0,13,17,0,0,30
bitnami/haproxy,2.8.3,2023/11/17,74,18,12,4,0,108
rapidfort/grafana-ib,9.5.3,2023/11/18,22,31,8,0,0,61
kasmweb/maltego,1.14.0,2023/09/14,193,397,0,0,0,590
okteto/python-getting-started,1.0.1,2023/02/27,77,31,27,2,0,137
formio/formio-enterprise,8.4.0-rc.24,2023/11/13,0,5,0,2,0,7
airbyte/source-aha,0.3.1,2023/06/05,0,15,27,1,0,43
balenalib/armv5e-debian-python,20191011,2019/10/29,185,170,174,35,8,572
rancher/rio-build,48f64897,2018/08/02,881,1348,105,0,0,2334
appdynamics/python-agent-init,5686,2023/02/06,0,10,10,0,0,20
astronomerinc/ap-po-logical-backup,1.8.1,2022/07/18,78,204,5,0,0,287
objectscale/remote-access,2.0.51,2020/09/29,61,118,171,23,0,373
portainer/config-manager,2.19.1,2023/09/27,null
rancher/opni-manager,v0.4.0,2022/04/01,5,56,38,3,14,116
docker/highland_builder,3979.0.0-stable,2023/06/20,0,8,4,4,0,16
okteto/supervisor,1.0.0,2021/04/16,0,1,0,0,0,1
airbyte/destination-gcs,0.4.4,2023/07/15,65,190,176,17,0,448
mongodb/mongodb-atlas-kubernetes-operator,2.0.0,2023/11/22,3,2,0,0,0,5
balenalib/up-board-debian-golang,20230712,2023/07/16,null
amazon/aws-sam-cli-emulation-image-provided.al2,20220125,2022/01/25,3,129,42,0,0,174
airbyte/source-chartmogul,1.0.0,2023/11/09,0,13,26,1,0,40
percona/percona-mysql-router,8.0.34,2023/09/15,240,52,13,0,0,305
balena/i386-nlp-supervisor,v10.11.3,2020/04/02,0,6,8,3,0,17
docker/volumes-backup-extension,1.1.4,2023/06/12,0,18,6,0,0,24
balenalib/ts4900-python,20220604,2022/06/12,124,81,76,20,0,301
google/apigee-envoy,v1.22.2,2022/06/10,11,16,12,2,0,41
intel/telemetry-aware-scheduling,0.6.0,2023/07/12,0,2,1,0,0,3
airbyte/source-clickup-api,0.1.1,2023/03/21,0,16,27,1,0,44
kasmweb/deluge,1.14.0,2023/09/14,194,381,0,0,0,575
newrelic/cluster-api-controller-arm,mv1a,2019/04/17,0,0,0,0,6,6
percona/dcos-mongo-tools,0.2.1,2018/07/02,null
docker/dtr-postgres-s390x,2.5.0-beta3,2018/01/17,0,15,26,5,0,46
amazon/aws-sam-cli-emulation-image-nodejs10.x,20220125,2022/01/25,1,56,27,3,0,87
onlyoffice/documentserver,7.5.1.1,2023/11/05,123,91,1,1,0,216
bellsoft/buildpacks.alpaquita-run,musl,2023/04/04,null
bitnami/telegraf,1.28.4,2023/11/13,74,12,8,2,0,96
rancher/calico,v3.13.3,2020/08/26,469,513,88,4,0,1074
bitnami/os-shell,11,2023/11/09,84,14,15,4,0,117
airbyte/source-youtube-analytics,0.1.4,2023/05/26,0,15,27,1,0,43
pachyderm/etcd,v3.5.5,2022/09/15,71,40,57,9,0,177
bitnami/wavefront-prometheus-storage-adapter-archived,1.0.7,2023/06/17,74,26,19,2,0,121
bitnami/nats,2.10.5,2023/11/10,74,12,8,2,0,96
greenbone/gvmd-build,23.1,2023/11/14,486,122,75,10,0,693
airbyte/airbyte-webapp,0.30.8-alpha-cloud-stage,2021/10/03,6,29,52,9,0,96
qualys/jira-client-for-jira-integration,1.2.0,2023/10/13,0,5,5,0,0,10
vmware/photon-2.0-kube-controller-manager-amd64,v1.10.2-20180619,2018/06/19,15,81,98,70,0,264
intel/intel-optimized-tensorflow-serving-avx512,2.8.0,2022/03/29,61,40,2,0,0,103
airbyte/normalization-clickhouse,0.4.3,2023/05/12,461,223,192,16,0,892
balenalib/imx6ul-var-dart-node,20230911,2023/09/12,118,38,41,6,0,203
grafana/cortex,single-binary-676071aa3-WIP-2,2019/05/09,0,0,0,2,0,2
percona/percona-postgresql-operator,2.2.0,2023/06/09,36,34,9,0,0,79
balena/open-balena-registry,2.39.27,2023/11/12,365,89,63,5,0,522
balenalib/apalis-imx6q-golang,20220714,2022/07/28,467,262,214,28,1,972
lacework/code-security-pipe,1.2.8,2023/10/30,58,53,22,1,0,134
atlassian/dynamodb-elasticsearch-indexer,3.0.10,2021/05/18,231,149,177,53,10,620
objectscale/rsyslog,0.54.0,2020/11/10,6,64,67,5,3,145
airbyte/source-close-com,0.4.3,2023/11/10,64,7,4,1,0,76
mattermost/node-rotator,11c4803,2023/05/25,0,10,5,3,0,18
kong/konnect-migration,debug,2022/10/12,77,40,44,3,0,164
ngrok/ngrok,3,1970/01/01,97,37,46,13,6,199
rancher/mirrored-coreos-flannel,v0.15.1,2021/11/12,2,16,27,3,0,48
balenalib/ts4900-alpine-python,20220714,2022/07/19,7,38,37,10,0,92
rancher/os-hypervvmtools,v1.5.8,2021/02/05,100,39,50,16,6,211
airbyte/source-sentry,0.3.0,2023/09/19,0,15,26,1,0,42
google/apigee-asm-ingress,1.12.9-asm.3,2022/09/30,15,11,12,0,0,38
balenalib/artik5-debian-python,20220714,2022/07/22,124,69,76,18,0,287
airbyte/destination-tidb,0.1.4,2023/06/23,67,201,190,17,0,475
balenalib/generic-aarch64-debian-openjdk,20231106,2023/11/07,125,43,31,4,0,203
rapidfort/gitlab-ce,latest-rfstub,2022/09/19,59,190,177,3,0,429
rancher/hardened-node-feature-discovery,v0.14.1-build20230926,2023/09/26,0,13,22,0,0,35
docker/dtr-jobrunner-s390x,2.5.0-beta3,2018/01/17,3,56,103,50,0,212
balenalib/zynq-xz702-fedora,20220604,2022/06/12,null
intel/oact-rps,v2.19.1,2023/11/01,0,0,2,0,0,2
kong/deck,v1.29.2,2023/11/08,0,0,4,0,0,4
docker/reefer,0.0.5,2018/08/09,0,0,0,2,0,2
astronomerinc/ap-pgbouncer,1.20.1-1,2023/11/02,0,0,3,0,0,3
adobecoldfusion/apimanager,latest-2023,2023/05/17,40,92,99,40,0,271
balena/open-balena-registry-proxy,5.0.23,2023/10/18,133,27,22,1,0,183
appdynamics/ad-air-java-services,netviz5,2021/01/26,107,121,106,32,0,366
mathworks/matlab,r2023b,2023/10/27,194,205,8,0,0,407
balenalib/raspberrypi3-ubuntu,20231026,2023/11/02,37,9,0,0,0,46
airbyte/source-kyve,0.1.0,2023/06/14,0,13,19,0,0,32
google/apigee-deployment-controller,1.1.1,2020/02/05,0,0,0,0,6,6
mirantis/ucp-hyperkube,3.7.1,2023/09/26,35,59,46,0,0,140
balenalib/ts4900-ubuntu-node,20220715,2022/07/19,88,104,12,0,0,204
balenalib/kitra520-alpine-python,20220803,2022/08/04,7,38,37,10,0,92
balenalib/nitrogen6x-debian-golang,20220714,2022/07/28,467,262,214,28,1,972
balenalib/raspberry-pi2-ubuntu-node,20231026,2023/11/02,38,10,1,0,0,49
portainer/golang-builder,cross-platform-next,2018/05/20,200,462,503,111,15,1291
intel/esp-uos-firmware-lan,v3.1.2,2023/07/25,null
appdynamics/orchestration-client,23.8.0-721,2023/08/24,0,5,7,0,0,12
grafana/mimirtool,2.10.4,2023/11/13,0,1,4,0,0,5
rancher/os-volumenetshare,v1.5.8,2021/02/05,2,17,37,4,0,60
balenalib/orbitty-tx2-golang,20231106,2023/11/07,436,82,52,5,0,575
balenalib/odroid-xu4-alpine-node,18.14.1-20231106,2023/11/07,0,1,5,0,0,6
rancher/mirrored-cilium-cilium-envoy,v1.26.6-ff0d5d3f77d610040e93c7c7a430d61a0c0b90c1,2023/10/29,19,8,0,0,0,27
rapidfort/rabbitmq,3.12.6,2023/10/17,49,12,12,3,0,76
balenalib/odroid-c1-ubuntu,20220714,2022/08/02,87,82,11,0,0,180
bitnami/cainjector,1.13.2,2023/11/08,74,12,8,2,0,96
puppet/puppet-agent-alpine,7.15.0,2022/03/23,2,8,6,0,0,16
newrelic/newrelic-istio-adapter,2.0.3,2020/08/24,2,15,19,1,0,37
balenalib/orangepi-plus2-debian-python,20230911,2023/09/11,118,37,40,6,0,201
grafana/loki-bigtable-backup,master-9930f704,2019/08/02,4,22,11,2,0,39
bitnami/redhatubi-base-buildpack,9-r4,2023/06/21,332,187,35,0,0,554
lacework/lacework-cli,v1.38.0,2023/11/09,0,1,5,0,0,6
rapidfort/redis-official,7.2.3-bookworm,2023/11/22,23,2,2,0,0,27
newrelic/k8s-nri-cassandra,2.2.0.1,2019/09/09,102,67,25,0,0,194
grafana/mimir,2.10.4,2023/11/13,0,1,4,0,0,5
redislabs/rejson,99.99.98,2023/10/09,72,19,17,2,0,110
rancher/goharbor-harbor-core,v1.7.5,2019/04/01,14,63,88,37,0,202
mirantis/dtr-jobrunner,3.0.0-alpha.2,2021/09/22,7,65,90,18,0,180
mirantis/ucp-proxy,1.1.6,2017/01/18,0,42,21,8,0,71
rancher/calico-ctl,v3.19.2,2021/08/03,0,6,9,2,0,17
rancher/git-serve,v0.7.0,2020/01/02,238,443,21,0,0,702
rapidfort/kong,3.0.0-ubuntu,2023/02/09,null
balenalib/odroid-xu4-openjdk,20230911,2023/09/11,129,64,44,6,0,243
ambassador/telepresence-docker-desktop-extension,0.0.8-alpha.2,2022/04/13,0,12,21,0,0,33
greenbone/cert-bund-data,202311150421,2023/11/15,null
docker/desktop-kubeconfig-merge,v1.1,2020/04/15,0,6,10,0,0,16
pachyderm/pachd-amd64,97276071e371d5b1ea221437e99cfd87b5599ddf,2023/11/03,0,7,4,0,0,11
airbyte/source-zendesk-chat,0.2.1,2023/10/20,64,21,8,1,0,94
couchbase/centos-69-sdk-build,20180806,2018/08/07,1624,2009,258,7,0,3898
balenalib/i386-nlp-alpine,20191223,2021/04/17,2,0,0,1,0,3
rancher/kubernetes-agent,v0.7.0,2017/09/28,312,392,24,0,0,728
pachyderm/bench,9485135059f9153350ad33a5928fe0b966502b8e,2017/04/27,65,106,17,0,0,188
airbyte/source-linkedin-ads,0.6.4,2023/10/19,64,21,8,1,0,94
balenalib/stem-x86-32-debian-python,20230904,2023/09/09,118,37,40,6,0,201
hashicorp/consul-k8s-control-plane-fips,1.3,2023/11/07,33,20,5,0,0,58
rancher/mirrored-banzaicloud-fluentd,v1.14.6-alpine-5,2022/05/25,4,42,34,6,0,86
docker/vpnkit-tap-vsockd,328ace386c62036c2a045744eeff20e46312d20a,2018/09/04,0,0,0,2,0,2
rancher/mirrored-neuvector-manager,5.2.3,2023/11/10,0,0,2,0,0,2
balenalib/apalis-imx6q-fedora,20220604,2022/06/12,null
balenalib/intel-nuc-python,20231106,2023/11/06,114,21,29,4,0,168
grafana/cortextool,v0.2.4,2020/08/12,3,20,20,0,0,43
balenalib/via-vab820-quad-debian-node,18.6-20220714,2022/07/21,124,70,75,18,0,287
bitnami/jwt-cli,6.0.0,2023/11/15,74,12,8,2,0,96
mongodb/mongo-cxx-driver,3.9.0-redhat-ubi-9.3,2023/11/09,20,11,0,0,0,31
rancher/mirrored-longhornio-livenessprobe,v2.9.0,2022/12/28,0,3,3,0,0,6
rancher/fleet-agent,v0.9.0,2023/11/07,2,12,19,0,3,36
intel/smart-city_solution,2021.4.2,2021/12/14,277,822,39,0,0,1138
docker/tilt,v0.33.6,2023/09/29,111,32,27,6,0,176
mattermost/mattermost-preview,9.1.1,2023/11/01,108,18,14,1,0,141
intel/dlstreamer,2023.0.0-ubuntu22-gpu682-dpcpp,2023/10/02,257,385,19,0,0,661
balenalib/apalis-imx6q-alpine-node,20220714,2022/07/19,7,38,36,10,0,91
balenalib/orbitty-tx2-alpine,20231106,2023/11/06,0,0,4,0,0,4
astronomerinc/ap-db-bootstrapper,0.31.7,2023/11/08,5,5,9,0,0,19
rancher/hardened-sriov-network-resources-injector,v1,2021/02/23,241,333,38,3,0,615
lacework/ghactions,6.0,2023/06/14,2,21,14,5,0,42
balenalib/odroid-xu4-node,20230911,2023/09/11,118,38,41,6,0,203
vmware/lightwave-base,1.0.0,2020/03/13,28,117,137,48,0,330
hashicorp/vault,1.15.2,2023/11/06,0,2,4,0,0,6
appdynamics/appd-oc-otel-collector,22.1.0,2022/01/31,0,5,9,0,0,14
objectscale/csi-baremetal-pre-upgrade-crds,1.4.0-124.541af8d,2023/11/03,94,13,24,3,0,134
redislabs/redis-connect-postgres,0.8.3-112,2022/03/04,5,29,39,13,0,86
mattermost/mattermod-jobserver,0.18.0,2023/10/11,28,28,7,0,0,63
vmware/photon-2.0-calico-kube-policy-controller,v1.0.0-20180619,2018/06/19,15,72,90,57,0,234
nginx/nginx-ingress-operator,2.0.2,2023/11/02,63,31,9,0,0,103
kasmweb/firefox,1.14.0,2023/09/14,185,397,0,0,0,582
opensearchproject/opensearch-benchmark,1.1.0,2023/08/10,467,143,96,10,0,716
grafana/openvas,20200716,2020/07/15,1052,1164,175,10,0,2401
airbyte/db,0.50.34,2023/11/09,0,0,4,0,0,4
bitnami/consul,1.17.0,2023/11/08,155,61,27,3,0,246
balenalib/revpi-core-3-golang,20230530,2023/06/27,379,57,48,8,0,492
newrelic/newrelic-prometheus-configurator,1.10.0,2023/11/13,0,0,4,0,0,4
balenalib/spacely-tx2-fedora,20231106,2023/11/06,null
balenalib/bananapi-m1-plus-openjdk,20230904,2023/09/09,129,64,44,6,0,243
docker/engine-community-arches,18.09.0-ce-tp6.test.x86_64,2018/09/05,null
balenalib/generic-aarch64-node,20231106,2023/11/07,114,22,30,4,0,170
bitnami/gitea,1.20.5,2023/11/17,100,19,29,5,0,153
hashicorp/vault-csi-provider,1.4.1,2023/10/26,0,0,4,0,0,4
rapidfort/haproxy-official,2.9-dev8-bullseye,2023/11/01,20,3,1,0,0,24
airbyte/destination-duckdb,0.3.0,2023/10/24,64,21,8,1,0,94
rancher/mirrored-library-registry,2.8.1,2023/05/10,0,8,4,3,0,15
cockroachdb/charts-builder,20200702-210440,2020/07/03,223,225,229,82,8,767
ubuntu/loki,2.8.4-22.04,2023/10/05,22,28,14,0,0,64
balenalib/artik10-alpine-node,20220803,2022/08/04,7,38,36,10,0,91
airbyte/source-exchangeratesapi-singer-abprotocol,0.1.2,2020/10/20,112,80,87,31,7,317
rancher/mirrored-sigwindowstools-k8s-gmsa-webhook,v0.3.0,2021/11/01,0,4,6,0,0,10
rancher/system-agent-installer-rancher,v2.8.0-rc3,2023/10/26,0,7,3,0,0,10
airbyte/destination-yugabytedb,0.1.1,2023/03/17,65,201,179,17,0,462
bitnami/grafana-tempo-vulture,2.3.0,2023/11/08,74,12,8,2,0,96
airbyte/source-firebase-realtime-database,0.1.0,2022/12/15,3,18,30,1,0,52
rancher/server,v2.0.0-beta4,2018/04/25,9,26,2,0,0,37
balenalib/zynq-xz702-node,18.6-20220714,2022/07/21,124,70,75,18,0,287
rancher/goharbor-nginx-photon,v1.7.5,2019/04/01,14,67,85,37,0,203
circleci/docker-coreos-toolbox-ubuntu,0.1,2019/10/25,133,136,6,0,0,275
bellsoft/liberica-openjdk-debian,21.0.1-12,2023/11/14,105,17,20,4,0,146
amazon/aws-sam-cli-emulation-image-python3.8,20220125,2022/01/25,1,52,14,0,0,67
mattermost/inbucket,release-1.2.0,2017/12/27,0,5,0,0,0,5
intel/its-query-rest,master-ae213cd97d6931b1d44fc7689867cf5701e0f15d,2023/09/24,65,32,19,14,0,130
apachepinot/trino,396-SNAPSHOT-amd64,2022/09/15,135,271,158,37,0,601
rancher/os-framework,55951fe-amd64,2021/10/09,18,174,159,7,9,367
accurics/terrascan_atlantis,1.14.0,2022/04/01,11,145,210,27,0,393
amazon/aws-lambda-dotnet,7.2023.11.12.09,2023/10/25,0,1,3,0,0,4
bitnami/kubeapps-kubeops-archived,2.5.1,2022/10/04,1,5,8,0,0,14
vmware/admiral,v1.5.2,2019/03/11,36,104,157,60,0,357
balenalib/nitrogen6x-alpine,20220714,2022/07/19,7,37,35,10,0,89
balenalib/ts4900-fedora-golang,20220507,2022/05/12,null
balenalib/ts4900-debian-openjdk,20210602,2021/06/05,230,232,145,39,8,654
airbyte/worker,0.50.34,2023/11/09,4,72,57,0,0,133
google/apigee-kube-rbac-proxy,v0.13.0,2022/09/20,0,3,10,1,0,14
intel/power-node-agent,v2.3.1,2023/08/28,0,3,2,0,0,5
airbyte/source-persistiq,0.2.0,2023/10/20,0,13,26,1,0,40
balenalib/hummingboard-ubuntu-python,20230904,2023/09/09,42,11,4,0,0,57
cockroachdb/cockroach,v23.1.12,2023/11/13,63,15,0,0,0,78
mirantis/k8s-externalipcontroller,tets,2019/01/04,0,10,2,0,0,12
balenalib/orbitty-tx2-ubuntu-python,20231103,2023/11/06,37,10,0,0,0,47
bitnami/trivy,0.47.0,2023/11/09,74,12,8,2,0,96
rancher/mesos-slave,0.28.1,2016/05/24,235,326,17,0,0,578
atlassian/bamboo-agent-base,9.4.1,2023/11/21,66,82,2,3,0,153
pachyderm/pachctl,2.8.0-rc.2,2023/11/13,95,20,30,2,0,147
balenalib/bananapi-m1-plus-fedora-openjdk,30-20210825,2021/09/03,null
onlyoffice/docspace-wait-bin-share,1.1.4.1,2023/10/23,null
bitnami/openresty,1.21.4-3,2023/11/04,107,30,22,4,0,163
redhat/ubi9-init,9.3-5,2023/11/01,127,38,2,0,0,167
airbyte/source-reply-io,0.1.0,2022/11/10,0,17,27,1,0,45
bitnami/cassandra-exporter,2.3.8,2023/11/17,76,24,18,2,0,120
rancher/cert-manager-acmesolver-arm64,v0.7.2-rio.1,2019/05/15,0,0,0,2,0,2
balenalib/generic-armv7ahf-debian-node,20230904,2023/09/09,118,38,41,6,0,203
objectscale/ese-callback,2.71.3,2021/04/14,2,17,22,0,0,41
balenalib/orangepi-plus2-ubuntu-node,20231026,2023/11/02,38,10,1,0,0,49
balenalib/parallella-alpine-python,20230904,2023/09/09,2,1,7,2,0,12
balenalib/spacely-tx2-debian-node,20231106,2023/11/07,114,22,30,4,0,170
intel/intel-ethernet-operator-labeler,v1.0.0,2023/07/26,4,14,4,0,0,22
docker/ucp-compose,3.3.1,2020/06/26,4,6,2,0,0,12
airbyte/destination-sqlite,0.1.0,2022/08/09,0,18,27,1,0,46
astronomerinc/ap-grafana,10.2.0,2023/10/31,0,3,7,0,0,10
balenalib/beaglebone-black-alpine-golang,20231106,2023/11/07,0,0,4,0,0,4
airbyte/destination-jdbc,0.3.14,2022/06/17,80,102,147,61,0,390
balenalib/colibri-imx6dl-python,20220604,2022/06/12,124,81,76,20,0,301
lacework/lacework-docker-extension,0.1.18,2022/07/14,0,21,33,1,0,55
pachyderm/ci_code_bundle,23875,2021/06/03,6,0,0,0,0,6
onlyoffice/docspace-backup,1.1.4.1,2023/10/23,1016,143,210,12,0,1381
kasmweb/teams,1.12.0,2022/12/01,356,1011,2,0,0,1369
ddosify/selfhosted_hammer,1.4.2,2023/07/18,0,14,11,1,0,26
balenalib/spacely-tx2-debian-python,20231106,2023/11/07,114,21,29,4,0,168
hashicorp/terraform-cloud-operator,2.0,2023/11/06,null
rancher/tekton-utils,v0.17-a3,2022/08/12,6,61,46,3,12,128
rancher/mirrored-k8scsi-csi-node-driver-registrar,v2.1.0,2020/12/18,0,5,9,0,5,19
balenalib/i386-ubuntu-openjdk,11-xenial-20230911,2023/09/11,null
objectscale/kube-metrics-adapter,3.7.0.0-1186.91aed4d8,2021/04/25,3,58,63,6,2,132
bitnami/python,3.12.0,2023/11/15,425,78,47,5,0,555
onlyoffice/mailserver,1.6.75,2020/08/04,2186,3479,151,8,0,5824
docker/cluster,v1.3.0,2020/04/20,10,38,36,2,0,86
bitnami/php-fpm,8.2.12,2023/11/15,151,81,52,5,2,291
bitnami/argo-workflow-controller,3.5.1,2023/11/08,0,2,0,0,0,2
atlassian/clientside-extensions,v0.4,2020/09/30,312,761,62,4,0,1139
balenalib/beaglebone-green-wifi-golang,20230911,2023/09/12,442,111,73,9,0,635
okteto/udemy,vote,2019/09/17,5,22,17,1,0,45
airbyte/source-gainsight-px,0.1.0,2023/07/13,0,15,27,1,0,43
redis/redis-stack,7.2.0-RC3,2023/07/10,27,17,2,0,0,46
intel/oact-rpc,v2.0.0,2021/09/15,74,66,4,0,0,144
rancher/goharbor-harbor-db,v1.7.5,2019/04/01,15,82,131,39,0,267
rancher/haproxy-cadvisor,v0.0.1,2016/06/11,0,27,24,10,0,61
rancher/cis-operator,v1.0.12,2023/06/08,0,5,5,0,1,11
grafana/grafana-ci-windows-test,0.1.0,2023/04/13,null
docker/ucp-auth-store-s390x,3.1.0-beta3,2018/10/04,0,0,4,8,0,12
amazon/aws-iot-greengrass,2.5.3-0-deprecated,2022/01/13,46,301,150,1,0,498
rancher/fluentd-helper,v0.1.2,2018/04/10,43,85,10,0,0,138
vmware/clair-photon,v2.0.1,2017/10/30,10,75,106,67,0,258
balenalib/beaglebone-green,20230911,2023/09/11,118,36,40,6,0,200
google/apigee-diagnostics-collector,1.8.1,2022/09/20,7,24,19,3,4,57
airbyte/source-younium,0.3.0,2023/10/25,65,23,8,1,0,97
kasmweb/core-centos-7,1.14.0,2023/09/09,1357,1281,60,0,0,2698
intel/oact-mpsrouter,v2.3.0,2023/09/20,null
grafana/devtools-github-event-aggregator,4160534dbc93f1bec6669c5a97edbbbf83cc3c52,2019/04/03,55,35,67,15,10,182
airbyte/airbyte-base-java-python-image,1.0,2023/06/22,7,72,99,0,0,178
portainer/compose-unpacker,latest-windows-amd64,2023/08/31,0,13,15,0,0,28
docker/dtr-notary-server-s390x,2.5.0-beta3,2018/01/17,0,16,41,34,0,91
intel/intel-gpu-initcontainer,0.28.0,2023/09/22,null
airbyte/integration-singer-stripe-source,0.1.2,2020/10/07,10,39,63,13,0,125
balenalib/aarch64-node,20231106,2023/11/07,107,22,24,4,0,157
grafana/netlify-cms-oauth-provider-go,51188a4,2019/06/21,4,14,9,3,0,30
airbyte/destination-milvus,0.0.9,2023/11/13,64,21,10,4,0,99
continuumio/ci-image,v27,2019/09/12,1224,1828,413,19,1,3485
vmware/nginx,1.11.5-patched,2017/04/07,55,157,175,66,22,475
bitnami/harbor-notary-server-archived,2.8.4,2023/09/15,83,177,229,2,0,491
balenalib/beaglebone-green-alpine-python,20231106,2023/11/07,0,1,4,0,0,5
bitnami/oauth2-proxy,7.5.1,2023/11/09,74,16,10,2,0,102
balenalib/i386-nlp-debian,20210225,2021/04/19,195,119,140,43,9,506
redislabs/cloud-api-build,1.0.0,2020/01/05,256,1614,39,8,0,1917
airbyte/source-asana,0.6.1,2023/11/13,64,7,4,1,0,76
google/apigee-prom-prometheus,v2.33.5,2022/03/08,4,26,18,0,0,48
mongodb/atlas,v1.31.0,2023/08/14,82,47,10,0,0,139
balenalib/orangepi-plus2-debian-golang,20230911,2023/09/11,442,111,73,9,0,635
accurics/siac-auth,1.3.14,2021/05/07,2,17,40,4,0,63
balenalib/artik530,20220714,2022/07/22,124,68,74,18,0,284
balenalib/asus-tinker-board-s-alpine-golang,20231106,2023/11/07,0,0,4,0,0,4
airbyte/keycloak-setup,0.50.34,2023/11/09,4,72,58,0,0,134
balenalib/beaglebone-green-golang,20230911,2023/09/11,442,111,73,9,0,635
mattermost/mattermost-app-chaosengine,150a153,2022/01/14,0,22,42,1,0,65
rancher/eks-controller,v0.1.0-rc14,2020/07/16,259,410,29,3,0,701
portainer/agent,2102,2018/07/31,null
rancher/mirrored-longhornio-csi-attacher,v4.2.0,2023/02/01,0,3,3,0,0,6
rapidfort/consul,1.16.2,2023/10/24,42,9,3,0,0,54
vmware/photon-2.0-nginx-ingress,v1.1.1-20180619,2018/06/19,15,78,98,58,0,249
bellsoft/buildpacks.maven,6.13.0,1980/01/01,null
rancher/secrets-bridge-v2,v0.3.2,2018/03/09,63,91,12,0,0,166
airbyte/source-intercom,0.3.1,2023/10/15,64,21,8,1,0,94
newrelic/test-oracle-db,11.2.0.2-xe,2020/08/31,4,131,30,3,0,168
balenalib/generic-aarch64-ubuntu,20231103,2023/11/06,37,9,0,0,0,46
bitnami/harbor-registry,2.9.1,2023/11/08,74,12,8,2,0,96
balenalib/artik5-alpine,20220803,2022/08/03,7,37,35,10,0,89
balenalib/aarch64-fedora-golang,20231106,2023/11/06,null
okteto/payroll,0.1,2019/06/06,47,99,150,50,10,356
sysdig/onprem_migration,events,2017/03/03,103,317,363,181,30,994
rancher/configmap-reload,v0.3.0-rancher4-windows-2004,2021/01/28,null
objectscale/blob-service,0.71.3,2021/04/15,16,142,197,36,3,394
bitnami/ghost,5.73.2,2023/11/17,91,54,39,8,0,192
hashicorp/vagrant-website,714860103532a0bc72678aafdc6e9769dede77c2ceeb76bcc8a6fa601e69e562,2020/10/08,11,86,117,24,0,238
accurics/cli-kubescan,1.0.41,2022/09/26,0,28,30,1,0,59
mirantis/dtr-content-cache,3.0.0-alpha.2,2021/09/22,1,10,36,3,0,50
rancher/mirrored-sonobuoy-sonobuoy,v0.57.0,2023/10/19,null
amazon/aws-secrets-manager-secret-sidecar,v0.1.4,2021/03/08,40,321,92,8,0,461
datadog/agent-buildimages-windows_20h2_x64,v3686353-1e75137,2021/01/12,8,49,134,12,0,203
balenalib/orangepi-plus2-fedora-openjdk,30-20210825,2021/09/03,null
hashicorp/consul-website,76497883ab408fa8fde43d9c554e73565874a46feb4549fc6ea97b2b20b204b7,2021/01/14,12,77,105,18,0,212
mirantis/ucp-auth,3.7.1,2023/09/07,3,2,8,2,0,15
bitnami/ubuntu-base-buildpack,22-r1,2022/09/07,306,566,74,0,0,946
airbyte/source-intercom-singer,0.2.3,2021/07/03,561,319,283,39,7,1209
rancher/opni-monitoring-ui-build,80424898df491ba46d6ace27167fd1d333577167,2023/04/26,null
balenalib/i386-alpine-node,16.19.1-20230911,2023/09/11,2,1,8,2,0,13
balenalib/beaglebone-black-ubuntu-python,20230911,2023/09/12,42,11,4,0,0,57
redislabs/redisearch,2.10.0,2023/09/11,72,21,17,2,0,112
rancher/hardened-cilium-bpftool,4c18d06f1d545ed6fde810c2b97935dc8938ddc8-build20210521,2021/05/21,76,71,3,0,0,150
balenalib/beaglebone-black-alpine-python,20231106,2023/11/07,0,1,4,0,0,5
airbyte/source-file,0.3.15,2023/10/19,143,19,18,3,0,183
docker/ucp-secureoverlay-mgr,3.3.1,2020/06/26,2,8,9,1,0,20
onlyoffice/4testing-docspace-clear-events,2.0.0.33,2023/11/15,1016,142,207,12,0,1377
okteto/babel-maquetacion,0.1,2020/02/03,508,2250,1365,328,72,4523
rancher/k3s-upgrade,v1.28.3-k3s2-s390x,2023/11/08,0,14,4,0,0,18
rancher/banzaicloud-fluentd,v1.11.5-alpine-9,2021/01/19,12,46,107,15,0,180
docker/ucp-calico-node-s390x,3.1.0-beta3,2018/10/04,0,6,6,2,0,14
grafana/fluent-bit-plugin-loki,2.9.2,2023/10/25,28,29,23,2,0,82
okteto/remote-ssh,dev,2019/09/12,698,1020,73,0,0,1791
balena/amd64-supervisor,1299,2020/07/31,6,26,55,9,0,96
airbyte/source-primetric,0.1.0,2022/09/21,0,15,19,0,0,34
mattermost/perseus,v0.0.2,2023/01/12,0,0,1,0,0,1
balenalib/ts4900-debian,20220714,2022/07/20,124,68,74,18,0,284
balenalib/ts4900-ubuntu-openjdk,20210826,2021/09/04,136,435,10,0,0,581
kasmweb/ubuntu-jammy-dind-rootless,1.14.0,2023/09/14,270,423,44,0,0,737
balenalib/odroid-c1-alpine-node,20220714,2022/07/19,7,38,36,10,0,91
pachyderm/mnist_standalone,v1.0.0,2020/04/08,1483,1783,1424,184,39,4913
rancher/k8s-dns-node-cache,1.15.13,2020/05/09,82,42,46,17,2,189
mariadb/xpand-single,23.09.1,2023/09/18,558,513,32,3,0,1106
bitnami/grafana-mimir,2.10.3,2023/11/08,74,14,10,2,0,100
rancher/prom-node-exporter,v1.0.1,2020/06/16,0,5,10,0,0,15
hashicorp/packer-website,4620289a4b88df2b745e524720bb3a372978056f2f4ece0ec0bd790747fa42c1,2020/09/04,11,93,125,24,0,253
bitnami/keycloak,22.0.5,2023/11/20,89,20,19,4,0,132
balenalib/parallella-ubuntu-node,20230904,2023/09/09,43,11,5,0,0,59
airbyte/source-marketo-singer,0.2.3,2021/07/06,561,320,282,39,7,1209
balenalib/odroid-xu4-debian-node,20230911,2023/09/11,118,38,41,6,0,203
portainer/helper-reset-password,windowsltsc2022-amd64,2023/05/17,0,3,3,0,0,6
bitnami/node-exporter,1.7.0,2023/11/13,74,12,8,2,0,96
balenalib/spacely-tx2-ubuntu-golang,20231103,2023/11/06,139,131,0,0,0,270
mattermost/mattermost-build-server,5.6.0,2018/11/29,223,547,586,150,18,1524
mattermost/mm-mlh-hacktoberfest,0.0.1,2020/09/15,2,18,41,4,0,65
balenalib/qemux86-64-fedora-golang,20231103,2023/11/04,null
rapidfort/nats-official,2.9.22,2023/09/13,0,0,1,0,0,1
airbyte/source-ip2whois,0.1.0,2022/11/09,0,17,27,1,0,45
balenalib/colibri-imx6dl-debian-openjdk,20210602,2021/06/05,230,232,145,39,8,654
rancher/k3c-data,v0.0.1,2020/01/11,null
kasmweb/core-ubuntu-jammy,1.14.0,2023/09/09,154,227,12,0,0,393
grafana/cortex-configs,w37-0193e7b7,2018/09/11,0,0,0,2,0,2
cockroachdb/acceptance-gss-kdc,20230419-131103,2023/04/19,null
balenalib/parallella-ubuntu-openjdk,11-xenial-20230904,2023/09/09,null
balenalib/artik710-alpine-golang,3.16-20230904,2023/09/09,2,0,5,2,0,9
cimg/redis,7.2.3,2023/11/02,294,325,48,0,0,667
rancher/backup-restore-operator,v4.0.0,2023/10/30,0,3,4,1,0,8
bitnami/kubernetes-event-exporter,1.5.0,2023/11/18,74,13,9,2,0,98
mirantis/ucp-openstack-cinder-csi-plugin,3.5.3,2021/04/08,132,108,121,38,3,402
docker/dev-environments-ruby,5741e9ade3b31784a7a35d5a81f19d30e8f63c5e,2021/08/10,1129,731,859,89,26,2834
balenalib/artik5-alpine-openjdk,8-jre-20220803,2022/08/04,34,78,48,10,0,170
purestorage/ccm-service,3.2.13,2022/08/09,19,53,32,1,0,105
dynatrace/easytravel-mongodb,7.1,2018/05/11,0,2,2,3,0,7
continuumio/anaconda-pkg-build,2023.03.28,2023/03/28,579,567,39,3,0,1188
docker/ucp-kube-dns,3.2.7,2020/06/26,0,0,0,2,0,2
solaceiotteam/async-apim-server,0.4.1,2022/09/29,0,13,24,2,0,39
objectscale/decks-support-store,2.71.3,2021/04/14,6,71,68,3,6,154
balenalib/nitrogen6x-alpine-openjdk,8-3.14-20220112,2022/01/19,2,50,42,13,0,107
mirantis/ucp-cfssl,3.7.1,2023/09/26,2,2,6,2,0,12
balenalib/stem-x86-32-ubuntu-openjdk,11-xenial-20230904,2023/09/09,null
rancher/bad-ingress-scanner,319,2023/11/15,19,4,0,0,0,23
astronomerinc/ap-nats-streaming,0.25.5-1,2023/11/08,0,0,5,0,0,5
pachyderm/label-studio-ci-testing,92081111f606b30014cf163da9d26f19513dd987,2023/09/22,189,299,24,0,0,512
airbyte/source-db2,0.1.20,2023/06/20,61,181,132,2,0,376
docker/ucp-compose-s390x,3.1.0-beta3,2018/10/04,131,358,15,4,0,508
rancher/jetstack-cert-manager-controller,v0.8.1,2019/06/18,0,0,0,2,0,2
opensearchproject/opensearch-maps-server,1.0.0,2022/10/20,59,149,123,0,0,331
mariadb/maxscale,23.08.3,2023/11/07,null
okteto/python,3,2023/08/24,508,281,92,10,2,893
balenalib/orbitty-tx2-fedora-openjdk,8-20231106,2023/11/06,null
circleci/docker-gc,2.0.1254-7001717,2023/07/17,0,3,1,0,0,4
bellsoft/buildpacks.environment-variables,4.5.0,1980/01/01,null
intel/esp-uos-dyninit,v3.1.2,2023/08/16,2,2,7,2,0,13
balenalib/hummingboard-alpine-golang,20230904,2023/09/09,2,0,7,2,0,11
onlyoffice/4testing-ds-proxy,6.0.0,2020/10/21,621,679,43,3,0,1346
airbyte/source-chargify,0.4.0,2023/10/16,0,14,26,1,0,41
google/apigee-operators,1.8.1,2022/09/22,0,4,5,1,0,10
rancher/healthcheck,v0.3.8,2018/07/09,342,450,26,0,0,818
couchbase/sandbox,5.0.0-beta,2017/05/20,97,86,8,0,0,191
objectscale/space-reclaimer,0.71.3,2021/04/15,17,149,215,36,6,423
balenalib/artik5-alpine-golang,20220803,2022/08/04,8,39,40,12,0,99
pachyderm/datascience-notebook,fde4beb9ff1afb404f0e34828adc1f311f4bf2d7,2021/10/20,115,180,41,5,0,341
greenbone/greenbone-feed-sync,v23.10.0,2023/10/23,70,14,13,1,0,98
balenalib/nitrogen6x-debian-node,18.6-20220714,2022/07/21,124,70,75,18,0,287
opensearchproject/data-prepper,2.5.0,2023/10/11,69,80,12,1,0,162
balenalib/artik533s-fedora-golang,20220714,2022/07/23,null
onlyoffice/4testing-documentserver-ee-cl,6.4.2,2022/01/06,434,1324,66,0,0,1824
onlyoffice/docspace-doceditor,1.1.4.1,2023/10/23,1004,151,215,12,0,1382
grafana/ci-build-windows,0.3.4,2022/04/19,8,26,22,2,0,58
balenalib/artik10-golang,20220714,2022/07/22,467,265,220,28,1,981
atlassian/docker-release-maker,test3,2022/03/09,7,54,67,16,0,144
grafana/jsonnet-build,1022b37,2020/03/18,0,0,0,2,0,2
percona/percona-server,8.0.34-26,2023/09/15,11,25,22,0,0,58
hashicorp/terraform-website,98965949466ebb9ac066eb14bf3118ca3230ec9e,2022/09/07,7,138,99,27,0,271
balenalib/artik710-fedora-node,20230712,2023/07/16,0,1,1,0,0,2
bitnami/kubeapps-tiller-proxy-archived,1.11.3,2020/10/21,9,28,18,1,0,56
mattermost/mm-te,97363046,2023/04/04,225,195,115,19,6,560
airbyte/destination-exasol,0.1.1,2023/02/22,65,201,179,17,0,462
bitnami/contour,1.26.1,2023/11/16,74,12,9,2,0,97
datadog/k8s-dns-exposer-controller,v0.0.1,2019/08/02,282,441,25,3,0,751
appdynamics/appdynamics-agent-config-client,23.10.0-1190,2023/10/27,0,0,4,0,0,4
tenable/terrascan_atlantis,1.18.3,2023/08/03,11,145,210,27,0,393
rancher/rancher,v2.8.0-rc3,2023/10/26,2,66,73,1,1,143
balenalib/orangepi-plus2-alpine-node,18.14.1-20231106,2023/11/07,0,1,5,0,0,6
airbyte/source-flexport,0.2.0,2023/08/23,0,15,26,1,0,42
okteto/outyet,0.0.5,2019/02/12,192,418,433,74,12,1129
nginx/docker-extension,0.0.3,2023/04/17,0,10,2,0,0,12
mariadb/columnstore,23.02.4,2023/08/03,3,22,41,0,0,66
vertica/verticadb-operator,1.11.2,2023/08/02,0,3,2,0,0,5
docker/ucp-kube-compose-api-s390x,3.1.0-beta3,2018/10/04,0,0,0,2,0,2
redislabs/fake-kubelet,arm-latest,2021/11/04,2,38,52,5,0,97
bitnami/deepspeed,0.12.3,2023/11/16,441,75,45,3,0,564
balenalib/armv7hf-debian-python,20230929,2023/10/02,111,37,35,6,0,189
launchdarkly/ld-find-code-refs,2.11.4,2023/10/16,0,0,4,0,0,4
balenalib/stem-x86-32-debian,20230904,2023/09/09,118,36,40,6,0,200
intel/esp-squid,v3.1.2,2023/07/25,null
bitnami/promtail,2.9.2,2023/11/09,74,14,9,2,0,99
onlyoffice/docs-docservice-de,7.5.1-1,2023/11/09,0,2,1,1,0,4
airbyte/source-quickbooks-singer,0.1.5,2022/02/17,0,22,51,8,0,81
balenalib/raspberry-pi2-alpine-golang,20231106,2023/11/07,0,0,4,0,0,4
balenalib/rpi-debian,20231106,2023/11/07,107,34,31,4,0,176
docker/ucp-etcd,3.3.1,2020/06/26,2,26,41,1,0,70
adobecoldfusion/apimanageraddons2021,2021.0.0,2021/09/16,106,172,8,3,0,289
balenalib/qemux86-64-openjdk,20231106,2023/11/06,125,43,31,4,0,203
balena/amd64-supervisor-node,1244-update-lock-weirdness,2020/03/31,717,611,603,76,9,2016
balenalib/generic-armv7ahf-golang,20230904,2023/09/09,442,111,73,9,0,635
mirantis/cnigenie,v1.0-124-ge4298f1,2018/05/28,null
airbyte/source-the-guardian-api,0.1.0,2022/11/09,0,17,27,1,0,45
mattermost/ops-tool,v0.0.3,2022/08/19,90,57,49,12,0,208
datadog/agent-dev-arm64,6.15.1,2019/11/26,101,64,79,20,6,270
balenalib/beaglebone-green-python,20230911,2023/09/11,118,37,40,6,0,201
rancher/cert-manager-webhook-arm64,v0.7.2-rio.1,2019/05/15,0,0,0,2,0,2
ubuntu/bind9,9.18-23.10_edge,2023/11/16,11,2,0,0,0,13
airbyte/source-faker,5.0.0,2023/08/09,0,15,26,1,0,42
mattermost/mattermost-cloud,9839667,2022/12/09,7,43,49,5,0,104
mattermost/calls-recorder,v0.5.3,2023/11/13,0,2,1,0,0,3
purestorage/pso-smartagent,v0.1.0,2020/12/02,10,24,48,6,0,88
balenalib/orangepi-plus2-openjdk,20230911,2023/09/11,129,64,44,6,0,243
google/apigee-istio-proxyv2,1.4.6,2020/02/22,650,1307,149,1,0,2107
intel/video-analytics-serving,0.7.0,2021/12/07,451,1403,66,0,0,1920
rancher/longhornio-csi-provisioner,v2.1.2,2021/04/13,0,5,13,0,4,22
bitnami/keycloak-gatekeeper-archived,10.0.0,2021/04/19,0,9,19,0,0,28
accurics/terrascan-action,1.4.1,2021/10/27,2,41,69,15,0,127
rancher/mirrored-openzipkin-zipkin,2.14.2,2019/06/15,5,42,84,31,6,168
objectscale/storageserver-manager,0.71.3,2021/04/15,14,96,116,14,6,246
couchbase/exporter,1.0.9,2023/01/27,0,1,0,0,0,1
bitnami/airflow,2.7.3,2023/11/21,225,89,47,4,0,365
kasmweb/forward-proxy,1.0.0,2023/08/08,2,0,6,2,0,10
redislabs/pcf-redis-enterprise-tester,100.0.999000971,2023/05/17,651,992,83,4,0,1730
rancher/os-debianconsole,v1.5.8,2021/02/05,60,70,226,12,8,376
balenalib/apalis-imx6q-fedora-golang,20220507,2022/05/12,null
airbyte/integration-singer-bigquery-destination,0.1.4,2020/10/07,19,63,85,16,0,183
solaceiotteam/apim-analytics-server,0.2.0,2022/06/02,2,29,30,5,0,66
rancher/external-lb,v0.3.7,2019/01/30,0,10,2,0,0,12
rancher/goharbor-clair-photon,v2.0.8-v1.7.5,2019/04/01,14,94,137,55,0,300
docker/ucp-auth-store,3.3.1,2020/06/26,2,8,7,1,0,18
rancher/webhookinator,v0.1.0,2019/05/15,4,14,6,2,0,26
balenalib/am571x-evm-openjdk,20210602,2021/06/05,230,232,145,39,8,654
jetbrains/upsource-psi,2017.1.1867,2017/04/05,106,392,512,228,30,1268
intel/inference-optimization,2023.2-py3.10,2023/09/20,156,172,22,1,0,351
puppet/puppet-agent,7.20.0,2022/12/02,30,26,2,0,0,58
balenalib/i386-nlp-openjdk,20210225,2021/04/19,242,240,159,48,10,699
balenalib/i386-ubuntu,20210705,2021/07/21,108,178,10,0,0,296
kong/blog,mockbin-traffic-mirror-v2,2022/11/11,2,17,25,4,0,48
balenalib/armv7hf-ubuntu-golang,20231026,2023/11/02,133,131,0,0,0,264
balenalib/armv7hf-ubuntu-node,20231026,2023/11/02,35,10,1,0,0,46
objectscale/objectscale-inventory,1.4.0-397.adb0726,2023/11/13,0,3,4,0,0,7
kasmweb/insomnia,1.14.0,2023/09/14,156,227,12,0,0,395
rancher/mirrored-longhornio-csi-resizer,v1.7.0,2022/12/28,0,3,3,0,0,6
rancher/mirrored-cloud-provider-vsphere-cpi-release-manager,v1.28.0,2023/08/25,0,2,4,0,0,6
balenalib/odroid-xu4-ubuntu-openjdk,11-xenial-20231026,2023/11/02,null
grafana/tanka,0.26,2023/08/08,1,9,11,1,0,22
airbyte/source-linnworks,0.1.5,2021/12/24,0,21,50,8,0,79
docker/for-desktop-kernel,41ab3c5d630f455776be4b7bbe57dcb796b5b0a2-amd64,2020/02/12,null
mirantis/kubeadm-dind-cluster,v1.12,2018/12/10,269,646,710,109,23,1757
balenalib/asus-tinker-board-s-alpine-openjdk,8-20231106,2023/11/07,0,0,4,0,0,4
balenalib/armv7hf-ubuntu,20231026,2023/11/02,34,9,0,0,0,43
onlyoffice/4testing-docspace-files,2.0.0.33,2023/11/15,1016,142,207,12,0,1377
balenalib/apalis-imx6q-fedora-node,36-build-20220714,2022/07/22,0,1,1,0,0,2
balenalib/artik530-alpine-golang,20220803,2022/08/04,8,39,40,12,0,99
accurics/siac-comms,1.3.14,2021/05/07,2,10,32,4,0,48
balenalib/beaglebone-black-alpine-node,18.14.1-20231106,2023/11/07,0,1,5,0,0,6
docker/ucp-dsinfo,3.3.1,2020/06/26,4,6,2,0,0,12
okteto/telemetry,1.5.45,2020/03/03,3,18,42,4,0,67
bitnami/mlflow,2.8.0,2023/11/15,97,13,24,7,0,141
bitnami/bitnami-shell-archived,11,2023/07/15,86,28,24,6,0,144
okteto/golang-ci,2.3.3,2023/10/26,484,195,150,14,0,843
mattermost/bifrost,5204093,2023/08/30,0,7,1,0,0,8
intel/ai-workflows,1.0-vision-tlt-disease-prediction,2023/07/11,26,36,6,1,0,69
balenalib/qemux86-64-alpine-python,20231106,2023/11/07,0,1,4,0,0,5
okteto/custom-error-pages,0.2.0,2020/02/08,2,10,29,4,0,45
objectscale/objectstore-post-upgrade,0.78.0-59.f3aae99,2021/07/20,2,16,21,0,0,39
intel/qat-crypto-base,v.0.1.0,2023/01/06,null
vmware/nsx-container-plugin-operator,v4.1.2,2023/10/23,152,32,4,0,0,188
grafana/grafana-dev,10.3.0-146415,2023/11/15,0,1,4,0,0,5
grafana/devtools-github-archive-parser,4160534dbc93f1bec6669c5a97edbbbf83cc3c52,2019/03/31,55,35,67,15,10,182
airbyte/source-adjust,0.1.0,2022/09/21,0,17,27,1,0,45
couchbase/couchbase-training,1.6,2022/08/04,49,34,2,0,0,85
balenalib/stem-x86-32,20230904,2023/09/09,118,36,40,6,0,200
balenalib/orbitty-tx2-fedora-golang,20231106,2023/11/06,null
objectscale/dks-testapp,2.71.3,2021/04/14,4,54,71,3,3,135
mattermost/mattermost-build-docker,20201023_19.03.12,2020/10/23,15,53,150,16,0,234
cockroachdb/cockroach-premier,v1.1.4-early,2017/12/12,42,55,67,11,19,194
rancher/mirrored-paketobuildpacks-builder,0.2.443-full,1980/01/01,0,196,98,0,0,294
balenalib/odroid-c1-fedora-openjdk,30-20210825,2021/09/03,null
balenalib/artik10-debian-golang,20220714,2022/07/22,467,265,220,28,1,981
intel/pmem-csi-driver-test,v1.1.0,2022/12/19,92,35,45,3,3,178
pachyderm/object-detection,fix4,2017/09/07,581,968,203,17,0,1769
bitnami/kubectl,1.28.3,2023/11/08,94,13,23,3,0,133
pachyderm/grpc-proxy,0.4.10,2019/10/04,536,1452,1164,241,14,3407
airbyte/source-lever-hiring,0.2.0,2023/05/29,0,15,27,1,0,43
intel/intel-ethernet-operator-bundle,v1.0.0,2023/07/26,null
astronomerinc/ap-fluentd,1.16.2-2,2023/11/08,12,2,0,0,0,14
balenalib/i386-debian-python,20231106,2023/11/06,107,21,23,4,0,155
rancher/longhorn-engine,6482810,2019/03/20,138,262,18,0,0,418
balenalib/artik533s-alpine,20220803,2022/08/03,7,37,35,10,0,89
airbyte/source-coingecko-coins,0.1.0,2022/11/18,0,17,27,1,0,45
couchbase/qe-mobile-greenboard,cbl_dev,2020/12/09,3,43,46,11,0,103
balenalib/via-vab820-quad-debian-openjdk,20210602,2021/06/05,230,232,145,39,8,654
intel/intel-optimized-tensorflow-avx512,2.11.0,2023/01/19,66,64,10,0,0,140
datadog/dd-apm-demo,ruby-2.7,2021/01/07,1790,1470,1345,161,45,4811
appdynamics/java-agent,23.10.0.35234,2023/10/30,0,0,4,0,0,4
bitnami/mediawiki,1.40.1,2023/10/11,149,82,56,4,2,293
rancher/cert-manager-cainjector,v0.11.0-rio.1,2019/10/22,0,0,0,0,6,6
onlyoffice/4testing-docspace-wait-bin-share,2.0.0.33,2023/10/18,null
datadog/agent-buildimages-suse_x64,v20433308-6861270,2023/09/25,3,24,21,1,0,49
balenalib/beaglebone-green-ubuntu-openjdk,11-xenial-20230911,2023/09/12,null
balenalib/artik10-fedora-node,36-build-20220803,2022/08/04,0,1,1,0,0,2
portainer/portainer-k8s-beta,linux-arm,2020/06/18,5,20,20,0,0,45
circleci/cci-demo-rails,711886c622bcf505c20c7f4148f4e5108297eb74,2016/12/21,504,2530,1614,395,72,5115
kasmweb/chrome,1.14.0,2023/09/14,187,380,0,0,0,567
mirantis/ucp-csi-provisioner,3.5.3,2022/04/05,0,0,0,0,6,6
bitnami/metrics-server,0.6.4,2023/11/08,74,15,12,2,0,103
rapidfort/postgresql,16.0,2023/11/09,33,10,4,1,0,48
airbyte/source-zendesk-sell,0.2.0,2023/10/24,0,13,26,1,0,40
pachyderm/postgresql,13.3.0,2022/02/11,181,109,104,32,6,432
ambassador/telepresence-docker-desktop-runtime,0.0.8-alpha.2,2022/04/13,16,90,78,10,0,194
balenalib/qemux86-64-golang,20231103,2023/11/05,436,83,52,5,0,576
mathworks/polyspace-deps,R2023b-ubuntu22.04,2023/11/20,44,30,0,0,0,74
balenalib/beaglebone-black-debian,20230911,2023/09/11,118,36,40,6,0,200
intel/power-operator_ocp-4.13,v2.3.1,2023/08/29,30,29,8,0,0,67
bitnami/google-cloud-sdk,0.455.0,2023/11/16,77,14,11,2,0,104
balenalib/apalis-imx6q-ubuntu,20220714,2022/08/02,87,82,11,0,0,180
airbyte/source-public-apis,0.2.0,2023/08/29,0,15,26,1,0,42
onlyoffice/docspace-clear-events,1.1.4.1,2023/10/23,1016,143,210,12,0,1381
intel/ai-tools,tlt-0.5.0,2023/07/06,26,36,5,1,0,68
mongodb/mongodb-atlas-search,preview-20231024T105931Z,2023/10/24,59,288,123,1,0,471
apachepinot/eks-nvme-ssd-provisioner,v1.0.1,2023/02/01,0,4,11,0,0,15
objectscale/objectscale-manager-pre-update-debug,0.61.0-7.da2bf03,2020/12/15,0,6,10,0,0,16
rancher/rio,v0.0.4-r6,2019/02/21,0,0,0,2,0,2
atlassian/pipelines-kubernetes-namespace-expiry,stg-stable,2019/11/07,114,129,133,38,8,422
balenalib/colibri-imx6dl-alpine-openjdk,8-3.14-20220112,2022/01/19,2,50,42,13,0,107
balenalib/fincm3,20230904,2023/09/09,118,36,40,6,0,200
bitnami/fluentd-exporter-archived,0.2.0,2022/06/19,94,63,57,18,0,232
airbyte/source-pardot,0.1.1,2022/12/15,0,16,27,1,0,44
bitnami/codeigniter,4.4.3,2023/10/27,154,84,54,5,2,299
jetbrains/upsource-proxy,2020.1.1992,2022/03/11,140,492,423,84,56,1195
balenalib/parallella-alpine,20230904,2023/09/09,2,0,7,2,0,11
mattermost/testwick,test2,2022/10/14,1,19,18,1,0,39
airbyte/source-rocket-chat,0.1.0,2022/11/13,0,17,27,1,0,45
grafana/grafana-oss,10.2.1,2023/11/14,0,1,5,0,0,6
vmware/photon-2.0-calico-node,v2.6.7-20180619,2018/06/19,17,87,106,59,0,269
vmware/dch-photon,18.06,2021/10/18,7,35,50,24,0,116
okteto/docker-desktop-extension,0.3.3,2022/11/09,79,83,84,6,0,252
greenbone/gsad,22.8,2023/11/14,94,17,16,2,0,129
kasmweb/kasm-guac,1.14.0,2023/08/19,130,231,19,1,0,381
couchbase/server,7.2.3,2023/11/09,21,6,0,0,0,27
docker/tilt-ctlptl,v0.8.22,2023/09/01,86,25,13,3,0,127
balenalib/bananapi-m1-plus-ubuntu-python,20231026,2023/11/02,37,10,0,0,0,47
docker/ucp-interlock-extension,3.3.1,2020/06/26,2,14,19,1,0,36
intel/intel-ethernet-operator-manager,v1.0.0,2023/07/26,4,15,5,0,0,24
bitnami/flink,1.18.0,2023/11/16,84,18,16,4,0,122
rancher/opni-payload-receiver-service,v0.5.4,2022/07/26,8,72,71,4,11,166
airbyte/source-ashby,0.1.0,2022/10/28,0,17,27,1,0,45
okteto/agent,1.0,2018/07/04,0,1,4,3,0,8
intel/intel-optimized-nginx,qatsw-src,2023/03/22,81,113,5,0,0,199
airbyte/source-azure-table,0.1.3,2022/10/18,0,17,27,1,0,45
appdynamics/dynamic-agent-ma,20.5.1.1,2020/06/01,819,137,384,30,6,1376
portainer/portainer-ce,2.19.2,2023/11/12,0,16,12,0,0,28
balenalib/orbitty-tx2-ubuntu,20231103,2023/11/06,37,9,0,0,0,46
balenalib/beaglebone-green-wifi-alpine-node,18.14.1-20231106,2023/11/07,0,1,5,0,0,6
objectscale/fedsvc,0.71.3,2021/04/14,9,102,121,20,3,255
airbyte/destination-redpanda,0.1.0,2022/11/14,60,182,146,2,0,390
balena/386-balena-multibuild-scripts,0.1.0,2019/10/01,4,14,9,1,0,28
docker/ucp-kube-gmsa-webhook,3.3.1,2019/07/17,null
bitnami/pushgateway,1.6.2,2023/11/09,74,14,9,2,0,99
balenalib/orbitty-tx2-debian-golang,20231106,2023/11/07,436,82,52,5,0,575
rancher/terraform-controller,v0.0.13-alpha1,2020/11/19,10,39,80,13,0,142
dynatrace/easytravel-headless-loadgen,2.0.0.3599,2023/08/04,205,117,95,15,0,432
balenalib/odroid-c1-fedora-python,20220622,2022/07/12,0,1,1,0,0,2
vmware/labs-service-bindings-manager,0.9.0,0001/01/01,null
jetbrains/datalore-postgres,2023.5.1,1970/01/01,112,40,37,2,0,191
balenalib/beaglebone-green-fedora-python,20220928,2022/10/04,0,1,1,0,0,2
objectscale/provision,0.71.3,2021/04/08,0,6,4,0,0,10
percona/percona-everest,v0.4.0,2023/11/01,0,2,1,0,0,3
puppet/kubetool,8.0.0,2023/07/13,1,26,44,1,0,72
adobecoldfusion/apimanager2023,2023.0.0,2023/05/17,40,92,99,40,0,271
onlyoffice/box-auth,1.0.1,2023/09/12,0,4,8,0,0,12
intel/sigopt-controller,2022-11-09a,2022/11/09,3,24,26,1,0,54
rancher/ecm-distro-tools,v0.23.0,2023/10/03,3,29,31,0,2,65
ddosify/selfhosted_frontend,2.4.1,2023/11/01,2,31,38,6,0,77
rancher/rke2-cloud-provider,v1.28.2-build20231016-s390x,2023/10/17,0,3,10,0,2,15
grafana/cortex-distributor,w37-0193e7b7,2018/09/11,0,0,0,2,0,2
airbyte/destination-vertica,0.1.0,2023/05/31,65,199,176,17,0,457
appdynamics/machine-agent-arm64,23.10.0,2023/10/30,94,29,6,1,0,130
balenalib/qemux86-64-ubuntu-golang,20230911,2023/09/11,147,146,23,0,0,316
grafana/cortex-lite,w37-0193e7b7,2018/09/11,0,0,0,2,0,2
rancher/haproxy-tomcat,v0.0.1,2016/06/17,0,27,24,10,0,61
rancher/mirrored-prom-alertmanager,v0.21.0,2020/06/17,0,12,26,0,0,38
balenalib/amd64-fedora-node,20231103,2023/11/04,0,1,1,0,0,2
docker/dtr-api-s390x,2.5.0-beta3,2018/01/17,3,56,103,50,0,212
balenalib/i386-alpine-golang,20230911,2023/09/11,2,0,7,2,0,11
bitnami/kiam,4.2.0,2023/11/08,78,17,20,2,0,117
launchdarkly/ld-relay,8.2.0,2023/10/24,0,1,5,0,0,6
mathworks/matlab-deep-learning,r2023b,2023/10/27,194,206,9,0,0,409
mirantis/phpldapadmin,v0.6.12-1,2018/04/10,67,219,256,125,35,702
rancher/drone-images,runner-amd64-2004,2020/07/13,3,15,18,0,0,36
okteto/movies-api,okteto,2020/04/15,512,1385,1102,223,12,3234
google/apigee-hybrid-cassandra-client,1.8.1,2022/07/07,9,30,42,4,4,89
docker/ucp-istio-proxyv2,3.3.1,2020/06/26,471,1159,140,1,0,1771
okteto/statuspage,dev,2020/03/31,514,1479,1225,247,12,3477
balena/armv7hf-supervisor-node,1244-update-lock-weirdness,2020/04/02,717,606,593,76,9,2001
okteto/helm-chart-manager,1.1.1,2020/01/08,13,42,65,9,0,129
rancher/systemd-node,v0.0.5-rc2,2023/06/08,6,27,31,0,2,66
airbyte/destination-e2e-test,0.3.0,2023/05/15,61,180,131,2,0,374
amazon/amazon-eks-pod-identity-webhook,4580826,2023/05/18,0,2,4,0,0,6
rancher/mirrored-kube-vip-kube-vip-iptables,v0.6.0,2023/05/15,0,13,12,0,0,25
objectscale/objectscale-license-usage,1.4.0-397.adb0726,2023/11/13,0,3,4,0,0,7
rancher/gke-operator,v2.0.1-rc2,2021/05/20,91,185,31,0,0,307
circleci/cci-demo-docker,0.1.68,2017/05/15,0,1,5,2,0,8
bitnami/mxnet,1.9.1,2023/10/11,601,188,83,10,2,884
okteto/clean,0.1.6,2021/02/16,0,1,0,0,0,1
redislabs/service-broker,968fa1a,2018/03/20,205,488,516,126,15,1350
airbyte/source-getlago,0.3.0,2023/10/17,0,14,26,1,0,41
dynatrace/dynatrace-codemodules,1.277.165.20231024-150054,2023/10/25,null
kasmweb/centos-7-desktop,1.14.0,2023/09/14,1383,1392,95,4,2,2876
objectscale/metering,0.71.3,2021/04/15,17,149,215,36,6,423
docker/ucp-auth-s390x,3.1.0-beta3,2018/10/04,0,2,6,16,0,24
airbyte/normalization-duckdb,0.4.3,2023/05/12,486,380,330,49,2,1247
balenalib/armv7hf-ubuntu-openjdk,11-xenial-20231026,2023/11/02,null
jetbrains/upsource-psi-agent,2020.1.1992,2022/03/11,79,148,245,95,0,567
airbyte/source-stripe-singer,0.2.1,2021/04/03,143,93,111,34,7,388
solaceiotteam/apim-demo-portal,0.1.20,2021/11/03,139,231,34,4,0,408
grafana/grafana-plugin-ci-e2e,1.9.7,2023/11/07,767,199,168,8,0,1142
circleci/clojure,tools-deps-1.11.1.1113-buster-node,2022/05/01,669,219,302,63,13,1266
rancher/mirrored-istio-proxyv2,1.19.0,2023/09/01,29,13,6,0,0,48
dynatrace/oneagent,1.129.145,2017/10/17,747,748,77,3,0,1575
appdynamics/ad-air-web-api,java,2021/01/15,106,103,92,32,0,333
greenbone/pheme,21.8.1,2023/11/14,107,36,43,6,0,192
objectscale/kahm-testapp,v2.74.0,2021/05/25,4,53,70,3,3,133
balenalib/up-board-alpine-node,20231106,2023/11/07,0,1,5,0,0,6
jetbrains/upsource-analyzer,2020.1.1992,2022/03/11,142,197,320,113,1,773
hashicorp/consul-api-gateway,0.5.5,2023/09/07,1,12,16,0,0,29
airbyte/source-postgres-strict-encrypt,3.1.13,2023/10/13,6,49,61,17,0,133
balenalib/jetson-tx2-python,20231106,2023/11/07,114,21,29,4,0,168
okteto/ruby,2,2023/08/24,770,451,307,21,2,1551
newrelic/synthetics-node-browser-runtime,2.0.35,2023/10/02,138,193,10,0,0,341
cimg/mariadb,11.2.1,2023/10/12,294,339,48,0,0,681
okteto/golang-middleware-template,0.1.1,2020/06/01,706,537,508,64,9,1824
google/apigee-connect-agent,1.8.1,2022/07/20,0,4,6,0,0,10
rancher/image-build-crictl,v1.17.0-amd64,2020/08/19,261,420,37,3,0,721
intel/oneapi-runtime,2023.2-devel-ubuntu22.04,2023/07/14,186,177,39,0,0,402
vmware/vke-imagetest,1.1,2019/01/26,854,1336,86,3,0,2279
balenalib/aarch64-debian-python,20231106,2023/11/07,107,21,23,4,0,155
cimg/azure,2023.09.1,2023/09/25,294,340,51,0,0,685
vmware/sources-for-knative-controller,v0.29.0,1970/01/01,0,4,7,0,0,11
docker/ucp-kube-dns-sidecar-s390x,3.1.0-beta3,2018/10/04,0,0,0,2,0,2
intel/image-recognition,tf-2.7.0-resnet101-int8-inference,2021/12/15,93,158,12,0,0,263
rancher/opa-gatekeeper,v3.1.0-rc.1,2020/08/14,0,8,14,0,6,28
docker/ucp-azure-ip-allocator-s390x,3.1.0-beta3,2018/10/04,0,0,6,16,0,22
balenalib/artik530-python,20220714,2022/07/22,124,69,76,18,0,287
solaceiotteam/solace-axway-agent,0.0.21,2022/05/10,0,12,11,1,0,24
objectscale/chunk-manager,0.71.3,2021/04/15,17,149,215,36,6,423
okteto/desk,0.1.6,2019/09/06,698,1020,73,0,0,1791
airbyte/source-amplitude,0.3.6,2023/10/24,64,21,8,1,0,94
balenalib/odroid-c1-fedora-golang,20220507,2022/05/12,null
airbyte/custom-transformation-prep,1.0,2023/05/12,486,380,330,49,2,1247
kasmweb/core-fedora-38,1.14.0,2023/09/09,null
bitnami/suitecrm,8.4.2,2023/11/14,151,111,58,7,2,329
rancher/hardened-sriov-network-operator,14bd335c17c1b4c6cb7d37c2972c05cc62cadeeb-build20211119,2021/11/19,241,323,29,3,0,596
balenalib/via-vab820-quad-fedora-node,36-build-20220714,2022/07/22,0,1,1,0,0,2
balenalib/zynq-xz702-fedora-openjdk,30-20210825,2021/09/03,null
airbyte/source-oracle-strict-encrypt,0.4.0,2023/06/29,61,181,132,2,0,376
pachyderm/splitcombine,0.0.2,2023/03/28,null
kasmweb/tracelabs,1.14.0,2023/09/14,4,73,82,16,0,175
balenalib/orangepi-plus2-fedora-golang,20221210,2022/12/13,null
circleci/logging-collector,3.0,2023/11/09,null
mattermost/webrtc,4.4,2017/11/30,458,713,56,1,0,1228
balenalib/odroid-xu4-fedora,20221210,2022/12/12,null
objectscale/decks-pre-update,2.78.0-221.79a9cc6,2021/07/20,2,16,21,0,0,39
intel/intel-ethernet-operator-flowconfig-daemon,v1.0.0,2023/07/19,4,15,5,0,0,24
rancher/directxman12-k8s-prometheus-adapter-amd64,v0.7.0,2020/04/17,null
intel/intel-optimized-ffmpeg,avx3-src,2023/08/31,156,164,21,0,0,341
lacework/azure-cfg-cli,v1.0,2018/12/03,881,1729,96,1,0,2707
kasmweb/doom,1.14.0,2023/09/14,187,381,0,0,0,568
amazon/aws-sam-cli-emulation-image-nodejs14.x,20220125,2022/01/25,1,54,21,3,0,79
docker/dtr-notary-server,2.8.1,2020/06/17,2,9,8,1,0,20
balenalib/intel-nuc-fedora-openjdk,8-20231103,2023/11/04,null
balenalib/artik533s-alpine-python,20220803,2022/08/04,7,38,37,10,0,92
balenalib/orbitty-tx2-node,20231106,2023/11/07,114,22,30,4,0,170
onlyoffice/docs-utils,7.5.1-1,2023/11/09,2,2,6,0,0,10
dynatrace/dynatrace-gcp-function,v1-latest,2023/02/02,103,48,44,3,3,201
balenalib/armv7hf,20230929,2023/10/02,111,36,35,6,0,188
bitnami/pymilvus,2.3.3,2023/11/16,77,12,9,2,0,100
balenalib/am571x-evm-ubuntu-golang,20220523,2022/06/03,222,536,46,0,0,804
intel/object-detection,tf-2.7.0-ssd-resnet34-int8-inference,2021/12/15,302,754,75,2,0,1133
cockroachdb/movr,21.1.1,2021/05/26,1441,1309,916,142,39,3847
balenalib/apalis-imx6q-openjdk,20210602,2021/06/05,230,232,145,39,8,654
balenalib/intel-nuc-ubuntu-python,20230911,2023/09/11,42,11,4,0,0,57
kasmweb/oracle-9-desktop,1.14.0,2023/09/14,16,156,944,0,0,1116
rancher/os-dind,18.03.1,2018/12/12,0,23,0,2,0,25
hashicorp/http-echo,1.0,2023/10/10,null
bitnami/mariadb,11.1.3,2023/11/15,74,15,9,2,0,100
pachyderm/example-wordcount,2.0.3,2022/02/18,490,361,316,60,2,1229
circleci/vm-service-lite,1.0.117-440460b,2023/01/26,1,9,17,1,0,28
rancher/harvester-node-disk-manager,v0.5.2,2023/11/20,null
circleci/jruby,9.3.3.0,2022/02/22,300,384,361,66,2,1113
docker/desktop-kubernetes,v1.15.4,2019/09/23,null
vmware/photon-build,rpm-ostree-3.0,2019/08/27,26,156,178,64,0,424
docker/ucp-calico-node,3.3.1,2020/06/26,131,309,37,0,0,477
rancher/hardened-k8s-metrics-server,v0.3.7,2020/09/25,258,400,18,3,0,679
balenalib/odroid-c1-alpine-golang,20220714,2022/07/27,8,39,40,12,0,99
balenalib/hummingboard-alpine-node,18.14.1-20230904,2023/09/09,2,1,8,2,0,13
docker/cnab-app-base,v0.9.1-beta3,2020/04/24,2,10,29,4,0,45
airbyte/source-zapier-supported-storage,0.1.0,2022/11/07,0,17,27,1,0,45
docker/ucp-calico-kube-controllers,3.3.1,2020/05/28,null
airbyte/source-courier,0.1.0,2022/10/19,0,17,27,1,0,45
balenalib/imx6ul-var-dart-debian-golang,20230911,2023/09/12,442,111,73,9,0,635
lacework/lacework-inline-scanner,0.23.2,2023/11/10,0,10,12,0,0,22
rancher/os-base,3929481,2017/02/03,null
kumahq/kuma-cni,2.4.4,2023/11/06,7,2,1,0,0,10
jetbrains/datalore-sql-session,2023.3.1,1970/01/01,68,105,7,0,0,180
balena/i386-nlp-supervisor-node,1244-update-lock-weirdness,2020/03/31,122,188,178,22,2,512
astronomerinc/ap-commander,0.33.6,2023/11/09,0,13,3,0,0,16
bitnami/jsonnet,0.20.0,2023/11/15,72,12,7,2,0,93
airbyte/destination-firestore,0.1.1,2021/11/21,0,22,53,8,0,83
docker/for-desktop-qemu,39146321ff4b36f97116053ff277fc87eb664aee-arm64,2021/05/04,null
ubuntu/dotnet-runtime,7.0_beta,2023/11/01,null
balenalib/generic-armv7ahf-fedora,20221210,2022/12/12,null
okteto/deno,1.9,2021/04/19,94,35,49,16,6,200
airbyte/source-coin-api,0.1.1,2023/01/05,0,16,27,1,0,44
okteto/golang,2,2020/04/28,708,562,533,65,9,1877
rancher/swarm-agent,v0.1.3,2016/07/13,49,14,4,0,0,67
airbyte/source-paypal-transaction,2.2.0,2023/10/26,64,21,8,1,0,94
bitnami/percona-xtrabackup,8.0.34-29,2023/11/15,79,13,13,3,0,108
bellsoft/buildpacks.java,1.0.0,1980/01/01,0,4,2,0,0,6
kong/ubi-kumactl,2.4.4,2023/11/06,31,26,8,0,0,65
balenalib/i386-nlp-ubuntu,20210225,2021/03/11,121,246,16,0,0,383
graphcore/pytorch-early-access,3.3.0-EA.1-ubuntu-20.04-20230504,2023/05/04,188,301,35,0,0,524
snyk/snyk-operator-index,1.40.3-pre6,2021/01/22,5,24,55,4,0,88
cockroachdb/cockroach-operator-unstable,v1.0.0-alpha.2,1970/01/01,null
newrelic/synthetics-job-manager,release-310,2023/11/02,34,14,0,1,0,49
rancher/os-qemuguestagent,v2.8.1-2,2019/01/22,77,62,71,11,11,232
vmware/restreview-db,V1,2017/10/31,101,225,318,118,13,775
puppet/puppet-bolt,3.27.4,2023/10/06,26,14,2,0,0,42
balenalib/kitra520-ubuntu-python,20220715,2022/08/02,87,83,13,0,0,183
balenalib/aarch64-debian,20231106,2023/11/07,107,20,23,4,0,154
kong/gateway-operator,20231115,2023/11/15,null
rancher/mirrored-minio-minio,RELEASE.2023-07-07T07-13-57Z-s390x,2023/07/07,76,46,7,0,0,129
objectscale/atlas-operator,0.69.0,2021/02/23,0,4,12,0,0,16
rancher/mirrored-flannel-flannel,v0.23.0,2023/10/30,0,0,2,0,0,2
balenalib/artik10-debian,20220714,2022/07/22,124,68,74,18,0,284
airbyte/source-configcat,0.1.0,2022/11/10,0,17,27,1,0,45
rancher/nginx-ingress-controller-defaultbackend,1.4,2017/10/24,null
grafana/grafana-enterprise-dev,10.3.0-63461,2023/11/15,0,1,4,0,0,5
balenalib/parallella-alpine-openjdk,8-20230904,2023/09/09,8,8,8,2,0,26
rancher/hardened-sriov-network-webhook,14bd335c17c1b4c6cb7d37c2972c05cc62cadeeb-build20211119,2021/11/19,241,322,27,3,0,593
grafana/fake-data-gen,1167815,2022/06/28,2,38,29,7,0,76
balenalib/raspberrypi3-debian-golang,20230530,2023/06/27,379,57,48,8,0,492
pingidentity/pingdirectoryproxy,2310,2023/11/01,3,13,8,0,0,24
mirantis/python-operations-api,comment-auth,2018/10/31,60,62,104,29,11,266
ambassador/telepresence-docker-runtime,1.0.19,2023/11/14,0,0,4,0,0,4
airbyte/source-search-metrics,0.1.1,2021/12/22,0,21,50,8,0,79
balenalib/kitra710-debian-openjdk,20230502,2023/05/06,143,80,50,6,0,279
rancher/grafana-grafana-image-renderer,2.0.0,2020/05/16,5,247,349,39,3,643
okteto/bin,1.24-rc1,2020/08/24,0,7,15,0,0,22
rancher/pipeline-kube-apply,v0.2.0,2018/07/23,0,2,1,0,0,3
objectscale/crunchy-upgrade,ubi8-5.1.2-0,2022/07/05,255,175,42,0,0,472
pingidentity/pingfederate,2310,2023/11/01,3,43,44,4,0,94
balenalib/aarch64-debian-node,20231106,2023/11/07,107,22,24,4,0,157
vmware/photon-2.0-kube-scheduler-amd64,v1.10.2-20180619,2018/06/19,15,81,98,70,0,264
kumahq/kuma-demo,latest-arm64,2022/05/26,0,13,12,1,0,26
kasmweb/ubuntu-focal-desktop-vpn,x86_64-develop,2023/11/17,241,420,0,0,0,661
pachyderm/split-loadtest-pipeline,20191119.0802,2019/11/19,null
balenalib/stem-x86-32-ubuntu-golang,1.20.1-xenial-20230904,2023/09/09,null
airbyte/source-open-exchange-rates,0.2.0,2023/10/23,0,13,26,1,0,40
cockroachdb/interop-demo,1.1,2017/04/24,null
tenable/tcs,2.7.0,2023/10/25,163,61,31,2,0,257
bitnami/gitlab-runner-helper,16.5.0,2023/11/08,109,19,30,5,0,163
kumahq/kumactl,2.4.4,2023/11/06,7,2,2,0,0,11
balenalib/beaglebone-black,20230911,2023/09/11,118,36,40,6,0,200
onlyoffice/4testing-docs-example,99.99.99.2945,2022/05/15,1403,1071,732,73,37,3316
kasmweb/minetest,1.14.0,2023/09/14,189,382,0,0,0,571
datadog/agent-dev-amd64,6.15.1,2019/11/27,101,64,79,20,6,270
bitnami/wavefront-hpa-adapter-archived,0.9.10,2023/05/21,0,3,5,0,0,8
okteto/example-react-api,devops,2019/02/27,405,1134,814,210,50,2613
appdynamics/appdynamics-smartagent,23.10.0-1190,2023/10/27,0,3,6,0,0,9
balenalib/i386-nlp-debian-golang,1.11.13-20200529,2021/04/12,657,403,359,53,9,1481
balenalib/nitrogen6x-fedora-golang,20220507,2022/05/12,null
ubuntu/zookeeper,3.1-22.04_edge,2023/07/06,33,39,11,5,0,88
balenalib/odroid-xu4-debian,20230911,2023/09/11,118,36,40,6,0,200
astronomerinc/ap-auth-sidecar,1.25.2-2,2023/11/07,0,0,2,0,0,2
rancher/longhornio-csi-node-driver-registrar,v2.5.0,2022/02/03,0,4,6,0,0,10
bitnami/wavefront-kubernetes-collector,1.13.0,2023/05/21,0,2,4,0,0,6
airbyte/source-gcs,0.3.1,2023/11/13,129,37,13,2,0,181
bitnami/vault-csi-provider,1.4.1,2023/11/09,84,14,15,4,0,117
grafana/promtail,2.9.2,2023/10/25,78,13,13,2,0,106
balenalib/beaglebone-green-wifi-openjdk,20230911,2023/09/12,129,64,44,6,0,243
balenalib/artik530-debian-python,20220714,2022/07/22,124,69,76,18,0,287
docker/desktop-vpnkit-controller,v2.0,2021/05/05,0,11,16,1,0,28
rancher/istio-sidecar_injector,1.5.9,2020/08/07,405,1084,142,0,0,1631
nginxinc/nginmesh_proxy_debug,0.7.1,2018/07/24,103,144,347,68,18,680
jetbrains/youtrack,2023.2.20316,2023/11/02,83,59,42,13,0,197
airbyte/source-mailjet-sms,0.1.0,2022/10/28,0,17,27,1,0,45
rancher/etcd,v3.4.13,2020/08/26,258,416,50,3,0,727
balenalib/rpi-alpine-node,18.14.1-20231026,2023/11/01,0,1,5,0,0,6
vmware/vsphere-block-csi-driver,v1.0.0,2019/08/16,14,63,70,30,0,177
okteto/grafana,0.1.3,2018/10/31,77,85,155,42,12,371
intel/gpu-extender,0.5.4,2023/08/14,0,1,1,0,0,2
objectscale/pgpool,4.2.2-debian-10-r38,2021/03/29,139,95,110,27,6,377
rancher/runc,v1.0.0-rc10,2020/08/11,258,400,18,3,0,679
pachyderm/gpt-2-example,v7,2020/06/19,707,1019,163,7,0,1896
vmware/dind-sshuttle-ci,dev,2018/06/12,3,61,26,30,0,120
kasmweb/brave,1.14.0,2023/09/14,187,380,0,0,0,567
vmware/lightwave-photon-testware,2.0.5,2018/12/20,64,389,487,144,0,1084
rancher/pod-setup,v0.1.0,2017/09/22,null
bitnami/kubeapps-chartsvc-archived,1.10.0,2020/04/01,null
vmware/veba-event-router,76088920,2020/10/20,74,60,12,0,0,146
balenalib/stem-x86-32-ubuntu-node,10.23.1-20210201,2021/07/27,106,185,26,3,0,320
intel/oneapi-vtune,2023.2-devel-ubuntu22.04,2023/07/14,186,177,39,0,0,402
balenalib/spacely-tx2-openjdk,20231106,2023/11/07,125,43,31,4,0,203
airbyte/source-bigquery,0.3.0,2023/06/29,61,180,131,2,0,374
pachyderm/ide-user,2.0.0-b6,2021/11/01,115,181,43,5,0,344
qualys/qcs-sensor,1.29.0-0,2023/09/29,0,25,11,0,0,36
mattermost/chaos-mesh,v0.0.5,2021/10/20,1,20,43,2,0,66
balenalib/orbitty-tx2-alpine-python,20231106,2023/11/06,0,1,4,0,0,5
balenalib/aarch64-alpine-golang,20231106,2023/11/06,0,0,4,0,0,4
cockroachdb/cockroach-operator,v2.12.0,2023/10/23,76,34,12,0,0,122
rancher/cluster-proportional-autoscaler,1.8.1,2020/06/11,0,0,0,0,6,6
pachyderm/dash,1.9.0,2019/06/11,69,66,106,39,9,289
objectscale/fluent-bit,0.33.0,2018/11/10,59,57,77,17,5,215
balenalib/apalis-imx6q-fedora-openjdk,30-20210825,2021/09/03,null
couchbase/centos-72-java-sdk,20170613,2017/07/06,714,886,133,14,0,1747
bitnami/dataplatform-emitter-archived,1.0.1,2022/05/04,4,21,16,0,0,41
balenalib/aarch64-alpine-node,20231106,2023/11/06,0,1,5,0,0,6
balenalib/colibri-imx6dl-ubuntu-golang,20220523,2022/06/03,222,536,46,0,0,804
circleci/ruby,3.0.3,2021/12/18,842,1026,788,101,5,2762
objectscale/csi-provisioner,v3.1.0,2022/01/12,0,4,9,0,0,13
rancher/longhornio-longhorn-manager,v1.3.1,2022/08/11,9,75,74,3,12,173
balenalib/raspberry-pi2-alpine-openjdk,8-20231106,2023/11/07,0,0,4,0,0,4
balenalib/beaglebone-green-alpine-node,18.14.1-20231106,2023/11/07,0,1,5,0,0,6
adobecoldfusion/coldfusionaddons2018,2018.0.1,2022/12/02,315,644,196,84,0,1239
onlyoffice/telegram_bugzilla_notifications,v0.3.0-244-g6a39b37,2023/11/09,0,1,4,0,0,5
rapidfort/ghost,5.52,2023/06/20,55,48,26,7,0,136
airbyte/source-onesignal,1.1.0,2023/08/31,0,15,26,1,0,42
balenalib/bananapi-m1-plus-debian-openjdk,20230904,2023/09/09,129,64,44,6,0,243
bitnami/apisix-ingress-controller,1.7.0,2023/11/08,74,15,11,2,0,102
intel/smart-city_grafana,2021.4.2,2021/12/14,5,31,66,9,0,111
balenalib/odroid-xu4-alpine-python,20231106,2023/11/07,0,1,4,0,0,5
balenalib/beaglebone-green-wifi-debian-openjdk,20230911,2023/09/12,129,64,44,6,0,243
pachyderm/worker,2.8.0-rc.2,2023/11/13,1,7,8,0,0,16
rapidfort/yugabyte,2.17.3.0-b152,2023/05/04,0,7,18,1,0,26
balenalib/rpi-debian-openjdk,8-20190705,2019/07/06,155,187,175,34,12,563
rancher/nginx,1.14.2,2019/03/26,43,55,81,31,7,217
objectscale/kahm-pre-update,2.78.0-167.d216af1,2021/07/20,2,16,21,0,0,39
grafana/kubernetes-diff-logger,0.0.5,2021/06/28,0,13,40,4,0,57
bitnami/harbor-adapter-trivy,2.9.1,2023/11/10,74,13,8,2,0,97
vmware/photon,1.0-20180621,2018/06/21,8,55,68,40,0,171
vmware/notary-server-photon,v0.5.1-v1.5.2,2018/07/18,8,54,72,36,0,170
balenalib/raspberrypi3-fedora-openjdk,8-20221031,2022/11/04,null
balenalib/orbitty-tx2-fedora-python,20231106,2023/11/06,null
bitnami/contour-operator-archived,1.24.0,2023/05/15,0,2,3,0,0,5
rancher/external-dns,v0.7.12,2018/08/09,0,7,0,0,0,7
balenalib/artik533s-ubuntu-python,20220715,2022/08/02,87,83,13,0,0,183
grafana/cortex-jsonnet-build-image,3527936,2021/06/22,3,28,59,17,0,107
airbyte/source-microsoft-teams,0.2.5,2021/12/16,3,22,52,8,0,85
portainer/portainer-updater,latest-windows-amd64,2023/03/26,0,11,7,0,0,18
balena/balena-mdns-publisher,1.27.35,2023/11/13,368,103,60,6,0,537
grafana/tempo-query,2.3.0,2023/10/30,0,2,6,0,0,8
ubuntu/mimir,2.6.0-22.04,2023/10/05,22,23,14,0,0,59
astronomerinc/ap-dogstatsd,9,2023/04/03,0,0,0,1,0,1
intel/intel-sgx-initcontainer,0.28.0,2023/09/22,null
pachyderm/retail-allocation,viz-fix2,2018/02/12,0,26,19,10,0,55
balenalib/generic-aarch64-ubuntu-openjdk,11-xenial-20231103,2023/11/06,null
redislabs/olm-bundle,100.0.7-1207,2023/02/26,null
mattermost/mattermost-operator,9981920,2020/12/03,0,5,11,1,5,22
bitnami/tomcat,10.1.16,2023/11/20,75,15,9,2,0,101
onlyoffice/4testing-docs-converter-de,7.5.1-1-saas,2023/11/08,0,2,0,0,0,2
okteto/php-getting-started,1.0.1,2023/02/27,428,169,113,7,0,717
onlyoffice/confluence-cloud,1.0.1,2023/05/23,1,17,5,1,0,24
balenalib/artik710-debian-golang,20230904,2023/09/09,442,114,73,9,0,638
vmware/rsyslog-photon,8.15.0-6,2017/10/23,10,81,101,57,0,249
intel/intel-optimized-pytorch,1.12.100,2022/10/19,48,66,8,1,0,123
rancher/rancher.github.io,2018-05-01,2018/04/17,69,67,109,41,9,295
continuumio/miniconda3,23.9.0-0,2023/10/23,123,40,58,7,0,228
redislabs/redis-di-cli,v0.117.0,2023/11/02,63,16,0,0,0,79
continuumio/anaconda,2019.10,2019/10/15,219,249,328,72,10,878
balenalib/raspberry-pi2,20230911,2023/09/11,118,36,40,6,0,200
balenalib/hummingboard-fedora-python,20221109,2022/11/16,0,1,0,0,0,1
balenalib/colibri-imx6dl-fedora-node,36-build-20220714,2022/07/22,0,1,1,0,0,2
dynatrace/easytravel-backend,7.1,2018/05/11,8,44,90,67,0,209
docker/ucp-kube-compose,3.3.1,2019/11/07,4,14,9,1,0,28
cockroachdb/locality-checker,0.1,2020/04/30,7,36,86,9,0,138
kasmweb/core-remnux-bionic,1.12.0,2022/12/01,260,1054,149,26,0,1489
balenalib/colibri-imx6dl-debian,20220714,2022/07/20,124,68,74,18,0,284
airbyte/destination-xata,0.1.1,2023/06/21,0,15,27,1,0,43
balenalib/raspberry-pi2-fedora-python,20221109,2022/12/02,0,1,0,0,0,1
rancher/kine,v0.10.3,2023/09/08,0,3,9,0,0,12
adobecoldfusion/coldfusionaddons2021,2021.0.3,2022/12/02,314,645,197,84,0,1240
newrelic/k8s-events-forwarder,1.48.1,2023/11/02,0,2,2,0,0,4
airbyte/destination-dev-null,0.3.0,2023/05/16,61,180,131,2,0,374
intel/language-modeling,tf-2.7.0-bert-large-fp32-training,2021/12/15,330,805,73,0,0,1208
intel/edge_video_analytics_microservice,0.7.2,2022/07/19,310,833,46,0,0,1189
bitnami/supabase-realtime,2.25.29,2023/11/14,74,12,8,2,0,96
balenalib/artik533s-golang,20220714,2022/07/22,467,265,220,28,1,981
objectscale/ciq-upload,webdav,2020/08/03,0,9,15,0,0,24
balenalib/kitra710-python,20230829,2023/09/02,118,37,40,6,0,201
mirantis/ucp-coredns,3.7.1,2023/08/09,0,3,2,0,0,5
apachepinot/pinot-base-runtime,21-openjdk,2023/10/15,210,55,55,1,0,321
docker/dtr-etcd,v2.2.4,2016/01/13,null
kasmweb/inkscape,1.14.0,2023/09/14,192,412,0,0,0,604
astronomerinc/ap-base,3.18.4-1,2023/11/02,0,0,3,0,0,3
hashicorp/vault-benchmark,0.2,2023/08/21,0,3,6,0,0,9
balenalib/jetson-tx2-debian-node,20231106,2023/11/07,114,22,30,4,0,170
airbyte/destination-mssql,0.2.0,2023/07/27,68,191,184,17,0,460
purestorage/k8s,v6.2.3,2022/07/22,0,22,35,0,0,57
portainer/helper-templates,linux-arm64,2020/08/26,null
balenalib/orangepi-plus2-golang,20230911,2023/09/11,442,111,73,9,0,635
vmware/lightwave-toolchain-photon,2.0.4,2018/08/14,49,267,243,76,0,635
balenalib/i386-openjdk,20231106,2023/11/06,118,43,25,4,0,190
bitnami/grafana-tempo-query,2.3.0,2023/11/15,74,14,12,2,0,102
docker/dtr-nginx,2.8.1,2020/06/17,2,10,9,1,0,22
airbyte/source-emailoctopus,0.1.0,2022/11/09,0,17,27,1,0,45
objectscale/transitionsvc,3.8.1.0-25.f6d9f2a,2022/12/12,12,64,53,3,3,135
rancher/pstauffer-curl,v1.0.3,2018/07/11,0,0,6,18,0,24
bitnami/wavefront-kubernetes-collector-archived,1.13.0,2023/05/21,0,2,4,0,0,6
vertica/vertica-logger,1.0.0,2021/12/15,0,12,16,1,0,29
adobecoldfusion/apimanageraddons2023,2023.0.0,2023/05/17,37,26,8,3,0,74
airbyte/destination-keen,0.2.4,2022/08/04,76,78,66,19,0,239
balenalib/hummingboard-alpine-openjdk,8-20230904,2023/09/09,8,8,8,2,0,26
circleci/golang,1.17.5,2021/12/18,537,443,389,69,2,1440
airbyte/source-oracle,0.4.0,2023/06/29,61,181,132,2,0,376
airbyte/source-todoist,0.1.0,2023/03/23,0,14,19,0,0,33
datadog/docker-dd-agent-build-rpm-x64,20180821,2018/07/27,0,3,10,3,0,16
balenalib/armv7hf-alpine-node,18.14.1-20231106,2023/11/07,0,1,5,0,0,6
bitnami/apache,2.4.58,2023/11/16,79,15,11,2,0,107
onlyoffice/docspace-zoom-router,1.0.0,2023/09/21,83,40,15,3,2,143
rancher/scheduler,v0.8.6,2019/01/22,306,388,24,0,0,718
balenalib/bananapi-m1-plus-python,20230904,2023/09/09,118,37,40,6,0,201
balenalib/raspberry-pi2-ubuntu,20231026,2023/11/02,37,9,0,0,0,46
docker/logs-explorer-extension,0.2.5,2023/10/30,0,0,4,0,0,4
mattermost/actions-runner,2.310.2-0,2023/10/18,159,200,29,0,0,388
intel/crypto-perf,0.28.0,2023/09/22,null
mirantis/salt,saltstack-ubuntu-xenial-salt-2018.3,2018/05/11,453,660,43,0,0,1156
grafana/agentctl,v0.37.4,2023/11/06,14,6,1,0,0,21
cockroachdb/cockroach-unstable-arm64v8,v2.0.0,2018/04/05,42,53,66,11,16,188
airbyte/source-salesforce,20211201-1,2021/12/02,0,21,50,8,0,79
rancher/k3k,v0.0.0-alpha7,2023/07/03,0,10,8,3,0,21
astronomerinc/ap-pgbouncer-krb,1.17.0-9,2023/06/12,0,6,3,0,0,9
balenalib/imx6ul-var-dart-alpine-golang,20231106,2023/11/07,0,0,4,0,0,4
balenalib/colibri-imx6dl-fedora-golang,20220507,2022/05/12,null
atlassian/artifactory-sidekick,staging-linux-arm64v8,0001/01/01,0,0,2,0,0,2
mongodb/mongodb-atlas-kubernetes-operator-prerelease,1.9.1-rc0,2023/10/19,3,2,0,0,0,5
astronomerinc/ap-po-pgbouncer,22.0,2022/07/18,0,0,0,1,0,1
mirantis/ucp-compose,3.7.1,2023/09/26,32,32,11,0,0,75
bitnami/notation,1.0.1,2023/11/09,74,12,8,2,0,96
balenalib/beaglebone-green-debian-openjdk,20230911,2023/09/11,129,64,44,6,0,243
balenalib/generic-armv7ahf-debian-golang,20230904,2023/09/09,442,111,73,9,0,635
onlyoffice/docs-example-de,6.2.2.17,2021/04/27,544,491,32,3,0,1070
objectscale/qualification-tool,1.4.0-110.4493033,2023/11/06,1,14,16,1,0,32
datadog/dd-lib-java-init,v1.23.0,2023/11/09,0,0,4,0,0,4
docker/dtr-postgres,2.8.1,2020/06/17,5,30,39,4,0,78
mattermost/mattermost-cloud-database-factory,9079426,2022/07/27,1,17,24,3,0,45
amazon/aws-codebuild-local,aarch64,2023/02/10,10,134,166,3,0,313
onlyoffice/trello-server,1.0.7,2023/11/15,0,0,4,0,0,4
docker/oscalkit,0.2.0,2019/02/07,0,0,0,2,0,2
airbyte/destination-cassandra,0.1.4,2022/08/26,76,75,66,19,0,236
puppet/pipelines,527601,2019/03/25,78,100,100,29,0,307
onlyoffice/4testing-docspace-bin-share,2.0.0.33,2023/11/15,null
balenalib/orbitty-tx2-ubuntu-node,20231103,2023/11/06,38,10,1,0,0,49
mirantis/dtr-postgres,2.9.14,2023/09/28,1,12,9,0,0,22
newrelic/infrastructure-k8s-unprivileged,1.8.0-beta,2019/04/12,0,0,0,2,0,2
pachyderm/kubeflow_worker,fix7,2018/03/07,0,2,2,2,0,6
balenalib/up-board-debian,20210825,2021/09/03,176,101,96,24,6,403
bitnami/logstash-exporter-archived,7.3.0,2022/05/16,130,76,77,23,6,312
balenalib/spacely-tx2-debian-golang,20231106,2023/11/07,436,82,52,5,0,575
rapidfort/cassandra-official,4.0.11,2023/11/14,2,8,6,0,0,16
docker/scout-sbom-indexer,974152c,2023/09/27,0,3,2,0,0,5
bitnami/kapacitor,1.7.1,2023/11/08,74,14,10,2,0,100
balenalib/am571x-evm-python,20220604,2022/06/12,124,81,76,20,0,301
balenalib/generic-armv7ahf-alpine-python,20230904,2023/09/09,2,1,7,2,0,12
objectscale/targetcfg,3.9.0.0-139102.b4b5064355c,2023/05/03,2,14,11,0,0,27
balenalib/kitra520-ubuntu-node,20220715,2022/08/02,88,83,12,0,0,183
nginx/nginx-prometheus-exporter,0.11,2022/09/07,null
bitnami/wildfly,30.0.0,2023/11/20,74,15,8,2,0,99
airbyte/source-unleash,0.1.0,2023/03/08,0,16,27,1,0,44
nginxinc/nginx-s3-gateway,unprivileged-oss-20231102,2023/11/02,81,20,7,1,2,111
datadog/agent-buildimages-windows_1809_x64,v3686353-1e75137,2021/01/12,8,47,132,12,0,199
balenalib/revpi-core-3-fedora,20221031,2022/11/04,null
rancher/drone-docker-image-digests,v0.0.13,2022/01/05,4,16,46,4,0,70
onlyoffice/4testing-docspace-api-system,2.0.0.33,2023/11/15,1016,142,207,12,0,1377
ddosify/ddosify,v1.0.5,2023/07/17,0,14,11,1,0,26
snyk/driftctl,v0.40.0,2023/11/06,0,2,6,0,0,8
balenalib/jetson-tx1-alpine,20230530,2023/06/06,2,10,6,2,0,20
airbyte/source-wrike,0.2.0,2023/10/24,0,13,26,1,0,40
rancher/externalip-webhook,v1.0.1,2021/12/17,0,6,9,0,0,15
intel/user-oob-server-app-for-azure,v0.7,2022/09/06,185,457,43,0,0,685
pachyderm/example-group,2.1.0,2022/02/10,824,950,731,95,5,2605
kumahq/kuma-init,2.4.4,2023/11/06,22,9,3,0,0,34
kasmweb/core-nvidia-focal,develop-rolling,2022/05/13,497,1641,3,0,0,2141
bitnami/influxdb,2.7.4,2023/11/08,84,15,16,4,0,119
balenalib/imx6ul-var-dart-debian-python,20230911,2023/09/12,118,37,40,6,0,201
balenalib/am571x-evm-node,18.6-20220714,2022/07/21,124,70,75,18,0,287
docker/vpnkit-expose-port,07953236583a8938ef2681984c2b1441ac0a1656,2020/07/27,null
mirantis/ucp-calico-kube-controllers,3.7.1,2023/09/26,0,6,5,0,0,11
okteto/weaver,0.1.10,2023/01/17,0,5,13,0,0,18
okteto/kubelet-configurator,0.0.1,2021/03/03,130,84,86,31,7,338
kasmweb/core-kali-rolling,1.14.0,2023/09/09,null
primekey/signserver-ce,6.0.0.1,2023/11/20,8,67,37,6,0,118
puppet/lumogon,0.6.0,2018/05/23,null
vmware/vsan-prometheus-setup,v20210717,2021/07/17,14,95,108,45,0,262
ddosify/curlubuntutestapp,23.10,2023/10/12,18,8,4,0,0,30
balenalib/raspberry-pi2-ubuntu-python,20231026,2023/11/02,37,10,0,0,0,47
bitnami/joomla,5.0.0,2023/10/23,149,81,52,4,2,288
intel/rpbs_pipeline_application_web_service,1.0,2023/08/21,5,6,12,3,2,28
google/apigee-synchronizer,1.8.0-preview.2,2022/02/18,9,28,27,3,4,71
bitnami/elasticsearch,8.11.1,2023/11/13,170,71,37,5,0,283
grafana/grafana-enterprise,10.2.1,2023/11/14,0,1,5,0,0,6
kasmweb/vivaldi,1.14.0,2023/09/14,187,380,0,0,0,567
balenalib/spacely-tx2-ubuntu,20231103,2023/11/06,37,9,0,0,0,46
ngrok/ngrok-docker-extension,0.1.5,2023/03/21,0,19,7,0,0,26
mirantis/ucp-csi-snapshotter,3.5.3,2022/04/05,0,0,0,0,6,6
kong/ubi-kuma-cp,2.4.4,2023/11/06,31,27,8,0,0,66
rancher/mirrored-istio-citadel,1.5.9,2020/08/07,406,1087,142,0,0,1635
redislabs/redisai,1.2.5,2021/10/28,230,279,30,0,0,539
newrelic/k8s-nri-jmx,2.4.3,2020/01/22,93,42,17,0,0,152
rapidfort/wordpress,6.3.1,2023/10/17,100,62,38,3,2,205
balenalib/orbitty-tx2-alpine-golang,20231106,2023/11/06,0,0,4,0,0,4
balenalib/artik10-openjdk,20220714,2022/07/22,157,127,85,18,0,387
pachyderm/mnist_pipeline,v1.0.4,2022/01/14,827,989,740,95,5,2656
bitnami/nginx-ingress-controller,1.9.4,2023/11/09,86,19,21,4,0,130
vmware/powerclicore,13.1,2023/05/05,181,294,33,0,0,508
mirantis/ucp-gatekeeper,3.7.1,2023/04/14,0,3,3,0,0,6
ubuntu/chiselled-jre,8-22.04_31,2023/06/19,null
astronomerinc/ap-pgbouncer-exporter,0.15.0-3,2023/11/02,0,0,3,0,0,3
appdynamics/appdynamics-cloud-db-collector,23.6.0-780,2023/06/26,0,3,9,0,0,12
rancher/mirrored-cilium-certgen,v0.1.9,2023/08/02,0,1,1,0,0,2
airbyte/source-pinterest,0.7.1,2023/11/01,64,21,8,1,0,94
purestorage/docker-plugin,v3.10,0001/01/01,null
airbyte/source-plausible,0.1.0,2022/11/17,0,17,27,1,0,45
docker/cruise-user-shell,17.06,2018/01/25,233,404,18,0,0,655
balenalib/zynq-xz702-debian-golang,20220714,2022/07/28,467,262,214,28,1,972
rancher/gitjob,v0.1.108,2023/11/13,0,0,2,0,0,2
bitnami/metallb-controller,0.13.12,2023/11/08,74,12,8,2,0,96
ngrok/ngrok-ingress-controller,0.2.0,2022/12/27,0,2,3,0,0,5
intel/intel-gpu-plugin,0.28.0,2023/09/22,null
balenalib/asus-tinker-board-alpine-node,18.14.1-20231106,2023/11/07,0,1,5,0,0,6
airbyte/source-kyriba,0.1.0,2022/07/13,0,21,51,8,0,80
balenalib/nitrogen6x-golang,20220714,2022/07/28,467,262,214,28,1,972
balenalib/up-board,20210825,2021/09/03,176,101,96,24,6,403
rancher/mirrored-calico-typha,v3.26.3,2023/10/06,0,2,2,0,0,4
airbyte/octavia-cli,0.50.7,2023/07/11,151,86,62,10,0,309
rancher/mirrored-kiali-kiali,v1.76.0,2023/10/30,37,4,4,0,0,45
docker/ucp-cfssl,3.3.1,2020/06/26,2,8,9,1,0,20
balenalib/intel-nuc-ubuntu-golang,20230911,2023/09/11,147,146,23,0,0,316
mirantis/ucp-kube-dns,3.2.15,2021/06/29,0,0,0,2,0,2
kumahq/kuma-prometheus-sd,1.8.8,2023/07/28,0,13,12,0,0,25
onlyoffice/4testing-docspace-migration-runner,2.0.0.33,2023/11/15,73,11,13,2,0,99
balenalib/rpi,20231106,2023/11/07,107,34,31,4,0,176
docker/ucp-secureoverlay-agent,3.3.1,2020/06/26,2,8,9,1,0,20
airbyte/source-marketo,1.2.2,2023/10/15,64,21,8,1,0,94
balenalib/up-board-fedora-python,20231103,2023/11/04,null
docker/ucp-kube-dns-dnsmasq-nanny-s390x,3.1.0-beta3,2018/10/04,null
mirantis/ucp-istio-node-agent-k8s,3.4.15,2020/06/17,472,1164,149,0,0,1785
onlyoffice/box-builder,1.0.1,2023/09/12,0,4,8,0,0,12
circleci/mongo,5.0.6,2022/02/22,106,175,7,0,0,288
amazon/aws-glue-streaming-libs,glue_streaming_libs_4.0.0_image_01,2023/09/21,43,242,387,91,0,763
snyk/code-agent,1.20.9,2023/10/27,0,0,2,1,0,3
pingidentity/pingtoolkit,2310,2023/11/01,0,7,8,0,0,15
portainer/gosec,v2.6.1-5-g1a0acdf,2021/02/01,7,22,56,15,0,100
datadog/serverless-buildpack,beta8,1980/01/01,0,3,4,0,0,7
google/apigee-stackdriver-logging-agent,1.8.9-2,2021/11/01,1,11,26,2,4,44
bitnami/kubeapps-apprepository-controller,2.9.0,2023/11/08,0,3,2,0,0,5
rancher/metadata,v1.0.7,2017/09/26,306,388,24,0,0,718
airbyte/source-snowflake,0.2.2,2023/10/24,6,49,61,17,0,133
rapidfort/curl,7.88.1,2023/06/02,0,8,8,0,0,16
vertica/kafka-scheduler,23.4.0,2023/11/08,null
hashicorp/envoy-fips,v1.26.4,2023/08/21,7,2,1,0,0,10
ddosify/alaz,v0.2.2,2023/10/30,0,2,5,0,0,7
rapidfort/wordpress-ib,6.2.2,2023/09/28,58,55,3,0,0,116
balenalib/beaglebone-green-wifi-ubuntu-python,20230911,2023/09/11,42,11,4,0,0,57
circleci/rust,1.57.0,2021/12/18,842,1024,785,101,5,2757
balenalib/bananapi-m1-plus-fedora-python,20221109,2022/11/16,0,1,0,0,0,1
balenalib/beaglebone-green-wifi-ubuntu-golang,20230911,2023/09/11,141,146,23,0,0,310
rancher/opni-opensearch-fetcher,v0.5.4,2022/07/26,8,72,71,4,11,166
balenalib/artik533s-alpine-golang,20220803,2022/08/04,8,39,40,12,0,99
solace/solace-pubsub-connector-ibmmq,1.1.1,2023/11/08,72,34,0,1,0,107
mattermost/playbooks-circleci,v2022-12-23,2022/12/23,489,1298,51,0,0,1838
balenalib/i386,20231106,2023/11/06,107,20,23,4,0,154
grafana/k6-grpcbin,v0.3.1,2023/08/23,0,4,6,0,0,10
couchbase/admission-controller,2.5.0,2023/08/14,0,2,1,0,0,3
balenalib/zynq-xz702-debian,20220714,2022/07/20,124,68,74,18,0,284
rancher/migration-agent,v0.1.0-rc8,2021/08/30,0,10,32,1,0,43
airbyte/source-dv-360,0.1.0,2022/09/27,0,21,51,8,0,80
balenalib/orbitty-tx2-ubuntu-golang,20231103,2023/11/06,139,131,0,0,0,270
grafana/drone,write-access-approve,2023/10/25,3,11,14,1,0,29
balenalib/via-vab820-quad-ubuntu,20220714,2022/08/02,87,82,11,0,0,180
okteto/cloud-proxy,0.2,2018/10/16,0,1,3,0,0,4
newrelic/k8s-nri-rabbitmq,2.2.1,2020/01/29,2,11,29,4,0,46
rancher/terraform-operator-executor,v0.0.5,2019/03/26,8,14,31,7,0,60
nginx/nginx-ingress,3.3.2,2023/11/22,81,21,8,1,2,113
hashicorp/consul-aws,0.1.2,2020/04/07,6,21,53,6,0,86
bellsoft/liberica-openjre-alpine,21.0.1-12,2023/11/14,0,0,4,0,0,4
intel/oact-mps,v2.12.5,2023/11/01,0,0,2,0,0,2
airbyte/normalization-redshift,0.4.3,2023/05/12,486,380,330,49,2,1247
kong/koko,v0.1.0,2022/09/27,0,13,18,0,0,31
balenalib/ts4900-alpine,20220714,2022/07/19,7,37,35,10,0,89
intel/mcss_covid19_grafana,2021.4.2,2021/12/16,5,31,66,9,0,111
puppet/iac_release,2.3.0-pre7,2021/09/16,1419,1336,950,145,39,3889
rancher/os2,v0.1.0-alpha13,2021/12/01,15,68,50,1,0,134
docker/ucp-swarm,3.3.1,2020/06/26,2,8,9,1,0,20
rancher/kubectl,v1.28.3,2023/10/23,null
mirantis/ucp-kube-ingress-controller,3.7.1,2023/09/08,2,1,10,2,0,15
balenalib/revpi-core-3-debian-node,20230530,2023/07/02,118,38,41,6,0,203
adobecoldfusion/apimanageraddons2018,2018.0.0,2021/09/16,106,172,8,3,0,289
bitnami/fluxcd-image-reflector-controller,0.30.0,2023/11/08,74,14,9,2,0,99
balenalib/zynq-xz702,20220714,2022/07/20,124,68,74,18,0,284
balenalib/hummingboard-python,20230904,2023/09/09,118,37,40,6,0,201
balenalib/raspberrypi3-ubuntu-python,20231026,2023/11/02,37,10,0,0,0,47
bitnami/spring-cloud-skipper-shell,2.11.1,2023/11/15,74,12,10,4,0,100
rancher/log-aggregator,v0.1.8,2021/08/04,56,26,0,0,0,82
mirantis/k8s-appcontroller,v0.4,2017/01/10,0,12,22,5,0,39
kong/kuma-init,2.4.4,2023/11/06,22,9,4,0,0,35
astronomerinc/ap-astro-ui,0.33.6,2023/11/14,null
onlyoffice/docspace-studio,1.1.4.1,2023/10/23,1016,143,210,12,0,1381
balenalib/i386-ubuntu-python,20210826,2021/09/21,105,168,8,0,0,281
airbyte/source-facebook-pages,0.3.0,2023/06/26,0,15,27,1,0,43
kumahq/install-cni,0.0.10,2022/05/19,6,19,21,0,0,46
balenalib/beaglebone-black-debian-golang,20230911,2023/09/12,442,111,73,9,0,635
balenalib/parallella-ubuntu-golang,20230904,2023/09/09,141,146,23,0,0,310
balenalib/parallella-python,20230904,2023/09/09,118,37,40,6,0,201
airbyte/source-gutendex,0.1.0,2022/10/20,0,17,27,1,0,45
airbyte/source-hubspot,1.7.0,2023/11/01,64,21,8,1,0,94
docker/ucp-controller-s390x,3.1.0-beta3,2018/10/04,0,2,6,16,0,24
airbyte/source-aircall,0.2.0,2023/07/27,0,15,26,1,0,42
newrelic/newrelic-k8s-operator,0.5.0,2023/11/13,0,2,3,0,0,5
bitnami/argo-workflow-cli,3.5.1,2023/11/08,0,1,0,0,0,1
mirantis/rethinkdb,2.4.3-mirantis-44-5296d3f,2023/05/10,4,14,15,2,0,35
intel/esp-uos-kernel,v3.1.2,2023/07/25,null
balenalib/colibri-imx6dl,20220714,2022/07/20,124,68,74,18,0,284
balenalib/intel-nuc-debian-node,20231106,2023/11/06,114,22,30,4,0,170
vmware/lightwave-sts,1.3.1,2017/10/26,34,188,245,119,0,586
grafana/loki,2.9.2,2023/10/25,0,1,5,0,0,6
airbyte/destination-local-json,0.2.11,2022/07/12,76,75,64,19,0,234
objectscale/pravega-operator,0.5.7-309-5fc87406,2023/07/20,2,14,20,0,0,36
intel/intel-ethernet-operator-daemon,v1.0.0,2023/07/26,33,34,7,0,0,74
sysdig/agent-kmodule,12.17.1,2023/10/24,151,30,0,0,0,181
rancher/rio-website,build,2018/08/09,55,31,59,15,9,169
airbyte/source-google-sheets,0.3.11,2023/10/15,64,21,8,1,0,94
docker/transfused,8599be9b5485e04530a593e23095a4726f67970b,2017/07/04,null
appdynamics/dotnet-agent,20.6.0-micro,2020/07/20,0,4,3,2,0,9
rancher/mirrored-flannelcni-flannel-cni-plugin,v1.2.0,2022/12/05,null
solace/pubsubplus-prometheus-exporter,1.0.1,2023/11/10,16,10,0,0,0,26
grafana/metaconvert,2.10.4,2023/11/13,0,0,4,0,0,4
airbyte/source-zenefits,0.2.0,2023/10/31,0,13,26,1,0,40
airbyte/destination-mariadb-columnstore,0.1.7,2022/09/09,80,96,107,34,0,317
intel/esp-core,v3.1.4,2023/08/23,null
intel/intel-qat-initcontainer,0.28.0,2023/09/22,null
airbyte/source-azure-blob-storage,0.2.3,2023/11/13,129,37,13,2,0,181
rancher/secrets-flexvol,855c1d5,2016/09/15,97,122,23,0,0,242
rancher/mirrored-istio-sidecar_injector,1.5.9,2020/08/07,405,1084,142,0,0,1631
kasmweb/core-alpine-318,1.14.0,2023/09/09,2,9,27,2,9,49
grafana/fluent-plugin-loki,2.9.2-amd64,2023/10/25,202,306,250,34,6,798
percona/percona-backup-mongodb,2.3.0,2023/11/02,72,23,3,0,0,98
docker/demo,v1.2.2,2018/10/02,0,0,0,2,0,2
onlyoffice/4testing-appserver-backup-background,test-2022081607,2022/08/16,1037,333,357,24,1,1752
balenalib/asus-tinker-board-alpine,20231106,2023/11/07,0,0,4,0,0,4
rapidfort/mongodb,7.0.2,2023/10/20,34,6,10,2,0,52
objectscale/postgres-operator-upgrade,ubi8-5.1.2-0,2022/07/05,68,83,16,0,0,167
balenalib/jetson-tx1-fedora-openjdk,8-20230530,2023/06/08,null
greenbone/openvas-smb-build,v22.5.4,2023/10/17,246,63,29,2,0,340
circleci/buildpack-deps,21.04,2021/02/20,38,488,26,0,0,552
kong/kumactl,2.4.4,2023/11/06,7,2,3,0,0,12
intel/envoy,1.19.0-intel.0,2023/11/13,17,4,0,0,0,21
rancher/hardened-etcd,v3.5.9-k3s1-build20231009-s390x,2023/10/10,2,8,14,0,2,26
datadog/dd-lib-ruby-init,v1.16.2,2023/11/10,0,0,4,0,0,4
airbyte/postgres-singer-source-abprotocol,0.1.0,2020/10/20,590,409,394,42,11,1446
bellsoft/buildpacks.alpaquita-base,musl,2023/04/04,null
docker/ucp-hrm-s390x,2.2.22,2019/10/07,2,11,9,1,0,23
bitnami/natscli,0.1.1,2023/11/09,74,13,12,2,0,101
rancher/cluster-proportional-autoscaler-amd64,1.3.0,2018/10/01,null
kasmweb/core-parrotos-5,1.14.0,2023/09/09,null
balenalib/raspberrypi3-debian,20230911,2023/09/11,118,36,40,6,0,200
docker/scout-cli,8832496,2023/09/05,0,3,6,0,0,9
balenalib/ts4900-ubuntu,20220714,2022/08/02,87,82,11,0,0,180
airbyte/destination-bigquery-denormalized,2.0.0,2023/07/15,65,189,175,17,0,446
balenalib/artik710-alpine-openjdk,8-20230904,2023/09/09,8,8,8,2,0,26
okteto/gitlab,0.1,2020/03/19,15,61,73,9,0,158
airbyte/source-declarative-manifest,0.53.6,2023/11/14,0,1,5,0,0,6
vmware/lightwave-toolchain-photon2,1.0.4,2019/10/09,57,330,393,123,0,903
bitnami/user-broker-archived,0.3.1,2022/01/16,130,83,89,23,6,331
rancher/mirrored-longhornio-csi-node-driver-registrar,v2.7.0,2022/12/28,0,3,3,0,0,6
balenalib/amd64-debian,20231106,2023/11/06,107,20,23,4,0,154
balenalib/amd64-alpine,20231106,2023/11/07,0,0,4,0,0,4
atlassian/crucible,4.8.13,2023/10/27,160,190,26,6,0,382
balenalib/beaglebone-green-ubuntu-node,20230911,2023/09/12,43,11,5,0,0,59
rancher/k8s-dns-dnsmasq-nanny,1.15.10,2020/03/05,16,17,19,8,1,61
balenalib/artik5-debian-openjdk,20220714,2022/07/22,157,127,85,18,0,387
balenalib/apalis-imx6q-alpine-openjdk,8-3.14-20220112,2022/01/19,2,50,42,13,0,107
rancher/hardened-runc,v1.0.0-rc92,2020/09/24,258,402,18,3,0,681
rancher/harvester-network-webhook,v0.3.5,2023/11/20,1,1,4,0,0,6
airbyte/source-mysql-strict-encrypt,3.1.5,2023/11/01,4,44,59,17,0,124
redislabs/k8s-controller,7.2.4-7,2023/09/19,62,29,4,0,0,95
objectscale/csi-baremetal-halmgr,0.69.0,2021/03/07,7,80,98,5,2,192
balenalib/asus-tinker-board-s-node,20230911,2023/09/12,118,38,41,6,0,203
airbyte/source-greenhouse,0.4.3,2023/09/27,64,23,8,1,0,96
bitnami/metallb-speaker,0.13.12,2023/11/08,74,12,8,2,0,96
rancher/thanos,v0.10.1,2020/01/24,2,13,16,0,0,31
balenalib/orangepi-plus2-fedora-python,20221109,2022/11/16,0,1,0,0,0,1
docker/pipeline_unpacker,0.2.0-alpha,2017/04/04,0,1,5,2,0,8
continuumio/anaconda3,2023.09-0,2023/09/29,125,63,76,10,0,274
onlyoffice/4testing-appserver-doceditor,test-2022081607,2022/08/16,999,363,499,45,7,1913
appdynamics/ad-nite-nodejs-services,2019-03-13-1552509464,2019/03/13,88,105,206,45,12,456
intel/tadk-waf,v23.03.0,2023/05/25,84,109,41,0,0,234
rancher/longhorn-orc,1135b84,2017/04/12,251,343,20,0,0,614
objectscale/manager-pre-update,0.60.0,2020/12/12,0,6,10,0,0,16
pingidentity/pingdataconsole,2310,2023/11/01,1,6,4,3,0,14
balenalib/artik710-fedora-openjdk,8-20230530,2023/06/08,null
rancher/mirrored-jaegertracing-all-in-one,1.49.0,2023/09/07,0,2,6,0,0,8
nginxinc/mra-fakes3,1.2.1,2018/01/16,0,9,24,7,0,40
airbyte/source-coinmarketcap,0.1.1,2022/11/01,0,17,27,1,0,45
bitnami/elasticsearch-curator-archived,5.8.4,2022/07/03,111,72,65,16,0,264
rapidfort/couchdb-official,3.2.3,2023/11/21,22,4,2,1,0,29
bitnami/concourse,7.11.0,2023/11/16,91,22,20,4,0,137
kong/kuma-prometheus-sd,1.9.8,2023/07/28,0,13,15,0,0,28
pachyderm/nvidia_driver_install,1870632b4853800ea8f4b0756c2033cab93e60f3,2017/05/10,0,1,5,2,0,8
atlassian/escalator,v1.13.2,2023/07/13,0,6,4,0,0,10
balenalib/rpi-python,20231106,2023/11/07,107,35,31,4,0,177
docker/for-desktop-kernel-grpcfuse,05437be5d71eb91706b1073d42b9a24851c6f6ff,2021/11/15,null
okteto/falco-renovator,0.5,2021/06/17,199,163,235,51,14,662
balenalib/beaglebone-black-debian-node,20230911,2023/09/12,118,38,41,6,0,203
rancher/storage-ebs,v0.9.8,2019/10/02,192,249,16,2,0,459
balenalib/am571x-evm,20220714,2022/07/20,124,68,74,18,0,284
grafana/doc-validator,7770886,1970/01/01,0,5,8,0,0,13
objectscale/objectscale-service-tools,2.71.3,2021/04/14,18,131,158,6,7,320
docker/dtr-garant-s390x,2.5.0-beta3,2018/01/17,0,16,41,34,0,91
airbyte/tool-link-checker,0.1.0,2020/11/03,3,19,45,8,0,75
couchbase/operator-backup,6.6.0-102,2021/02/09,13,11,7,0,0,31
newrelic/k8s-metadata-injection,1.22.0,2023/11/13,0,0,4,0,0,4
objectscale/objectscale-insideiq,1.4.0-397.adb0726,2023/11/13,0,3,4,0,0,7
redhat/ubi9-micro,9.3-6,2023/11/01,3,0,0,0,0,3
datadog/ci,v2.23.1,2023/11/10,0,0,4,0,0,4
purestorage/realtime-metrics,1.0.21,2023/11/13,0,0,2,0,0,2
balenalib/generic-armv7ahf-alpine-golang,20230904,2023/09/09,2,0,7,2,0,11
balenalib/orangepi-plus2-python,20230911,2023/09/11,118,37,40,6,0,201
onlyoffice/docspace-urlshortener,test,2022/09/08,995,362,503,46,7,1913
rancher/mirrored-k8scsi-csi-provisioner,v2.1.0,2020/12/18,0,5,13,0,5,23
ubuntu/grafana,10.0.3-22.04,2023/10/05,22,13,5,0,0,40
balenalib/jetson-tx2-fedora-openjdk,8-20231106,2023/11/06,null
airbyte/destination-chroma,0.0.5,2023/10/27,64,7,7,4,0,82
google/dart-hello,2.16-beta,2021/12/13,190,104,123,39,9,465
grafana/drone-git,2023-01-12-windows-amd64,2019/08/06,0,5,4,2,0,11
airbyte/source-plaid,0.4.0,2023/08/17,0,15,26,1,0,42
airbyte/config,0.39.0-alpha,2022/05/11,0,6,8,1,0,15
rancher/longhornio-longhorn-share-manager,v1_20220808-s390x,2022/08/08,7,59,33,3,11,113
rancher/shell,v0.1.22,2023/10/20,0,16,14,0,2,32
rancher/coredns-coredns,1.8.3,2021/02/24,1,6,11,0,0,18
graphcore/pytorch,3.3.0,2023/07/03,146,196,27,0,0,369
datadog/cluster-agent-dev,1.0.1,2018/11/14,null
balenalib/beaglebone-black-alpine,20231106,2023/11/07,0,0,4,0,0,4
balenalib/kitra710-fedora-node,20230712,2023/07/16,0,1,1,0,0,2
airbyte/source-openweather,0.2.0,2023/08/31,0,15,26,1,0,42
balenalib/raspberry-pi2-debian-python,20230911,2023/09/12,118,37,40,6,0,201
pachyderm/imap_spout,1.11,2020/09/03,1473,1447,1074,153,39,4186
bitnami/acmesolver,1.13.2,2023/11/08,74,12,8,2,0,96
vmware/vke-mutentca-plugin-toolchain-photon2,1.0.2,2018/12/13,62,354,460,153,0,1029
balenalib/stem-x86-32-alpine-golang,20221109,2022/11/17,6,30,35,11,0,82
mirantis/ucp-rethinkdb-exporter,3.7.1,2023/09/26,2,1,6,2,0,11
balenalib/artik710,20230904,2023/09/09,118,36,40,6,0,200
balenalib/artik10-fedora-openjdk,8-20220224,2022/03/05,null
couchbase/service-broker,1.2.1,2022/04/09,0,3,5,0,0,8
balenalib/kitra710-alpine,20230904,2023/09/09,2,0,7,2,0,11
bellsoft/buildpacks.builder,musl,1980/01/01,2,28,14,0,0,44
rancher/system-agent-installer-rke2,v1.28.3-rke2r2-windows-1809-amd64,2023/11/08,null
rancher/heapster-amd64,v1.6.0-beta.1,2018/08/06,null
rancher/mirrored-prom-node-exporter,v1.0.1,2020/06/16,0,5,10,0,0,15
rancher/openpolicyagent-gatekeeper,v3.3.0,2021/01/28,0,7,14,0,4,25
docker/dockerfile-copy,v0.1.9,2018/10/31,null
okteto/docker-proxy,0.1.1,2019/08/27,2,27,10,5,0,44
airbyte/source-rss,0.1.0,2022/11/10,0,15,19,0,0,34
balenalib/generic-armv7ahf-openjdk,20230904,2023/09/09,129,64,44,6,0,243
rancher/coreos-prometheus-config-reloader,v0.43.0,2020/10/27,0,1,1,0,0,2
datadog/dev-dd-agent,5202rc1,2017/12/05,50,127,106,41,20,344
sysdig/agent-kmodule-thin,12.17.1,2023/10/24,151,30,0,0,0,181
rancher/os-xfce,v0.8.2,2017/02/23,47,67,7,0,0,121
newrelic/k8s-nri-nagios,2.6.0,2020/01/20,null
balenalib/rpi-node,16.19.1-20231106,2023/11/07,107,36,32,4,0,179
rancher/goharbor-harbor-registryctl,v1.7.5,2019/04/01,14,63,88,37,0,202
grafana/agent-build-image,0.30.3,2023/10/16,806,255,200,13,0,1274
atlassian/pipelines-awscli,1.29.35,2023/08/28,1,2,4,1,0,8
hashicorp/boundary-enterprise,0.14.2-ent,2023/10/31,0,1,3,0,0,4
docker/ucp-calico-cni-s390x,3.1.0-beta3,2018/10/04,null
rancher/library-nginx,1.19.2-alpine-s390x,2020/08/14,10,32,60,7,0,109
jetbrains/teamcity-minimal-agent,2023.05.4,2023/09/19,37,72,84,9,0,202
objectscale/logging-injector,3.9.0.0-1588.729cf194,2023/04/25,4,33,29,0,0,66
rancher/cert-manager-controller,v0.11.0-rio.1,2019/10/22,0,0,0,0,6,6
rancher/harvester-support-bundle-utils,master-head,2021/05/28,4,25,39,8,0,76
rapidfort/fluentd,1.16.2,2023/11/15,30,5,4,1,0,40
bitnami/owncloud-archived,10.11.0,2022/12/22,153,201,97,10,2,463
airbyte/source-gnews,0.1.3,2023/01/17,0,16,27,1,0,44
airbyte/source-serpstat,0.1.0,2023/08/22,0,15,26,1,0,42
circleci/redis,7.0-rc1,2022/02/22,73,31,37,15,0,156
intel/intel-extension-for-pytorch,2.1.0-pip-mulitnode,2023/10/23,122,150,4,0,0,276
airbyte/destination-kafka,0.1.10,2022/08/04,76,78,66,19,0,239
pachyderm/seldon-pachyderm-rsi-trainer,0.1.2,2021/02/10,104,68,79,31,7,289
bitnami/ejbca,8.0.20230531,2023/09/23,79,64,57,14,0,214
purestorage/ccm-go,1.2.0,2023/11/14,0,3,2,0,0,5
balenalib/i386-debian,20231106,2023/11/06,107,20,23,4,0,154
kasmweb/unityhub,1.14.0,2023/09/14,189,381,3,0,0,573
balenalib/i386-nlp-golang,1.11.13-20200529,2021/04/12,657,403,359,53,9,1481
bitnami/fluxcd-notification-controller,1.1.0,2023/11/08,74,15,10,2,0,101
airbyte/source-insightly,0.2.0,2023/11/14,0,13,26,1,0,40
kasmweb/ubuntu-bionic-dind,develop-rolling,2022/03/18,272,877,21,0,0,1170
pachyderm/example-spout101,2.0.2,2023/02/17,798,597,350,25,2,1772
vmware/restreview-appserver,V2,2017/12/31,221,865,632,149,57,1924
airbyte/source-sonar-cloud,0.1.1,2023/02/27,0,16,27,1,0,44
balenalib/artik10-alpine-openjdk,8-jre-20220803,2022/08/04,34,78,48,10,0,170
rancher/minio-minio,RELEASE.2020-07-13T18-09-56Z,2020/07/13,11,35,74,8,0,128
grafana/snyk_exporter,v1.12,2023/02/06,0,1,1,0,0,2
balenalib/i386-debian-golang,20231106,2023/11/06,435,81,52,5,0,573
newrelic/es-operator,dev,2019/04/03,4,14,8,2,0,28
mirantis/ucp-secureoverlay-agent,3.7.1,2023/09/26,2,2,6,2,0,12
rancher/os-console,3929481,2017/02/09,null
intel/ctk_loadkey,v2.4,2023/10/15,37,18,0,0,0,55
objectscale/crunchy-pgadmin4,ubi8-4.30-2,2022/07/05,273,243,50,0,0,566
bitnami/java,21.37.0,2023/10/01,191,95,54,7,0,347
bitnami/multus-cni,4.0.2,2023/11/08,74,21,14,2,0,111
kasmweb/core-alpine-317,1.14.0,2023/09/09,6,54,38,11,2,111
rancher/confd-base,v0.1.0,2015/09/15,null
continuumio/anaconda2,2019.10,2019/10/15,219,249,328,72,10,878
google/apigee-mint-task-scheduler,1.10.0,2023/05/09,5,17,12,0,4,38
balenalib/colibri-imx6dl-ubuntu-node,20220715,2022/07/19,88,104,12,0,0,204
lacework/perf-test,lw-jmeter-docker,2022/11/18,446,873,93,3,0,1415
balenalib/beaglebone-black-ubuntu-golang,20230530,2023/07/02,173,176,39,0,0,388
balenalib/i386-nlp-ubuntu-node,6.17.1-20190503,2021/04/10,109,240,49,2,0,400
objectscale/crunchy-pgbouncer,ubi8-1.16-4,2022/07/05,250,170,40,0,0,460
intel/oneapi-dlfdkit,2023.1.0-devel-ubuntu22.04,2023/04/03,228,280,48,0,0,556
airbyte/source-clickhouse,0.1.17,2023/03/22,61,184,134,2,0,381
docker/ucp-metrics,3.3.1,2020/06/26,2,8,9,1,0,20
balenalib/asus-tinker-board-fedora-openjdk,30-20210825,2021/09/03,null
balenalib/via-vab820-quad-alpine-openjdk,8-3.14-20220112,2022/01/19,2,50,42,13,0,107
onlyoffice/4testing-docs-docservice,lt,2020/11/26,544,491,32,3,0,1070
rancher/istio-coredns-plugin,0.2-istio-1.1,2019/03/06,331,452,37,0,0,820
grafana/enterprise-metrics,v2.10.4,2023/11/14,0,1,4,0,0,5
rancher/mirrored-sig-storage-csi-provisioner,v3.6.2,2023/11/09,null
appdynamics/infraagent-cnao,23.10.0-4872-ecs-amd64,2023/10/20,0,3,1,0,0,4
balenalib/apalis-imx6q-fedora-python,20220622,2022/07/12,0,1,1,0,0,2
rancher/mirrored-sig-storage-livenessprobe,v2.11.0,2023/09/13,0,2,2,0,0,4
rancher/kubernetes-auth,v0.0.8,2017/08/17,312,392,24,0,0,728
mirantis/ucp-blackbox-exporter,3.7.1,2023/09/26,2,3,5,2,0,12
google/drone-firebase,0.1,2016/07/01,26,170,155,42,0,393
balena/balena-base-ui,10.0.1,2023/09/11,418,216,135,14,0,783
grafana/enterprise-logs-boringcrypto,v1.8.4,2023/10/18,0,2,5,0,0,7
docker/ucp-etcd-s390x,3.1.0-beta3,2018/10/04,0,2,6,16,0,24
hashicorp/counting-service,0.0.2,2018/11/14,0,0,0,2,0,2
pachyderm/pachctl-amd64,97276071e371d5b1ea221437e99cfd87b5599ddf,2023/11/03,95,20,30,2,0,147
rapidfort/consul-ib,1.14.9,2023/08/27,26,18,5,0,0,49
bitnami/jmx-exporter,0.20.0,2023/11/10,72,12,7,2,0,93
amazon/amazon-lightsail,hello-world,2020/11/19,45,508,198,10,0,761
balenalib/qemux86-64-ubuntu-openjdk,11-xenial-20230911,2023/09/11,null
bitnami/minio,2023.11.11,2023/11/11,84,14,15,4,0,117
pachyderm/tf_job_s3_gateway_minio,1.9.2,2019/07/31,462,741,176,18,0,1397
solace/solace-pubsub-connector-gcppubsub,1.1.0,2023/09/27,72,47,6,1,0,126
balenalib/i386-ubuntu-node,12.16.3-20200518,2020/05/29,162,255,34,3,0,454
balenalib/beaglebone-green-ubuntu-golang,20230911,2023/09/12,141,146,23,0,0,310
grafana/automatic-aliases,7770886,1970/01/01,0,2,2,0,0,4
ubuntu/memcached,1.6-23.10_edge,2023/11/16,10,2,0,0,0,12
rancher/istio-proxyv2,1.8.3,2021/02/05,302,918,127,2,0,1349
kasmweb/slack,1.10.0,2021/11/16,308,898,21,0,0,1227
balenalib/stem-x86-32-alpine-openjdk,8-20230712,2023/08/01,10,16,7,2,0,35
airbyte/destination-snowflake-bulk,3.2.3-dev.cc832795bb,2023/11/14,6,49,61,17,0,133
kasmweb/super-tux-kart,1.14.0,2023/09/14,187,380,0,0,0,567
pachyderm/config-pod,0.6,2022/02/10,0,6,10,0,0,16
onlyoffice/ffvideo,6.0,2023/04/13,37,12,0,0,0,49
intel/intel-dlb-plugin,0.28.0,2023/09/22,null
objectscale/objectscale-telemetry,vinod,2020/08/12,0,7,11,0,0,18
airbyte/source-pivotal-tracker,0.1.1,2023/10/25,0,13,26,1,0,40
airbyte/source-webflow,0.1.2,2022/07/14,0,18,27,1,0,46
appdynamics/appdynamics-cloud-otel-collector,23.10.0-1163,2023/10/19,0,2,2,0,0,4
hashicorp/consul-dataplane-fips,1.3,2023/11/06,30,19,5,0,0,54
balenalib/raspberrypi3-ubuntu-golang,20231026,2023/11/02,133,131,0,0,0,264
bitnami/harbor-notary-signer,2.8.4,2023/09/15,83,177,229,2,0,491
intel/reconfigurable-ri-viewer,4.0,2022/12/21,56,55,96,23,10,240
rancher/mirrored-calico-node,v3.26.3,2023/10/06,32,4,3,0,0,39
objectscale/csi-baremetal-node,0.69.0,2021/03/07,99,178,30,0,0,307
balenalib/hummingboard-debian,20230904,2023/09/09,118,36,40,6,0,200
appdynamics/machine-agent,23.10.0,2023/10/30,129,30,6,1,0,166
docker/dev-environments-javascript,639923ad2c5ce6f29a24ca8d11c8f38f9206c462,2021/06/21,1116,736,874,89,26,2841
balenalib/armv7hf-python,20230929,2023/10/02,111,37,35,6,0,189
airbyte/source-zuora,0.1.3,2021/10/22,0,21,50,8,0,79
balena/open-balena-base,16.0.13,2023/11/02,357,89,59,5,0,510
airbyte/source-google-drive,0.0.2,2023/11/14,129,37,13,2,0,181
cimg/python,3.12.0,2023/10/07,291,335,48,0,0,674
airbyte/destination-azure-blob-storage,0.2.1,2023/09/21,6,67,76,17,0,166
airbyte/cloud-workers,no-check-3,2023/11/15,4,73,62,0,0,139
graphcore/tensorflow-minimal,2-intel-3.3.0-ubuntu-20.04-20230703,2023/07/03,141,286,50,1,0,478
intel/intelligent_traffic_management_cloud_connector_dev,2.0,2022/12/06,61,92,13,0,0,166
balenalib/via-vab820-quad-openjdk,20210602,2021/06/05,230,232,145,39,8,654
intel/intel-fpga-initcontainer,0.28.0,2023/09/22,null
balenalib/apalis-imx6q-debian-openjdk,20210602,2021/06/05,230,232,145,39,8,654
kong/cloudtrail-integration,1.0.0,2023/02/06,1,100,58,0,0,159
kasmweb/ubuntu-focal-dind,1.14.0,2023/09/14,220,493,2,0,0,715
redislabs/operator,804_c4987427,2019/06/05,null
bitnami/redis,7.2.3,2023/11/09,75,13,8,2,0,98
vmware/photon-controller-ui,1.0.0,2016/11/08,80,215,219,104,23,641
purestorage/telemetry-envoy,1.1.10,2023/11/14,0,2,3,0,0,5
rancher/agent-instance,v0.8.3,2016/06/14,419,519,58,1,0,997
okteto/godev,1,2021/07/05,694,451,419,63,9,1636
airbyte/temporal-auto-setup,1.13.0,2021/10/20,4,54,162,5,0,225
docker/engine-community,18.09.9,2019/09/04,null
rancher/mirrored-prometheus-node-exporter,v1.3.1,2021/12/05,0,4,8,0,0,12
apachepinot/pinot,1.0.0,2023/10/15,2,60,98,25,0,185
balenalib/qemux86-64-fedora-node,20231103,2023/11/04,0,1,1,0,0,2
balenalib/ts4900-fedora,20220604,2022/06/12,null
rancher/hello-world,v0.1.2,2018/06/29,0,4,8,22,0,34
kasmweb/alpine-318-desktop,1.14.0,2023/09/14,12,57,85,10,9,173
balena/aarch64-supervisor,1299,2020/07/31,6,26,55,9,0,96
balenalib/armv7hf-alpine,20231106,2023/11/07,0,0,4,0,0,4
airbyte/destination-teradata,0.1.3,2023/09/25,6,61,73,17,0,157
rancher/opni-kibana-dashboard,v0.1.3,2021/09/14,0,2,25,4,0,31
lacework/k8scollector,6.10.0,2023/11/10,61,14,0,0,0,75
bitnami/couchdb,3.3.2,2023/11/15,84,14,15,4,0,117
airbyte/source-zendesk-support,20211125-1,2021/11/25,0,21,50,8,0,79
astronomerinc/ap-statsd-exporter,0.24.0,2023/09/25,0,2,1,0,0,3
balenalib/up-board-ubuntu,20230911,2023/09/11,42,10,4,0,0,56
airbyte/source-recreation,0.1.0,2022/11/17,0,17,27,1,0,45
mirantis/terratrain,tt-54,2023/05/30,64,123,145,6,0,338
airbyte/source-mongodb,0.3.3,2021/07/20,0,14,46,5,0,65
airbyte/destination-weaviate,0.2.9,2023/11/13,64,21,10,4,0,99
airbyte/source-redshift,0.4.0,2023/06/29,61,182,143,5,0,391
greenbone/gsa,22.9,2023/11/14,94,17,16,2,0,129
continuumio/conda_builder_linux,5.11-5.2-1-4,2016/12/02,0,4,7,4,0,15
solaceiotteam/apim-connector-server,0.10.1,2023/05/09,770,456,307,24,2,1559
redhat/ubi8-micro,8.8-7,2023/09/13,21,10,3,0,0,34
datadog/cluster-agent,7.50.0-rc.2,2023/11/14,11,2,1,0,0,14
graphcore/tensorflow-paperspace,3.3.0,2023/07/03,221,447,51,1,0,720
balenalib/aarch64-python,20231106,2023/11/07,107,21,23,4,0,155
rancher/rancher-runtime,v2.7.1,2023/01/24,12,72,82,3,0,169
airbyte/airbyte-postgres-destination-abprotocol,0.1.0,2020/10/20,101,75,81,24,6,287
balenalib/asus-tinker-board-ubuntu,20231026,2023/11/02,37,9,0,0,0,46
pachyderm/mnist_klflow_example,1.9.3,2019/08/27,757,1086,170,9,0,2022
objectscale/statefuldaemonset-operator,3.9.0.0-1588.729cf194,2023/04/25,4,33,32,0,0,69
airbyte/init,0.50.34,2023/11/09,null
balenalib/artik710-ubuntu-golang,20230904,2023/09/09,147,146,23,0,0,316
pachyderm/script_to_pipeline,v0.1.0,2022/04/13,824,950,731,95,5,2605
rancher/k3c,v0.3.0-alpha.0,2021/01/22,3,12,15,0,0,30
grafana/grafana,9799770991,2023/03/02,0,11,11,0,0,22
vmware/restreview-ui,V2,2018/01/08,57,179,187,66,22,511
rancher/hardened-crictl,v1.19.0,2020/09/25,261,417,36,3,0,717
rancher/rancher-ecr-credentials-windows,v3.0.0,2018/03/08,null
kong/kuma-cni,2.4.4,2023/11/06,7,2,3,0,0,12
rancher/mirrored-amazon-aws-cli,2.9.14,2023/01/11,10,88,111,0,0,209
kasmweb/vlc,1.14.0,2023/09/14,217,483,0,0,0,700
airbyte/source-whisky-hunter,0.1.0,2022/10/21,0,17,27,1,0,45
kasmweb/core-ubuntu-focal,1.14.0,2023/09/09,187,380,0,0,0,567
grafana/test-exporter,log-span-e1ab5495e-WIP5,2019/06/28,0,0,0,2,0,2
grafana/drone-runner-docker,1.0.0,2021/04/08,3,13,14,0,0,30
bitnami/jenkins-exporter-archived,0.20171225.0,2022/03/30,135,81,81,24,6,327
mattermost/mm-te-test,9729641,2023/04/18,225,193,115,19,6,558
grafana/build-container,1.7.7,2023/09/18,941,260,198,17,5,1421
balenalib/stem-x86-32-debian-golang,20230904,2023/09/09,442,113,73,9,0,637
opensearchproject/opensearch-dashboards,2.11.0,2023/11/09,0,2,0,2,0,4
rancher/harvester-upgrade,v1.2.1,2023/10/26,0,11,14,0,0,25
balenalib/zynq-xz702-alpine,20220714,2022/07/19,7,37,35,10,0,89
datadog/dogstatsd-socat-proxy,beta,2017/07/03,0,19,15,6,0,40
grafana/openshift-cloud-log-forwarder-bundle,v1.0.2,2022/03/08,null
airbyte/source-railz,0.1.1,2023/02/23,0,16,27,1,0,44
balenalib/armv7hf-node,20230929,2023/10/02,111,38,36,6,0,191
datadog/dd-trace-java-docker-build,17,2023/02/06,430,716,69,0,0,1215
docker/labs-debug-tools-kubeservice,dev,2023/09/14,13,41,22,4,0,80
mattermost/ops-tool-daily,v0.0.10,2022/06/27,3,17,5,0,0,25
astronomerinc/ap-keda-metrics-apiserver,2.3.0,2021/06/30,0,5,12,1,4,22
cockroachdb/ccloud-builder,20220523-223313,2022/05/23,403,940,66,0,0,1409
balenalib/parallella-ubuntu-python,20230904,2023/09/09,42,11,4,0,0,57
nginxinc/ngx-rust-tool,1.26.0,2018/05/14,391,548,37,0,0,976
intel/language-translation,tf-2.7.0-transformer-mlperf-fp32-training,2021/12/15,330,805,73,0,0,1208
kong/jenkins,1.2.31,2023/06/05,135,46,55,10,0,246
balenalib/kitra520-openjdk,20220714,2022/07/22,157,127,85,18,0,387
balenalib/generic-aarch64-fedora-golang,20231106,2023/11/06,null
bitnami/rmq-messaging-topology-operator,1.12.1,2023/11/09,0,1,0,0,0,1
airbyte/source-iterable,0.1.30,2023/07/20,151,86,62,10,0,309
rapidfort/prometheus,2.47.1,2023/10/17,18,12,6,0,0,36
pachyderm/pachctl-arm64,97276071e371d5b1ea221437e99cfd87b5599ddf,2023/11/03,95,20,30,2,0,147
grafana/grafana-oss-dev,10.3.0-146415,2023/11/15,0,1,4,0,0,5
balenalib/stem-x86-32-alpine-python,20230712,2023/07/25,2,7,6,2,0,17
bitnami/gradle,8.4.0,2023/11/15,84,16,17,4,0,121
solaceiotteam/platform-api-server,0.0.12,2021/04/12,226,404,426,91,8,1155
bitnami/debian-base-buildpack,stretch-r4,2022/01/11,108,101,147,20,3,379
balena/balena-rethinkdb,0.0.3,2019/01/22,139,286,204,38,15,682
airbyte/destination-pubsub,0.2.0,2022/12/02,60,181,146,2,0,389
pachyderm/python-evaluate,sigmoid,2018/02/19,0,26,19,10,0,55
bitnami/cert-manager,1.13.2,2023/11/08,74,13,9,2,0,98
bitnami/airflow-worker,2.7.3,2023/11/21,225,89,47,4,0,365
pachyderm/cert-manager-controller,v0.15.1,2020/05/27,0,0,0,0,6,6
balenalib/beaglebone-black-ubuntu,20231026,2023/11/02,37,9,0,0,0,46
intel/intel-extension-for-tensorflow,2.13.0.0-xpu,2023/07/31,46,24,5,0,0,75
rancher/rancher-webhook,v0.4.0,2023/10/23,0,1,8,0,0,9
bitnami/rclone,1.64.2,2023/11/09,74,13,9,2,0,98
datadog/dd-trace-php,7.4-buster-debug-asan,2019/08/26,1121,791,931,154,14,3011
amazon/aws-sam-cli-emulation-image-java8.al2,20220125,2022/01/25,1,49,13,0,0,63
rapidfort/traefik-ib,v2.10.5,2023/11/16,11,7,1,0,0,19
airbyte/normalization-mssql,0.4.3,2023/05/12,515,393,335,53,2,1298
pingidentity/pingdirectory,2310,2023/11/01,3,13,8,0,0,24
bitnami/harbor-portal,2.9.1,2023/11/15,74,12,8,2,0,96
newrelic/k8s-webhook,0.0.3,2019/09/09,6,20,12,1,0,39
airbyte/source-mailgun,0.2.1,2023/10/31,0,13,26,1,0,40
balenalib/intel-nuc-alpine-node,20231106,2023/11/07,0,1,5,0,0,6
vmware/chartmuseum-photon,dev,2018/08/10,8,70,104,51,0,233
onlyoffice/docspace-telegram-service,test,2022/09/08,1037,333,357,22,1,1750
mattermost/pillar,test,2021/03/02,2,19,39,5,0,65
intel/its-search-image-by-image,master-ae213cd97d6931b1d44fc7689867cf5701e0f15d,2023/09/23,70,31,16,5,0,122
balenalib/bananapi-m1-plus-alpine,20231106,2023/11/07,0,0,4,0,0,4
rancher/mirrored-appscode-kubed,v0.13.2,2023/01/11,0,5,10,1,0,16
cockroachdb/bazel,20231114-194628,2023/11/14,168,180,5,0,0,353
balenalib/armv7hf-alpine-openjdk,8-20231106,2023/11/07,0,0,4,0,0,4
balenalib/beaglebone-green-wifi-python,20230911,2023/09/12,118,37,40,6,0,201
balenalib/artik10-debian-node,20220714,2022/07/20,124,70,75,18,0,287
snyk/snyk-pipe,1.0.0,2023/09/15,484,302,108,16,2,912
kong/ubi-kuma-dp,2.4.4,2023/11/06,31,28,10,0,0,69
airbyte/destination-pulsar,0.1.3,2022/08/05,77,89,73,19,0,258
airbyte/source-exchange-rates,1.3.0,2023/08/25,0,15,26,1,0,42
continuumio/concourse-rsync-resource,master,2023/07/13,0,6,4,0,0,10
hashicorp/consul-enterprise,1.10.4,2021/11/11,3,29,45,3,0,80
ubuntu/dotnet-aspnet,7.0_beta,2023/11/01,null
docker/labs-debug-tools-service,0.0.44,2023/11/14,13,38,20,4,0,75
bitnami/symfony,6.3.8,2023/11/10,151,83,52,4,2,292
newrelic/cli,v0.76.3,2023/11/15,0,2,3,0,0,5
grafana/plugin-build-report-service,0.0.6,2022/03/23,2,24,49,6,0,81
rancher/coreos-flannel,v0.12.0,2020/03/13,5,15,16,3,0,39
rancher/pipeline-tools,v0.1.16,2021/06/28,6,31,72,19,0,128
couchbase/server-sandbox,7.2.3,2023/11/10,21,6,0,0,0,27
intel/intel-dsa-plugin,0.28.0,2023/09/22,null
netdata/package-builders,ubuntu23.10-v1,2023/11/22,86,68,4,0,0,158
redhat/ubi9,9.3-1361,2023/11/01,127,38,2,0,0,167
airbyte/source-shopify-oauth,0.1.0,2023/07/20,0,15,27,1,0,43
rancher/cert-manager-webhook,v0.11.0-rio.1,2019/10/22,0,0,0,0,6,6
intel/intel-xpumanager-sidecar,0.28.0,2023/09/22,null
bitnami/clickhouse,23.10.3,2023/11/11,75,15,9,2,0,101
mattermost/notice-file-generator,v0.0.5,2023/04/12,0,2,4,0,0,6
rancher/alertmanager-helper,v0.0.2,2018/02/13,43,94,10,0,0,147
airbyte/normalization-snowflake,0.4.3,2023/05/12,486,380,330,49,2,1247
rapidfort/elasticsearch,8.10.3,2023/10/17,34,13,5,2,0,54
onlyoffice/docs-example,7.5.1-1,2023/11/09,1070,328,205,7,2,1612
rancher/longhornio-csi-attacher,v3.4.0,2021/12/21,0,4,7,0,0,11
jetbrains/correttowrapper,17.0.5,2023/01/06,13,111,121,0,0,245
rancher/prometheus-federator,v0.3.4,2023/07/13,0,6,5,0,1,12
airbyte/source-tplcentral,0.1.1,2022/11/29,0,17,27,1,0,45
greenbone/data-objects,202311150504,2023/11/15,null
airbyte/source-typeform,1.1.2,2023/10/27,64,21,8,1,0,94
google/apigee-fluent-bit,1.9.9,2022/09/28,28,29,23,2,0,82
lacework/lacework-proxy-scanner,0.23.2,2023/11/10,0,4,9,0,0,13
redislabs/redis-connect-gemfire,0.5.0-139,2022/01/22,3,29,32,12,0,76
datadog/dogstatsd-dev,7.46.0-devel.git.33.79ca82b.pipeline.15281127,2023/04/26,0,10,2,0,0,12
intel/generative-ai,tf-flex-gpu-stable-diffusion-inference,2023/08/31,46,24,7,0,0,77
pachyderm/pachd-arm64,97276071e371d5b1ea221437e99cfd87b5599ddf,2023/11/03,0,7,4,0,0,11
balenalib/orangepi-plus2-alpine-golang,20231106,2023/11/07,0,0,4,0,0,4
intel/intelligent_traffic_management_dashboard,2.0,2022/11/15,62,93,15,0,0,170
intel/intelligent_traffic_management_rule_engine,2.0,2022/11/09,61,88,12,0,0,161
grafana/cortex-grafanacloud,v0.6.0,2020/07/23,6,36,51,4,0,97
airbyte/destination-cumulio,0.1.0,2023/04/20,823,932,700,81,3,2539
jetbrains/qodana-dotnet,2023.2,2023/09/06,159,86,127,18,0,390
pachyderm/estimate-pi-spark,0.3,2018/07/20,122,447,591,257,39,1456
balenalib/artik530-ubuntu-openjdk,20210826,2021/09/21,136,435,10,0,0,581
rancher/longhorn-test,version-test.2-2.1-1.1-1,2018/06/18,58,97,13,0,0,168
airbyte/source-looker,0.2.8,2023/01/06,0,16,27,1,0,44
vmware/postgresql-photon,v1.5.2,2018/07/18,11,70,117,36,0,234
rapidfort/postgresql-official,15.2,2023/03/01,46,25,17,1,0,89
airbyte/source-mixpanel-singer,0.2.4,2021/07/06,561,319,283,39,7,1209
balenalib/odroid-c1-alpine-openjdk,8-3.14-20220112,2022/01/19,2,50,42,13,0,107
balena/open-balena-haproxy,4.3.1,2023/06/28,2,9,9,5,0,25
balenalib/qemux86-64-alpine,20231106,2023/11/07,0,0,4,0,0,4
rancher/k3os,v0.19.5-rc.1,2021/01/05,null
grafana/docker-slack-message,9834170,2023/09/03,0,0,4,0,0,4
kong/release-script,1.28.0,2023/11/14,0,0,4,0,0,4
balenalib/colibri-imx6dl-debian-node,18.6-20220714,2022/07/21,124,70,75,18,0,287
airbyte/source-qualaroo,0.3.0,2023/10/25,0,13,26,1,0,40
kasmweb/redirector,1.0.0,2019/06/02,135,190,2,0,0,327
formio/uswds-viewer,5.3.4,2023/11/08,206,172,1,0,0,379
docker/proxyv2,1.1.2,2019/04/12,446,623,51,0,0,1120
datadog/envoy-apm-experimental,1962f1461148b4c1a6a072740b877708deeb2051,2018/10/01,54,72,12,0,0,138
grafana/alertmanager-webhook-logger,0.3,2021/07/16,0,2,1,0,0,3
grafana/agent-crow,v0.22.0,2022/01/20,94,37,52,13,6,202
rancher/coreos-flannel-cni,v0.3.0,2017/09/12,null
bitnami/prometheus-operator,0.69.1,2023/11/09,74,12,8,2,0,96
nginx/unit,1.29.1-ruby3.1,2023/02/28,775,590,345,23,2,1735
objectscale/objectscale-manager-pre-update,0.71.3,2021/04/07,2,17,22,0,0,41
rapidfort/airflow-ib,2.6.3,2023/09/20,0,1,0,0,0,1
intel/rpbs_pipeline_management_service,1.1,2023/08/30,819,1182,63,0,0,2064
vmware/tern,testimage,2020/02/08,null
balenalib/artik530-alpine-openjdk,8-jre-20220803,2022/08/04,34,78,48,10,0,170
kong/pulp-resource-manager,1.1.38,2022/08/24,4,11,9,4,0,28
bitnami/harbor-jobservice,2.9.1,2023/11/08,84,15,16,4,0,119
atlassian/jira-performance-tests,4748205,2021/05/13,167,337,29,0,0,533
rancher/plugins-docker,18.09,2020/04/16,0,9,0,2,0,11
rancher/longhorn-ui,5528110,2017/04/13,180,740,697,228,56,1901
greenbone/gvm-libs-build,v23.3.0,2023/03/30,496,209,150,13,0,868
rancher/metadata-windows,v0.10.0,2017/12/11,null
balenalib/bananapi-m1-plus-debian-python,20230904,2023/09/09,118,37,40,6,0,201
greenbone/gsad-build,22.8,2023/11/14,476,119,76,9,0,680
rancher/os-zfs,v1.5.8,2021/02/05,1502,1923,1460,206,39,5130
rancher/istio-install-cni,1.8.3,2021/02/05,301,934,154,0,0,1389
airbyte/source-senseforce,0.1.1,2023/03/02,0,16,27,1,0,44
balenalib/jetson-tx2-fedora-python,20231106,2023/11/06,null
balenalib/artik5-alpine-python,20220803,2022/08/04,7,38,37,10,0,92
airbyte/source-stripe,4.5.3,2023/11/14,64,21,8,1,0,94
airbyte/gitx,90f68c3,2023/02/20,3,22,18,1,0,44
bitnami/jenkins,2.414.3,2023/11/02,113,18,34,7,0,172
mirantis/ucp-node-feature-discovery,3.7.1,2023/09/26,32,43,22,0,0,97
balenalib/beaglebone-green-openjdk,20230911,2023/09/11,129,64,44,6,0,243
bitnami/cosign,2.2.1,2023/11/08,74,13,8,2,0,97
appdynamics/ad-air-mysql-db,java,2021/01/15,139,74,105,27,6,351
airbyte/normalization-mysql,0.4.3,2023/05/12,486,380,330,49,2,1247
grafana/rollout-operator,v0.9.0,2023/11/14,0,0,4,0,0,4
rancher/pause-amd64,3.1,2017/12/20,null
intel/intel-optimized-tensorflow,2.9.1,2023/01/06,66,64,10,0,0,140
balenalib/imx6ul-var-dart-alpine-python,20231106,2023/11/07,0,1,4,0,0,5
ambassador/aes-eg-ext,v4.0.0-preview.2.dev.1,2023/10/27,0,1,1,0,0,2
rancher/calico-kube-controllers,v3.18.1,2021/03/10,0,8,16,0,0,24
rancher/os-udev,v0.7.1,2016/11/11,null
balenalib/raspberry-pi2-fedora,20221031,2022/11/04,null
atlassian/ssh-ubuntu,0.2.2,2019/09/16,265,386,39,0,0,690
bitnami/argo-workflow-exec,3.5.1,2023/11/08,74,13,9,2,0,98
grafana/docs-base,20231115,2023/11/15,0,12,6,3,0,21
balenalib/odroid-xu4-debian-python,20230911,2023/09/11,118,37,40,6,0,201
balenalib/intel-nuc-debian,20231106,2023/11/06,114,20,29,4,0,167
appdynamics/machine-agent-netviz,23.5.0,2023/06/30,58,152,4,0,0,214
balenalib/via-vab820-quad-fedora-openjdk,30-20210825,2021/09/03,null
balenalib/amd64-fedora,20231103,2023/11/04,null
rancher/mirrored-longhornio-csi-snapshotter,v6.2.1,2023/01/04,0,3,3,0,0,6
rapidfort/haproxy24-ib,v2.4.24,2023/10/25,85,34,0,0,0,119
dynatrace/easytravel-pluginservice,2.0.0.3599,2023/08/04,31,16,46,12,0,105
intel/intel-fpga-plugin,0.28.0,2023/09/22,null
onlyoffice/4testing-docs-proxy-de,7.5.1-1-saas,2023/11/08,0,2,1,1,0,4
google/dart-runtime-base,2.16-beta,2021/12/13,190,104,123,39,9,465
astronomerinc/ap-init,3.18.4-2,2023/11/06,0,0,3,0,0,3
rancher/os-autoformat,v0.7.1,2016/11/11,null
rancher/pipeline-docker-publish,v0.2.0,2018/07/23,0,8,3,3,0,14
rancher/cli,v2.0.4,2018/08/10,0,8,0,2,0,10
bitnami/harbor-adapter-clair-archived,2.5.1,2022/06/20,97,67,60,18,0,242
bitnami/airflow-scheduler,2.7.3,2023/11/10,216,90,39,3,0,348
vmware/photon-2.0-kube-apiserver-amd64,v1.10.2-20180619,2018/06/19,15,81,98,70,0,264
mirantis/ucp-alertmanager,3.7.1,2023/09/26,2,2,4,2,0,10
mattermost/mattermost-build-redux,20210125_node-11.3-1,2018/12/08,609,1686,1396,322,16,4029
newrelic/k8s-nri-mysql,1.4.0,2019/11/25,null
balenalib/kitra520-ubuntu-openjdk,20210826,2021/09/21,136,435,10,0,0,581
balenalib/zynq-xz702-ubuntu-golang,20220523,2022/06/03,222,536,46,0,0,804
grafana/alpine,3.15.4,2022/04/05,0,12,10,1,0,23
objectscale/csi-attacher,v1.0.1,2018/12/05,0,0,0,2,0,2
dynatrace/easytravel-nginx,7.1,2018/05/11,62,136,141,48,23,410
grafana/grafana-ci-deploy,1.3.3,2022/07/20,17,52,36,3,0,108
onlyoffice/documentserver-integration,4.4.3.7,2017/08/11,323,467,31,1,0,822
grafana/query-tee,2.10.4,2023/11/13,0,0,4,0,0,4
airbyte/source-okta,0.1.16,2023/07/07,151,86,62,10,0,309
airbyte/source-amazon-seller-partner,1.6.2,2023/11/14,64,21,8,1,0,94
objectscale/csi-node-driver-registrar,v2.5.0,2022/02/03,0,4,6,0,0,10
rancher/mirrored-prometheus-alertmanager,v0.25.0,2022/12/22,0,4,4,0,0,8
airbyte/source-smartsheets,1.1.1,2023/06/07,77,25,22,2,0,126
airbyte/source-hellobaton,0.2.0,2023/08/24,0,15,26,1,0,42
appdynamics/db-agent,23.9.0-3436,2023/09/29,0,0,5,0,0,5
bitnami/gotrue,1.0.1,2023/11/08,74,17,19,2,0,112
bitnami/matomo,4.15.1,2023/10/11,156,83,57,5,2,303
kasmweb/oracle-7-desktop,1.14.0,2023/09/14,0,14,34,0,0,48
kasmweb/core-almalinux-9,1.14.0,2023/09/09,7,116,861,0,0,984
bitnami/jax,0.4.20,2023/11/16,77,12,9,2,0,100
balenalib/artik5-alpine-node,20220803,2022/08/04,7,38,36,10,0,91
balenalib/asus-tinker-board-alpine-python,20231106,2023/11/07,0,1,4,0,0,5
balenalib/raspberrypi3-alpine-python,20231106,2023/11/07,0,1,4,0,0,5
rancher/hardened-build-base,v1.21.3b1,2023/10/13,0,5,6,0,0,11
grafana/cortex-query-frontend,w37-0193e7b7,2018/09/11,0,0,0,2,0,2
redislabs/rcp-kubectl,4719504c7e53b421448a2f2e329a9c19,2020/04/02,181,336,45,1,0,563
objectscale/crunchy-postgres,ubi8-14.4-0,2023/08/30,267,93,16,0,0,376
appdynamics/machine-agent-analytics-arm64,23.10.0,2023/10/30,94,29,6,1,0,130
datadog/agent-buildimages-circleci-runner_test_only,v23305348-a2473651,2023/11/14,124,169,2,0,0,295
balenalib/via-vab820-quad-ubuntu-python,20220622,2022/06/23,87,113,13,0,0,213
rancher/mirrored-openpolicyagent-gatekeeper-crds,v3.13.0,2023/08/08,0,2,2,0,0,4
balenalib/orbitty-tx2-alpine-node,20231106,2023/11/06,0,1,5,0,0,6
newrelic/amazon-k8s-cni,246b3c71,2019/05/25,54,479,150,8,0,691
airbyte/source-snapchat-marketing,0.3.0,2023/06/13,0,16,27,1,0,44
rapidfort/vault,1.12.0,2023/11/20,0,6,7,0,0,13
balenalib/aarch64-debian-golang,20231106,2023/11/07,435,82,52,5,0,574
balenalib/artik710-fedora-python,20230712,2023/07/16,0,1,0,0,0,1
onlyoffice/4testing-docspace-webhooks-service,test-2022112110,2022/11/21,1033,308,328,19,0,1688
docker/github-actions,v1.1.0,2020/04/22,2,10,31,4,0,47
airbyte/source-firebolt,1.0.0,2023/08/23,1,15,26,1,0,43
grafana/grafana-enterprise-arm32v7-linux,7.0.6,2020/07/09,4,30,54,9,0,97
balenalib/stem-x86-32-ubuntu-python,20210826,2021/09/22,105,174,8,0,0,287
balenalib/intel-nuc,20231106,2023/11/06,114,20,29,4,0,167
docker/telemetry-tgz,1.0.0.linux-x86_64-test,2017/08/01,null
pachyderm/seldon-pachyderm-rsi-server,0.1.2,2021/02/10,105,77,87,32,7,308
rancher/k3d-proxy,5.3,2022/02/03,8,54,79,9,0,150
onlyoffice/docs-proxy-ee,7.5.1-1,2023/11/09,0,2,1,1,0,4
rancher/mirrored-cilium-hubble-relay,v1.14.4,2023/11/13,null
dynatrace/easytravel-angular-frontend,2.0.0.3599,2023/08/04,31,29,58,17,0,135
rancher/10-openvmtools,v0.8.0-rc9,2017/02/09,3,28,2,0,0,33
dynatrace/dynatrace-gcp-monitor,v1-latest,2023/09/21,65,25,8,1,0,99
balenalib/artik5-fedora,20220714,2022/07/23,null
intel/flexran_vdu,v22.07,2022/12/07,147,283,55,0,0,485
okteto/hello-world,1.0.0,2020/03/26,2,10,29,4,0,45
balenalib/nitrogen6x-debian,20220714,2022/07/20,124,68,74,18,0,284
bitnami/kong,3.4.2,2023/10/12,160,58,39,3,0,260
google/apigee-istio-citadel,1.4.6,2020/02/22,651,1308,152,0,0,2111
balenalib/zynq-xz702-alpine-python,20220714,2022/07/19,7,38,37,10,0,92
rancher/harvester-node-manager,v0.1.8,2023/11/20,null
airbyte/source-file-secure,0.3.13,2023/10/13,65,24,8,2,0,99
onlyoffice/documentserver-ee-ucs,7.5.1.1,2023/11/08,116,107,3,1,0,227
balenalib/amd64-alpine-node,20231106,2023/11/07,0,1,5,0,0,6
balenalib/spacely-tx2-fedora-node,20231106,2023/11/06,0,1,1,0,0,2
portainer/volume-browser,develop,2018/07/16,null
balenalib/kitra710-alpine-openjdk,8-20230904,2023/09/09,8,8,8,2,0,26
cockroachdb/bazel-fips,20230815-175543,2023/08/15,152,209,19,0,0,380
kong/nightly-ingress-controller,2023-11-15,2023/11/15,null
balenalib/generic-aarch64-ubuntu-node,20231103,2023/11/06,38,10,1,0,0,49
onlyoffice/4testing-docspace-proxy-runtime,v1.0.0,2023/09/04,153,262,19,0,0,434
pachyderm/rrt-modeling,sort,2018/02/20,0,26,19,10,0,55
bitnami/cluster-autoscaler,1.28.0,2023/11/08,74,14,15,2,0,105
airbyte/source-pokeapi,0.2.0,2023/10/11,0,14,26,1,0,41
onlyoffice/docspace-api,1.1.4.1,2023/10/23,1016,143,210,12,0,1381
rancher/k8s-codegen,1.11,2018/11/27,310,494,31,0,0,835
bitnami/jenkins-agent,0.3192.0,2023/10/27,84,14,15,4,0,117
rancher/opdom,v0.1.0,2022/12/07,4,55,31,0,10,100
airbyte/source-cockroachdb-strict-encrypt,0.1.22,2023/03/22,61,183,134,2,0,380
okteto/crontab,0.0.6,2020/10/10,2,10,32,4,0,48
newrelic/k8s-nri-consul,2.0.3,2019/10/25,null
airbyte/source-coda,1.2.0,2023/08/25,0,15,26,1,0,42
airbyte/integration-singer-exchangeratesapi_io-source,0.1.3,2020/10/07,2,26,48,11,0,87
cockroachdb/cockroach-django-builder,20211210,2021/12/10,347,972,65,0,0,1384
vmware/vke-infra-toolchain,1.0.1,2018/09/21,17,136,210,102,0,465
balenalib/aarch64-fedora,20231106,2023/11/06,null
okteto/rails,6,2020/07/22,1386,1132,1068,120,21,3727
docker/ucp-dsinfo-s390x,3.1.0-beta3,2018/10/04,131,358,15,4,0,508
docker/kube-compose-controller,v0.5.0,2022/02/14,0,6,14,1,0,21
docker/kube-compose-installer,v0.5.0,2022/02/14,0,6,14,1,0,21
atlassian/bitbucket-mesh,2.2.0,2023/11/18,60,65,2,0,0,127
bitnami/harbor-registryctl,2.9.1,2023/11/08,74,13,9,2,0,98
docker/ucp-auth,3.3.1,2020/06/26,2,8,9,1,0,20
rancher/mirrored-cluster-proportional-autoscaler,1.8.6,2022/07/27,0,3,5,1,0,9
rancher/os-vboxtools,v5.2.26-5,2019/08/13,34,21,36,6,7,104
balenalib/apalis-imx6q-ubuntu-node,20220715,2022/07/19,88,104,12,0,0,204
balenalib/amd64-ubuntu-python,20230929,2023/10/07,39,11,4,0,0,54
bitnami/mongodb-sharded,7.0.3,2023/11/17,84,14,15,4,0,117
balenalib/artik530-ubuntu-python,20220715,2022/08/02,87,83,13,0,0,183
rancher/support-bundle-kit,v0.0.29,2023/10/30,0,2,7,0,0,9
hashicorp/envconsul,0.13.2,2023/05/22,0,10,5,3,0,18
rancher/mirrored-bci-micro,15.4.14.3,2022/09/26,0,5,4,0,2,11
docker/getting-started,vscode,2020/07/08,6,22,48,6,0,82
airbyte/source-retently,0.2.0,2023/08/08,0,15,26,1,0,42
ubuntu/prometheus,2.46.0-22.04,2023/10/05,22,19,6,0,0,47
rancher/os-openvmtools,10.3.10-2,2019/05/10,47,46,44,7,7,151
balenalib/odroid-xu4-ubuntu-python,20231026,2023/11/02,37,10,0,0,0,47
nginxinc/amplify-agent,1.8.1,2023/02/02,116,122,78,6,0,322
mattermost/backup-restore-tool,8005000,2023/03/28,2,22,13,0,0,37
puppet/tlser,1.3.2,2021/06/30,0,3,7,0,0,10
objectscale/objectscale-portal,1.4.0-337.edaba629,2023/11/14,0,0,2,0,0,2
bitnami/harbor-notary-signer-archived,2.8.4,2023/09/15,83,177,229,2,0,491
onlyoffice/4testing-ds-example-de,6.2.0-eu-r2,2021/03/04,544,491,32,3,0,1070
balenalib/fincm3-node,20230530,2023/07/02,118,38,41,6,0,203
balenalib/artik530-debian-node,20220714,2022/07/20,124,70,75,18,0,287
jetbrains/qodana-php,2023.2,2023/09/06,487,164,136,16,0,803
airbyte/source-prestashop,1.0.0,2023/06/27,151,86,62,10,0,309
balenalib/odroid-c1-debian,20220714,2022/07/20,124,68,74,18,0,284
datadog/chaos-controller,8.3.0,2023/10/26,11,3,3,0,0,17
mirantis/ucp-controller,3.7.1,2023/09/26,4,5,8,2,0,19
balenalib/asus-tinker-board-fedora-golang,20221210,2022/12/13,null
docker/ucp-hyperkube-s390x,3.1.0-beta3,2018/10/04,173,435,12,0,0,620
kasmweb/rockylinux-8-desktop,1.14.0,2023/09/14,0,17,812,0,0,829
mirantis/mysql,5.6,2018/09/19,39,51,49,11,15,165
balenalib/apalis-imx6q-node,18.6-20220714,2022/07/21,124,70,75,18,0,287
mirantis/ucp-agent,3.7.1,2023/09/26,4,5,8,2,0,19
docker/dtr-rethink,2.8.1,2020/06/17,3,10,15,1,0,29
rapidfort/telegraf,1.28.2,2023/10/17,18,5,4,0,0,27
balenalib/am571x-evm-debian,20220714,2022/07/20,124,68,74,18,0,284
mirantis/dtr-api,3.0.0-alpha.2,2021/09/22,5,32,53,5,0,95
airbyte/source-xero,0.2.3,2023/06/19,0,13,19,0,0,32
vmware/photon-2.0-pause-amd64,v1.10.2-20180619,2018/06/19,null
balenalib/i386-ubuntu-golang,1.20.1-xenial-20230911,2023/09/11,null
balenalib/spacely-tx2-alpine-openjdk,8-20231106,2023/11/06,6,6,4,0,0,16
balenalib/qemux86-64-alpine-golang,20231106,2023/11/07,0,0,4,0,0,4
rapidfort/mariadb-official,10.10.5,2023/06/09,1,4,1,0,0,6
kasmweb/almalinux-9-desktop,1.14.0,2023/09/14,7,141,891,0,0,1039
grafana/beyla,1.0.0,2023/11/14,55,8,2,1,0,66
vmware/photon-2.0-kubernetes-dashboard-amd64,v1.8.3-20180619,2018/06/19,null
intel/power-operator,v2.3.1,2023/08/28,0,3,2,0,0,5
balenalib/odroid-c1-fedora,20220604,2022/06/12,null
grafana/grafana-dev-arm64v8-linux,master-91219227-4f9f-465a-8ea0-70670344aaaa-ubuntu,2020/05/15,130,274,40,4,0,448
redislabs/ng-ci-runner,626671509cd9430c7dac72b85cd223f2,2022/08/15,514,322,289,30,1,1156
rancher/hardened-ib-sriov-cni,v1.0.0,2021/03/02,241,326,20,3,0,590
bitnami/percona-mysql,8.0.34-26,2023/11/15,160,61,31,3,0,255
rancher/etc-host-updater,v0.0.3,2017/07/21,306,388,24,0,0,718
airbyte/source-us-census,0.1.2,2021/12/28,104,59,73,27,7,270
atlassian/crowd,5.2.0,2023/11/18,32,42,67,41,0,182
balenalib/beaglebone-green-wifi-debian-python,20230911,2023/09/12,118,37,40,6,0,201
balenalib/bananapi-m1-plus-ubuntu-openjdk,11-xenial-20231026,2023/11/02,null
rancher/mirrored-coreos-kube-state-metrics,v1.9.7,2020/06/03,0,8,14,0,6,28
astronomerinc/ap-registry,3.18.4-1,2023/11/06,0,0,3,0,0,3
portainer/greengrass-components-examples,sub,2022/08/12,59,143,120,0,0,322
balenalib/kitra710-fedora-python,20230712,2023/07/16,0,1,0,0,0,1
couchbase/fluent-bit,1.2.6,2023/06/05,76,19,19,2,0,116
amazon/aws-sam-cli-emulation-image-java11,20220125,2022/01/25,1,49,13,0,0,63
kasmweb/core-oracle-7,1.14.0,2023/09/09,0,11,6,0,0,17
ubuntu/traefik,2.10.4-22.04,2023/10/05,22,18,3,0,0,43
rapidfort/mariadb-ib,10.5.20,2023/11/08,87,144,10,0,0,241
circleci/shutdown-hook-poller,0.1,2020/11/16,103,80,79,24,6,292
docker/ucp-interlock-extension-s390x,3.1.0-beta3,2018/10/04,0,2,6,16,0,24
kasmweb/kali-rolling-desktop,1.14.0,2023/09/14,null
amazon/cloudwatch-agent,1.300031.1b317,2023/11/10,0,9,12,0,0,21
grafana/drone-autoscaler,1.7.5-grafana9,2021/11/19,4,16,19,0,0,39
formio/pdf-libs,5.0.2-rc.1,2023/04/17,0,6,0,0,0,6
balenalib/spacely-tx2-debian-openjdk,20231106,2023/11/07,125,43,31,4,0,203
rancher/coredns,v1.6.9,2020/09/12,260,412,32,3,0,707
balenalib/odroid-xu4-debian-openjdk,20230911,2023/09/11,129,64,44,6,0,243
intel/cri-resmgr-webhook,v0.8.4,2023/08/25,0,2,1,0,0,3
balenalib/qemux86-64,20231106,2023/11/06,114,20,29,4,0,167
cockroachdb/activerecord_test_container,20210914,2021/09/14,957,1049,954,183,26,3169
balenalib/spacely-tx2-alpine-node,20231106,2023/11/06,0,1,5,0,0,6
pachyderm/kube-event-tail,v0.0.7,2022/10/27,0,5,8,0,4,17
objectscale/decks,2.71.3,2021/04/14,2,18,23,0,0,43
rancher/terraform-operator,v0.0.5,2019/03/26,6,14,27,5,0,52
rancher/kubernetes,v1.18.4,2020/08/11,259,400,18,3,0,680
onlyoffice/4testing-ds-spellchecker,6.0.0,2020/10/21,563,567,32,3,0,1165
grafana/logcli,2.9.2-arm64,2023/10/25,0,1,5,0,0,6
objectscale/cmf-switch,0.71.3,2021/04/14,2,19,24,0,0,45
airbyte/source-recharge,1.1.2,2023/11/03,64,21,8,1,0,94
rancher/hyperkube,v1.27.7-rancher1-linux-arm64,2023/11/10,39,43,22,0,0,104
okteto/terminal,0.4,2021/03/11,19,76,81,13,0,189
intel/intel-qat-plugin,0.28.0,2023/09/22,null
objectscale/crunchy-postgres-exporter,ubi8-5.1.2-0,2022/07/05,78,111,12,0,0,201
greenbone/boreas-build,v22.5.0,2023/05/02,487,173,130,14,0,804
bitnami/grafana-operator,5.4.2,2023/11/08,74,12,8,2,0,96
grafana/agent-boringcrypto,v0.37.4,2023/11/06,14,6,1,0,0,21
rancher/mirrored-coredns-coredns,1.10.1,2023/02/06,0,3,3,0,0,6
balenalib/ts4900-fedora-python,20220622,2022/07/12,0,1,1,0,0,2
continuumio/sourceclear,v2,2018/11/02,203,471,13,0,0,687
hashicorp/nomad-driver-podman,0.2.0,2020/12/18,6,25,49,7,0,87
circleci/k8s-release-agent,0.1.206,2023/11/10,0,3,4,0,0,7
balenalib/bananapi-m1-plus-ubuntu-golang,20231026,2023/11/02,133,131,0,0,0,264
bitnami/jupyter-base-notebook,4.0.2,2023/11/16,83,24,15,3,0,125
lacework/code-security-gitlab,690c3699,2023/09/26,2,11,5,2,0,20
continuumio/planet-gpu,5.1.2-1907,2018/06/06,394,1967,1688,229,30,4308
airbyte/source-files-abstract,0.1.0,2022/04/11,104,60,74,28,7,273
balenalib/kitra520,20220714,2022/07/22,124,68,74,18,0,284
rancher/harvester-os,29221228,2022/12/28,11,82,63,2,0,158
airbyte/source-kustomer-singer,0.1.2,2021/12/25,0,21,51,8,0,80
jetbrains/upsource-file-clustering,2020.1.1992,2022/03/11,79,148,245,95,0,567
rancher/mirrored-directxman12-k8s-prometheus-adapter,v0.8.4,2021/03/31,null
bitnami/kube-state-metrics,2.10.1,2023/11/09,74,12,8,2,0,96
balenalib/artik10-node,20220714,2022/07/20,124,70,75,18,0,287
greenbone/notus-data,community,2023/11/21,null
onlyoffice/4testing-docspace-backup-background,2.0.0.33,2023/11/15,1016,142,207,12,0,1377
atlassian/confluence-server,8.6.1,2023/11/18,23,20,7,2,0,52
rancher/jaegertracing-all-in-one,1.20.0,2020/09/29,0,7,12,0,0,19
docker/dtr-garant,2.8.1,2020/06/17,2,9,8,1,0,20
objectscale/vnest,3.9.0.0-139102.b4b5064355c,2023/05/03,11,45,42,2,0,100
datadog/agent-buildimages-rpm_x64,v20433308-6861270,2023/09/25,1639,2002,194,6,0,3841
onlyoffice/4testing-appserver-migration-runner,test-2022081607,2022/08/16,73,83,123,7,0,286
balenalib/parallella-alpine-golang,20230904,2023/09/09,2,0,7,2,0,11
balenalib/orbitty-tx2-python,20231106,2023/11/07,114,21,29,4,0,168
redislabs/rebloom,2.6.8,2023/10/23,72,14,12,2,0,100
bitnami/fluent-bit,2.2.0,2023/11/08,74,12,8,2,0,96
balenalib/artik10-ubuntu-python,20220715,2022/08/02,87,83,13,0,0,183
grafana/query-frontend,r56-04edcb97f-WIP,2019/07/11,0,0,0,2,0,2
onlyoffice/4testing-appserver-webhooks-service,test-2022081607,2022/08/16,1037,333,357,24,1,1752
intel/openfl,1.5.1,2023/10/24,30,15,0,0,0,45
balenalib/intel-nuc-alpine-openjdk,8-20231106,2023/11/07,0,0,4,0,0,4
balenalib/intel-nuc-fedora-node,20231103,2023/11/04,0,1,1,0,0,2
rancher/local-path-provisioner,v0.0.24,2023/03/23,0,17,6,0,0,23
graphcore/ipu-operator-vipu-proxy,1.2.0,2023/05/30,31,15,2,0,0,48
rapidfort/redis-cluster,7.2.1,2023/11/17,28,4,2,0,0,34
datadog/agent-buildimages-circleci-runner,v22941763-c6364642,2023/11/07,126,169,2,0,0,297
pachyderm/jupyterhub-pachyderm-hub,1.1.0,2020/04/16,657,996,87,2,0,1742
balenalib/beaglebone-green-ubuntu-python,20230911,2023/09/12,42,11,4,0,0,57
netdata/builder,v2,2023/11/22,247,65,40,2,0,354
mattermost/oncall-notifier,v0.1.0,2020/10/27,2,19,41,4,0,66
balenalib/qemux86-64-fedora-openjdk,8-20231103,2023/11/04,null
circleci/openjdk,11.0.8,2020/10/05,935,828,851,135,19,2768
airbyte/source-woocommerce,0.2.3,2023/06/02,0,15,27,1,0,43
bitnami/solr,9.4.0,2023/11/16,89,23,31,6,0,149
balenalib/fincm3-ubuntu,20230904,2023/09/09,42,10,4,0,0,56
airbyte/destination-qdrant,0.0.7,2023/11/13,64,7,5,4,0,80
rancher/coreos-kube-state-metrics,v1.9.7,2020/06/03,0,8,14,0,6,28
kumahq/kuma-net-ebpf,0.8.10,2022/12/14,null
rancher/mirrored-prometheus-adapter-prometheus-adapter,v0.10.0,2022/08/12,0,3,8,0,0,11
grafana/plugin-validator-cli,v1,2021/04/27,0,7,31,4,0,42
balenalib/spacely-tx2-alpine-golang,20231106,2023/11/06,0,0,4,0,0,4
rancher/os-headers,v0.7.1,2016/10/19,null
datadog/docker-filter,1.2.1,2019/01/04,2,6,7,8,0,23
rancher/rke-cert-deployer,v0.1.1,2018/01/15,0,10,5,0,0,15
grafana/tns-db,842bd3b,2021/10/31,2,14,13,0,0,29
balenalib/odroid-c1-ubuntu-python,20220622,2022/06/23,87,113,13,0,0,213
rancher/goharbor-notary-server-photon,v0.6.1-v1.7.5,2019/04/01,14,63,88,37,0,202
balenalib/beaglebone-black-golang,20230911,2023/09/12,442,111,73,9,0,635
redislabs/redis-connect-oracle,0.6.2-3,2022/01/22,4,27,38,13,0,82
rancher/prometheus,v2.5.0,2018/11/06,null
pachyderm/notebooks-user-transformers,3ed85e7bffe50b2fb5293ab74d5c5c7f06946b26,2023/08/04,220,620,61,2,0,903
balenalib/i386-nlp,20210225,2021/04/19,195,119,140,43,9,506
circleci/circle-admin-cli,0.1,2020/01/13,2,36,75,6,0,119
dynatrace/dynatrace-synthetic-vuc-worker,1.277.53.20231106-153656,2023/10/10,21,10,3,0,0,34
rancher/k3s,v1.28.3-k3s2-s390x,2023/11/08,0,7,7,0,0,14
balenalib/revpi-core-3-debian,20230911,2023/09/11,118,36,40,6,0,200
intel/intelligent_traffic_management_analytics,2.0,2022/11/15,102,216,15,0,0,333
bitnami/supabase-storage,0.43.11,2023/11/16,77,16,9,6,0,108
airbyte/source-smartengage,0.1.0,2022/11/13,0,17,27,1,0,45
balenalib/bananapi-m1-plus-alpine-python,20231106,2023/11/07,0,1,4,0,0,5
rancher/istio-mixer,1.7.6,2020/12/08,1,9,15,1,4,30
newrelic/newrelic-pixie-integration,2.1.4,2023/06/22,0,9,6,3,0,18
rancher/harvester,v1.2.1,2023/10/26,0,1,6,0,0,7
grafana/containerized-systemd,debian-10,2022/06/27,121,62,56,12,6,257
balenalib/aarch64-ubuntu,20231103,2023/11/06,34,9,0,0,0,43
rancher/mirrored-neuvector-controller,5.2.3,2023/11/10,0,0,2,0,0,2
rancher/terraform-controller-appliance,v0.0.13-alpha1,2020/11/19,null
airbyte/source-talkdesk-explore,0.1.0,2022/05/26,0,21,51,8,0,80
balenalib/raspberry-pi2-alpine,20231106,2023/11/07,0,0,4,0,0,4
google/apigee-cert-manager-webhook,v0.12.0,2019/11/28,0,0,0,0,6,6
rancher/jenkins-swarm,v0.3.0,2016/08/09,119,459,479,214,35,1306
balenalib/orangepi-plus2-ubuntu-golang,20231026,2023/11/02,133,131,0,0,0,264
circleci/exim,0.2,2022/02/23,108,90,176,26,1,401
balenalib/colibri-imx6dl-node,18.6-20220714,2022/07/21,124,70,75,18,0,287
airbyte/destination-listen-and-echo,dev,2021/05/21,99,45,56,19,6,225
circleci/testing-cli,1.0.0,2018/05/01,442,1390,974,250,72,3128
bitnami/apisix,3.6.0,2023/11/04,95,29,12,2,0,138
rancher/istio-node-agent-k8s,1.5.9,2020/08/07,405,1084,143,0,0,1632
balenalib/zynq-xz702-alpine-golang,20220714,2022/07/27,8,39,40,12,0,99
docker/extension-npm-installer,0.2.14,2022/11/16,0,11,11,0,0,22
rancher/kubernetes-dashboard-amd64,v1.10.1,2018/12/17,null
portainer/agent-k8s-beta,linux-arm,2020/03/30,null
balenalib/orbitty-tx2-debian-openjdk,20231106,2023/11/07,125,43,31,4,0,203
vmware/mariadb-photon,10.2.10,2017/11/21,11,110,119,59,0,299
airbyte/source-freshdesk,3.0.4,2023/06/23,0,16,27,1,0,44
balenalib/artik5-debian-golang,20220714,2022/07/22,467,265,220,28,1,981
redislabs/redisedgevision-bionic,0.1.1,2019/06/11,235,517,41,6,0,799
balenalib/hummingboard-fedora-golang,20221210,2022/12/13,null
redislabs/redis-connect-db2,0.7.0-18,2022/01/22,4,27,36,13,0,80
rancher/mirrored-s3gw-s3gw,v0.14.0,2023/03/30,5,36,15,0,1,57
balenalib/nitrogen6x-openjdk,20210602,2021/06/05,230,232,145,39,8,654
rapidfort/mysql8-ib,8.0.31,2023/10/25,103,40,0,0,0,143
sysdig/agent-s390x,0.78.1,2018/03/15,null
rancher/mirrored-cilium-operator-aws,v1.14.4,2023/11/13,0,1,0,0,0,1
kasmweb/core-oracle-8,1.14.0,2023/09/09,4,13,820,0,0,837
bitnami/kubewatch-archived,0.1.0,2022/03/23,130,82,85,23,6,326
intel/flexran_l1_spree,v23.07,2023/10/12,79,116,10,0,0,205
airbyte/source-yandex-metrica,1.0.0,2023/03/20,0,16,27,1,0,44
vmware/vsan-prometheus-operator,v20210225,2021/02/26,14,100,109,45,0,268
rancher/strato,0.0.3,2018/01/16,null
kasmweb/manager,1.14.0,2023/09/14,28,10,1,0,0,39
vmware/photon-2.0-wavefront-proxy,v4.26-20180619,2018/06/19,41,146,204,88,0,479
balenalib/nitrogen6x-fedora-node,36-build-20220714,2022/07/22,0,1,1,0,0,2
balenalib/rpi-debian-golang,20231106,2023/11/07,372,51,44,5,0,472
airbyte/source-everhour,0.1.0,2023/03/23,0,16,27,1,0,44
balenalib/parallella-debian-python,20230904,2023/09/09,118,37,40,6,0,201
lacework/datacollector,6.10.0,2023/11/10,19,8,0,0,0,27
mattermost/channel-spammer,0.0.4,2021/05/07,2,22,40,4,0,68
atlassian/proforma-jre-with-fonts,8u121-jre-alpine,2020/04/27,9,25,17,13,0,64
balenalib/generic-aarch64-fedora,20231106,2023/11/06,null
vmware/lightwave-sts-photon2,1.3.1-35,2018/08/24,37,165,311,101,0,614
docker/runc,v1.0.0-rc5,2018/08/07,null
objectscale/kahm,v2.74.0,2021/05/25,2,18,24,0,0,44
balenalib/kitra710-ubuntu-python,20230904,2023/09/09,42,11,4,0,0,57
pingidentity/pingdelegator,2310,2023/11/01,0,2,1,0,0,3
rancher/vm-rancheros,1.4.2,2018/11/27,null
atlassian/bamboo-specs-runner,9.4.1,2023/11/07,72,89,9,13,0,183
bitnami/keycloak-config-cli,5.9.0,2023/11/15,74,12,8,2,0,96
balenalib/amd64-alpine-python,20231106,2023/11/07,0,1,4,0,0,5
kumahq/kuma-dp,2.4.4,2023/11/06,7,4,4,0,0,15
rancher/goharbor-notary-signer-photon,v0.6.1-v1.7.5,2019/04/01,14,63,88,37,0,202
balenalib/amd64-debian-openjdk,20231106,2023/11/06,118,43,25,4,0,190
vmware/photon-2.0-k8s-dns-dnsmasq-nanny-amd64,1.14.10-20180619,2018/06/19,19,75,92,57,0,243
kasmweb/debian-bullseye-desktop,1.14.0,2023/09/14,981,387,438,91,4,1901
airbyte/source-orbit,0.3.0,2023/10/25,0,13,26,1,0,40
rancher/longhorn-driver,88639e7,2017/12/12,89,230,14,0,0,333
airbyte/integration-base-python,20230210,2023/02/10,0,9,9,0,0,18
balenalib/beaglebone-green-alpine,20231106,2023/11/07,0,0,4,0,0,4
bitnami/testlink-archived,1.9.20,2022/03/23,297,278,162,24,13,774
bitnami/wavefront-adapter-for-istio-archived,0.1.5,2022/07/09,94,68,76,16,0,254
balenalib/amd64-node,20231106,2023/11/06,107,22,24,4,0,157
hashicorp/consul,1.17,2023/11/03,0,0,3,0,0,3
objectscale/rep,0.71.3,2021/04/15,13,89,98,14,3,217
rancher/grafana,5.3.0,2018/10/10,55,45,77,24,10,211
airbyte/source-googleanalytics-singer,0.2.6,2021/06/25,567,315,280,39,7,1208
pingidentity/pingcentral,2310,2023/11/01,7,19,11,2,0,39
objectscale/csi-baremetal-controller,0.69.0,2021/03/07,2,17,26,1,0,46
bitnami/geode-archived,1.15.1,2022/11/30,77,57,57,16,0,207
vmware/dind-sshuttle-bosh-ci,dev,2018/09/26,3,51,14,19,0,87
purestorage/psctl,v1.1.2,2022/07/07,0,2,6,0,0,8
docker/hub-explorer-extension,0.0.5,2022/03/09,0,15,22,1,0,38
mirantis/ucp-csi-node-driver-registrar,3.5.3,2022/04/05,0,0,0,0,6,6
docker/desktop-kubernetes-controller-manager,v1.28.2,2023/09/13,0,3,4,0,0,7
docker/ucp-swarm-s390x,3.1.0-beta3,2018/10/04,0,1,7,8,0,16
rancher/mirrored-idealista-prom2teams,4.2.1,2022/12/21,1,25,26,0,0,52
balenalib/beaglebone-green-alpine-openjdk,8-20231106,2023/11/07,0,0,4,0,0,4
lacework/container-auto-scan,1.1.2,2023/03/28,77,33,26,2,0,138
objectscale/objectscale-component-pre-update,1.4.0-397.adb0726,2023/11/13,0,3,4,0,0,7
redislabs/redismod,feature-search-json,2021/04/19,151,96,140,42,9,438
bitnami/drupal,10.1.6,2023/11/03,160,81,52,4,2,299
balenalib/asus-tinker-board-s-fedora-node,36-build-20230530,2023/06/29,0,1,1,0,0,2
datadog/agent-buildimages-system-probe_arm64,v22885174-c6364642,2023/11/06,845,346,281,7,0,1479
bitnami/etcd,3.5.10,2023/11/20,72,12,10,2,0,96
ubuntu/jre,17-22.04_24,2023/10/31,null
circleci/api-gateway-test-server,0.2.629-9503714,2023/02/02,0,4,4,0,0,8
grafana/loki-docker-driver,2.9.2,0001/01/01,0,2,5,0,0,7
airbyte/integration-singer-postgres-source,0.1.3,2020/10/07,126,101,161,32,11,431
rancher/mirrored-k8s-dns-dnsmasq-nanny,1.22.20,2023/02/22,11,14,6,0,0,31
balenalib/zynq-xz702-debian-python,20220604,2022/06/12,124,81,76,20,0,301
google/deepsomatic,1.6.0,2023/10/19,123,171,8,0,0,302
kasmweb/filezilla,1.14.0,2023/09/14,189,380,0,0,0,569
bitnami/fluentd,1.16.2,2023/11/15,159,60,28,2,0,249
airbyte/destination-convex,0.2.0,2023/05/24,0,15,27,1,0,43
kasmweb/thunderbird,1.14.0,2023/09/14,187,411,0,0,0,598
onlyoffice/4testing-docspace-proxy,1.1.3.2484,2023/09/08,153,262,19,0,0,434
astronomerinc/ap-redis,6.2.13,2023/09/25,137,58,25,3,0,223
bitnami/external-dns,0.14.0,2023/11/08,74,12,8,2,0,96
docker/dockerfile-upstream,1.6,2023/07/12,0,4,5,0,0,9
mattermost/mattermod,0.18.0,2023/10/11,35,37,19,0,0,91
kong/pulp-worker,1.1.38,2022/08/24,4,11,9,4,0,28
balenalib/odroid-xu4-debian-golang,20230911,2023/09/11,442,111,73,9,0,635
bitnami/jupyterhub,4.0.2,2023/11/16,84,22,14,3,0,123
airbyte/source-appstore-singer,0.2.6,2021/12/23,3,24,52,8,0,87
balenalib/apalis-imx6q-ubuntu-golang,20220523,2022/06/03,222,536,46,0,0,804
appdynamics/infra-agent,21.5.0-1784,2021/04/27,77,99,64,0,0,240
balenalib/orbitty-tx2-ubuntu-openjdk,11-xenial-20231103,2023/11/06,null
hashicorp/consul-enterprise-fips,1.17.0-ent.fips1402-ubi,2023/11/03,37,19,3,0,0,59
balenalib/odroid-c1-python,20220604,2022/06/12,124,81,76,20,0,301
onlyoffice/4testing-ds-spellchecker-de,6.2.0-eu-r2,2021/03/04,544,491,32,3,0,1070
rancher/plugin-manager,v0.2.12,2016/11/30,306,399,26,0,0,731
balenalib/am571x-evm-ubuntu-openjdk,20210826,2021/09/04,136,435,10,0,0,581
rancher/istio-galley,1.5.9,2020/08/07,405,1084,142,0,0,1631
greenbone/pg-gvm,22.6.1,2023/07/26,120,32,37,2,0,191
docker/ucp-calico-kube-controllers-s390x,3.1.0-beta3,2018/10/04,0,2,2,2,0,6
vmware/admiral_agent,1.3.1,2018/07/23,8,55,72,37,0,172
kasmweb/sublime-text,1.14.0,2023/09/14,187,380,0,0,0,567
kasmweb/core-rockylinux-9,1.14.0,2023/09/09,0,2,2,0,0,4
balenalib/intel-nuc-golang,20231106,2023/11/06,436,83,52,5,0,576
amazon/aws-lambda-java,21-preview,2023/11/12,null
rancher/pipeline-jenkins-server,v0.1.5,2020/02/14,214,200,269,76,9,768
grafana/mv-manager,7770886,1970/01/01,0,2,2,0,0,4
mattermost/mirror-sync-gitlab,latest-0743b65,2021/12/20,0,10,21,1,0,32
rapidfort/zookeeper-ib,3.8.2,2023/08/31,14,13,3,1,0,31
balenalib/amd64-openjdk,20231106,2023/11/06,118,43,25,4,0,190
redislabs/memtier_benchmark,2.0.0,2023/06/22,null
balenalib/odroid-c1-alpine-python,20220714,2022/07/19,7,38,37,10,0,92
circleci/cassandra,3.10,2017/05/25,59,174,159,79,23,494
balenalib/artik530-openjdk,20220714,2022/07/22,157,127,85,18,0,387
rapidfort/mariadb,11.1.2,2023/10/20,21,4,2,1,0,28
balenalib/asus-tinker-board-s-debian-node,20230911,2023/09/12,118,38,41,6,0,203
objectscale/telemetry-upload,3.0.4-413.8230f25,2023/10/03,2,3,5,0,0,10
balenalib/i386-nlp-debian-node,7.10.1,2018/11/07,398,1019,720,182,45,2364
airbyte/source-survey-sparrow,0.2.0,2022/12/09,0,16,27,1,0,44
balenalib/via-vab820-quad-python,20220604,2022/06/12,124,81,76,20,0,301
docker/artifactory-docker-desktop,v1.0.45,2023/10/02,null
rancher/vm-rhel,7.6-x86_64,2018/11/26,null
onlyoffice/documentserver-ee,7.5.1.1,2023/11/05,123,91,1,1,0,216
rancher/jimmidyson-configmap-reload,v0.4.0,2020/07/13,0,1,1,0,0,2
grafana/ci-e2e,12.19.0-1,2020/10/20,469,647,576,90,10,1792
rancher/rancher-csp-adapter,v3.0.0,2023/10/23,0,3,5,0,0,8
airbyte/source-convex,0.2.0,2023/06/21,0,13,19,0,0,32
datadog/cws-instrumentation,7.50.0-devel.git.506.5fb6ed0.pipeline.22983080,2023/11/07,null
rancher/mirrored-skopeo-skopeo,v1.13.2,2023/08/29,null
rancher/squareup-ghostunnel,v1.5.2,2019/11/20,5,17,34,2,0,58
puppet/puppetexplorer,2.0.0,2017/10/24,0,19,8,18,0,45
rancher/mirrored-istio-pilot,1.19.0,2023/09/01,29,14,6,0,0,49
continuumio/miniconda,4.7.12,2019/10/16,217,214,283,60,10,784
greenbone/ospd-openvas,22.6.1,2023/10/24,115,45,32,4,0,196
intel/pilot,1.19.0-intel.0,2023/09/27,29,14,6,0,0,49
airbyte/source-mysql,3.1.7,2023/11/08,2,30,15,2,0,49
balenalib/odroid-xu4-fedora-node,36-build-20230530,2023/06/29,0,1,1,0,0,2
bitnami/rmq-default-credential-updater,1.0.4,2023/11/09,null
balenalib/artik533s-fedora-openjdk,8-20220224,2022/03/05,null
rancher/strato-min,0.0.2,2017/01/02,null
bitnami/spring-cloud-skipper,2.11.1,2023/11/15,74,12,14,4,0,104
rancher/opni-inference-service,v0.12.1-rc1,2023/11/10,8,70,76,5,11,170
balenalib/beaglebone-black-fedora,20221109,2022/12/04,null
passbolt/labs,2.13.5-fpm,1970/01/01,84,249,188,59,6,586
hashicorp/secrets-store-csi-driver-provider-vault,0.0.7,2021/01/20,2,14,14,1,0,31
docker/ucp-agent,3.3.1,2020/06/26,2,8,9,1,0,20
redislabs/redisedge-bionic,0.1,2019/06/09,94,76,7,0,0,177
nginxinc/mra_python_base,3.5,2018/05/31,418,1554,1058,274,69,3373
balenalib/jetson-tx1-debian,20230530,2023/06/28,118,39,41,6,0,204
rancher/goharbor-chartmuseum-photon,v0.8.1-v1.7.5,2019/04/01,14,63,88,37,0,202
rancher/storage-rbd,v0.9.7,2018/07/09,251,509,17,0,0,777
balenalib/bananapi-m1-plus-ubuntu,20231026,2023/11/02,37,9,0,0,0,46
mirantis/dtr,2.9.14,2023/09/28,2,13,10,0,0,25
mattermost/notice-file-generator-daily,v0.0.2,2022/07/08,0,2,4,0,0,6
rancher/mirrored-cloud-provider-vsphere-csi-release-syncer,v3.1.1,2023/10/24,3,8,9,3,0,23
google/apigee,nginx,2019/04/16,43,55,81,31,7,217
balenalib/beaglebone-black-node,20230911,2023/09/12,118,38,41,6,0,203
snyk/container-registry-agent,70316042f6291a25d1ddf2e0535c057570aebd42,2021/11/10,0,21,47,6,0,74
rancher/security-scan,v0.2.13,2023/09/12,2,6,14,0,3,25
airbyte/source-dockerhub,0.2.0,2023/08/24,0,15,26,1,0,42
balenalib/qemux86-64-debian,20231106,2023/11/06,114,20,29,4,0,167
objectscale/objectscale-operator,0.71.3,2021/04/19,4,15,18,0,0,37
balenalib/generic-armv7ahf-ubuntu-python,20230904,2023/09/09,42,11,4,0,0,57
rancher/connectivity-check,v0.0.8,2018/07/17,306,388,24,0,0,718
mirantis/k8s-netchecker-agent,v1.2.2,2018/01/02,null
airbyte/source-posthog,0.1.15,2023/11/03,64,7,4,1,0,76
rancher/tektoncd-controller,80e040a5,2019/05/29,0,0,0,0,6,6
bitnami/wavefront-prometheus-storage-adapter,1.0.7,2023/06/17,74,26,19,2,0,121
balenalib/rpi-alpine-openjdk,8-20231026,2023/11/01,8,8,4,0,0,20
balenalib/beaglebone-green-wifi-debian-golang,20230911,2023/09/12,442,111,73,9,0,635
rancher/mirrored-cilium-kvstoremesh,v1.14.4,2023/11/13,null
airbyte/source-weatherstack,0.1.0,2022/11/07,0,15,19,0,0,34
mattermost/mattermost-push-proxy,5.26.0,2023/11/01,0,2,4,0,0,6
intel/intelligent_traffic_management_pipeline_server_init,2.0,2022/11/15,45,50,5,0,0,100
bitnami/supabase-studio,0.23.10,2023/11/09,78,19,9,2,0,108
mongodb/mongodb-community-server,7.0.3-ubuntu2204-20231115T085830Z,2023/11/15,142,140,0,0,0,282
mattermost/genesis,209d026,2021/04/14,1,24,54,5,0,84
bitnami/redis-sentinel,7.2.3,2023/11/09,74,12,8,2,0,96
docker/remote,server,2017/09/15,0,26,3,0,0,29
rancher/rancher-cleanup,130,2022/05/30,5,53,30,3,11,102
pingidentity/pingintelligence,2310,2023/11/01,510,514,6,0,0,1030
bitnami/mxnet-archived,1.9.1,2023/10/11,601,188,83,10,2,884
rancher/harvester-pcidevices,v0.2.6,2023/11/17,0,0,3,0,0,3
balenalib/i386-node,16.19.1-20231106,2023/11/06,107,22,24,4,0,157
intel/esp-uos-builder,v3.1.2,2023/07/25,2,12,38,4,0,56
balenalib/zynq-xz702-openjdk,20210602,2021/06/05,230,232,145,39,8,654
sysdig/falco_rules_installer,12,2022/09/23,823,907,638,32,5,2405
balenalib/artik530-alpine-node,20220803,2022/08/04,7,38,36,10,0,91
rancher/istio-citadel,1.5.9,2020/08/07,406,1087,142,0,0,1635
airbyte/source-metabase,1.1.0,2023/10/31,64,7,6,1,0,78
rancher/metadata-syncer,319,2023/11/15,0,0,4,0,0,4
rancher/kube-api-auth,v0.2.0,2023/07/12,2,8,11,0,1,22
google/cloud-sdk,455.0.0,2023/11/21,535,168,127,13,0,843
balena/open-balena-db,5.2.1,2023/04/21,112,40,37,2,0,191
onlyoffice/dropbox-callback,1.0.0-rc7,2023/09/04,0,4,8,0,0,12
jetbrains/qodana-go,2023.2,2023/09/06,484,160,138,17,0,799
balenalib/odroid-xu4-fedora-python,20221109,2022/11/16,0,1,0,0,0,1
astronomerinc/ap-elasticsearch,8.9.2,2023/10/31,25,18,3,0,0,46
pachyderm/seldon-pachyderm-rsi-deployer,0.1.4,2021/02/11,8,31,52,7,0,98
airbyte/migration,0.33.0-alpha,2021/12/03,99,84,91,24,6,304
rancher/mirrored-istio-coredns-plugin,0.2-istio-1.1,2019/03/06,331,452,37,0,0,820
balenalib/stem-x86-32-golang,20230904,2023/09/09,442,113,73,9,0,637
bitnami/odoo,17.0.20231105,2023/11/15,100,24,25,5,0,154
airbyte/source-vitally,0.1.0,2022/11/14,0,17,27,1,0,45
objectscale/chunks3server,1.0.0-367.df32ef43,2022/09/09,7,45,54,4,3,113
airbyte/source-http-request,0.2.4,2021/06/09,143,93,111,34,7,388
rancher/rke-nginx-proxy,v0.1.1,2018/01/20,0,26,9,23,0,58
balenalib/zynq-xz702-fedora-golang,20220507,2022/05/12,null
rancher/agent,v2.0.3,2018/03/07,7,31,0,0,0,38
hashicorp/vault-enterprise,1.15.2-ent,2023/11/07,0,2,4,0,0,6
balena/open-balena-vpn,11.29.17,2023/10/18,357,99,79,5,0,540
google/apigee-istio-galley,1.4.6,2020/02/22,650,1305,152,0,0,2107
rancher/build-base,v1.14.2,2020/08/09,1233,1929,1449,83,16,4710
rancher/linkerd-install,stable-2.8.1,2020/07/30,122,226,28,0,0,376
snyk/snyk-operator-bundle,1.63.0-pre0,2021/06/04,95,200,35,2,0,332
objectscale/objectstore-connectivity,0.71.3,2021/03/24,2,17,23,0,0,42
okteto/gc,1.0.0,2020/03/13,2,18,41,4,0,65
objectscale/chunkserver,1.0.0-418.1b630f7e,2023/11/14,0,3,7,0,0,10
rancher/net,v0.13.17,2018/07/19,306,388,24,0,0,718
balenalib/nitrogen6x-ubuntu-golang,20220523,2022/06/03,222,536,46,0,0,804
rancher/kube-rbac-proxy,v0.5.0,2020/02/17,2,19,42,4,0,67
mattermost/awat-e2e,8330887,2022/03/30,492,368,300,55,1,1216
mattermost/cloud-db-factory-vertical-scaling,7665090,2020/09/21,3,24,41,4,0,72
airbyte/source-tyntec-sms,0.1.0,2022/11/16,0,17,27,1,0,45
intel/esp-certbot,v3.1.2,2023/07/25,4,6,4,0,0,14
redislabs/redis-webcli,yuvallevy2-webcli_tls_support-RED-37222,2020/02/09,590,1653,1281,279,16,3819
rancher/cleanup-1-1,v0.1.2,2017/01/19,141,323,297,146,0,907
cimg/clojure,1.11.1,2022/11/28,460,958,100,0,0,1518
rapidfort/mysql,8.1,2023/10/17,21,4,2,0,0,27
kasmweb/zoom,1.14.0,2023/09/14,189,380,0,0,0,569
mirantis/ucp-hardware-info,3.7.1,2023/09/26,2,3,6,2,0,13
atlassian/bitbucket,8.15.1,2023/11/18,60,71,11,1,0,143
docker/desktop-kubernetes-pause,3.9,2022/10/13,null
intel/search-image-by-image,evi-2.0.0,2022/10/31,51,42,33,7,0,133
bitnami/spark,3.5.0,2023/11/16,88,39,60,6,0,193
airbyte/source-slack,0.3.5,2023/10/15,64,21,8,1,0,94
rancher/harvester-cloud-provider,v0.2.0,2023/06/07,1,7,11,0,1,20
bitnami/laravel,10.2.9,2023/11/14,156,85,53,5,2,301
bellsoft/liberica-native-image-kit-container,jdk-17-nik-22.3.2-stream-musl,2023/11/17,null
airbyte/source-yotpo,0.1.0,2023/05/01,0,16,27,1,0,44
balenalib/amd64-fedora-golang,20231103,2023/11/04,null
mirantis/ucp-metrics-swarm-only,3.7.1,2023/09/26,2,10,10,2,0,24
balenalib/armv7hf-alpine-python,20231106,2023/11/07,0,1,4,0,0,5
daggerio/ci-test,32728,2022/07/25,0,12,16,1,0,29
rancher/storage-secrets,v0.9.7,2018/07/09,125,218,12,0,0,355
amazon/aws-lambda-nodejs,20.2023.11.13.16,2023/11/13,0,2,0,1,0,3
pachyderm/worker-arm64,97276071e371d5b1ea221437e99cfd87b5599ddf,2023/11/03,1,7,8,0,0,16
docker/tutum-test-alpine,quantal,2020/05/29,2,10,32,4,0,48
airbyte/source-pipedrive,2.2.1,2023/11/06,0,13,26,1,0,40
circleci/android,example,2021/03/18,884,731,807,154,18,2594
rancher/metrics-server,v0.4.1,2020/11/16,0,7,12,1,5,25
airbyte/source-dremio,0.1.0,2023/01/12,0,16,27,1,0,44
airbyte/source-chargebee,0.2.5,2023/10/15,64,21,8,1,0,94
balenalib/orbitty-tx2-alpine-openjdk,8-20231106,2023/11/06,8,8,4,0,0,20
grafana/dd-proxy,v0.1.0,2020/09/24,6,31,49,4,0,90
balenalib/raspberrypi3-debian-node,20230530,2023/07/02,118,38,41,6,0,203
kasmweb/chromium,1.14.0,2023/09/14,187,380,0,0,0,567
circleci/twistlock-secret-fetcher,0.1.31-be7da25,2019/05/28,0,6,5,7,0,18
airbyte/source-hubplanner,0.2.0,2023/09/04,0,15,26,1,0,42
ambassador/aes-authsvc,v4.0.0-preview.2.dev.1,2023/10/27,0,1,1,0,0,2
rancher/os-selinuxtools,v1.5.8,2021/02/05,null
balenalib/asus-tinker-board-s-alpine-python,20231106,2023/11/07,0,1,4,0,0,5
rancher/opensearch-dashboards,1.3.1,2022/05/19,63,325,152,6,0,546
mattermost/matterbuild,0.12.1,2023/10/11,25,16,7,0,0,48
balenalib/stem-x86-32-node,16.19.1-20230904,2023/09/09,118,38,41,6,0,203
rancher/k8s-dns-sidecar,1.15.10,2020/03/05,16,17,19,8,1,61
balenalib/intel-nuc-debian-openjdk,20231103,2023/11/05,125,43,31,4,0,203
balenalib/amd64-fedora-python,20231103,2023/11/04,null
rancher/mirrored-sig-storage-csi-attacher,v4.4.2,2023/11/09,null
onlyoffice/documentserver-de,7.5.1.1,2023/11/05,123,91,1,1,0,216
balenalib/artik530-fedora-openjdk,8-20220224,2022/03/05,null
balenalib/via-vab820-quad-ubuntu-openjdk,20210826,2021/09/04,136,435,10,0,0,581
google/apigee-istio-pilot,1.4.6,2020/02/22,650,1310,159,1,0,2120
balenalib/artik530-fedora-python,20220714,2022/07/23,0,1,1,0,0,2
docker/ucp-controller,3.3.1,2020/06/26,2,8,9,1,0,20
airbyte/source-datascope,0.1.0,2022/11/11,0,17,27,1,0,45
docker/fab-backend,50b36877f5c4f4f9947837690a988f592450d1de,2018/11/21,1,0,14,11,0,26
airbyte/source-instatus,0.1.0,2023/01/13,0,16,27,1,0,44
intel/intel-deviceplugin-operator,0.28.0,2023/09/22,null
objectscale/bookkeeper-operator,0.1.9-99-582916f,2023/02/10,1,13,19,0,0,33
airbyte/destination-s3,1.0.0,2023/01/13,64,200,185,17,0,466
intel/evi-fm-master,master-ae213cd97d6931b1d44fc7689867cf5701e0f15d,2023/09/23,55,10,3,1,0,69
balenalib/armv7hf-debian,20230929,2023/10/02,111,36,35,6,0,188
circleci/erlang,25,2022/02/22,850,1014,763,100,5,2732
balenalib/jetson-tx2-debian-python,20231106,2023/11/07,114,21,29,4,0,168
airbyte/source-breezometer,0.1.0,2022/11/08,0,17,27,1,0,45
atlassian/pipelines-kubectl,1.28.1,2023/08/31,0,1,3,0,0,4
rancher/os-extras,v0.7.1,2016/10/03,0,53,26,10,0,89
rancher/os-rootfs,3929481,2017/02/03,null
balena/i386-nlp-supervisor-base,v1.4.7,2019/05/28,null
snyk/kubernetes-operator-index,1.100.2,2023/01/03,3,26,53,3,0,85
balenalib/artik10-debian-openjdk,20220714,2022/07/22,157,127,85,18,0,387
balenalib/odroid-xu4-alpine,20231106,2023/11/07,0,0,4,0,0,4
newrelic/cluster-api-controller-ppc64le,mv1a,2019/04/17,0,0,0,0,6,6
airbyte/destination-mongodb-strict-encrypt,0.2.0,2023/07/26,61,172,132,2,0,367
graphcore/ipu-operator-launcher,1.2.0,2023/05/30,31,16,3,0,0,50
rancher/os-cloudinit,v0.7.1,2016/11/01,null
balenalib/am571x-evm-debian-python,20220604,2022/06/12,124,81,76,20,0,301
mattermost/community-continuous-profiling,6055961,2021/01/20,10,21,40,6,0,77
onlyoffice/4testing-docspace-healthchecks,2.0.0.33,2023/11/15,1016,142,207,12,0,1377
intel/intelligent_traffic_management_analytics_dev,2.0,2022/12/06,102,207,15,0,0,324
rancher/mirrored-curlimages-curl,7.85.0,2022/08/31,0,11,14,0,0,25
balenalib/artik5-ubuntu,20220714,2022/08/02,87,82,11,0,0,180
grafana/technical-documentation-build-image,6673591,2022/11/15,1,14,15,3,0,33
objectscale/csi-baremetal-node-controller,1.4.0-652.08b8de3,2023/11/13,null
adobecoldfusion/apimanager2021,2021.0.1,2021/12/17,109,246,100,40,0,495
kasmweb/alpine-317-desktop,1.14.0,2023/09/14,15,124,148,19,2,308
vmware/vs-api-manager,v0.0.1,2017/12/05,15,81,98,70,0,264
rancher/mirrored-jenkins-jnlp-slave,4.7-1,2021/03/24,237,154,192,54,10,647
okteto/traefik,dev,2020/04/10,13,37,68,8,0,126
cockroachdb/xgo,20170218,2017/02/19,764,1408,75,1,0,2248
mirantis/operations-ui,remove-keycloak-stuff,2018/11/08,409,1276,811,204,49,2749
objectscale/csi-baremetal-scheduler-patcher,0.69.0,2021/03/07,0,15,49,12,0,76
docker/proxy_init,1.1.2,2019/04/12,40,35,0,0,0,75
balena/aarch64-supervisor-base,v1.4.7,2019/05/28,null
balenalib/apalis-imx6q,20220714,2022/07/20,124,68,74,18,0,284
percona/dbaas-operator-bundle,0.1.17,2023/07/04,null
intel/intel-iaa-plugin,0.28.0,2023/09/22,null
circleci/nomad,0.9-8443593,2019/08/16,60,69,111,16,10,266
airbyte/proxy,0.51.0,2023/07/20,91,41,19,3,4,158
bellsoft/liberica-openjre-centos,21.0.1-12,2023/11/14,551,497,32,3,0,1083
redislabs/mp-vault,0.0.2,2019/06/26,0,0,0,2,0,2
bitnami/memcached,1.6.22,2023/11/15,78,12,9,3,0,102
balenalib/via-vab820-quad-alpine-python,20220714,2022/07/19,7,38,37,10,0,92
rancher/mirrored-library-busybox,1.36.1,2023/07/18,null
airbyte/destination-postgres-strict-encrypt,0.4.0,2023/06/29,65,199,176,17,0,457
rancher/mirrored-jimmidyson-configmap-reload,v0.8.0,2022/10/11,null
onlyoffice/4testing-ds-proxy-de,6.2.0-eu-r2,2021/03/04,601,587,37,3,0,1228
balena/open-balena-api,14.14.3,2023/11/13,357,91,59,5,0,512
onlyoffice/documentserver-builder,develop-latest,2019/02/18,17,29,10,6,0,62
vmware/photon2,20180620,2018/06/20,15,71,90,57,0,233
airbyte/source-workable,0.1.0,2022/10/27,0,17,27,1,0,45
couchbase/sync-gateway,1.4.0-2,2019/04/10,614,635,48,3,0,1300
circleci/migratorator-test,0.1,2017/08/26,501,1809,1164,312,70,3856
amazon/aws-secrets-manager-secret-rotator,v1,2020/10/14,0,7,13,0,6,26
balenalib/orangepi-plus2-alpine,20231106,2023/11/07,0,0,4,0,0,4
balenalib/revpi-core-3-ubuntu,20231026,2023/11/02,37,9,0,0,0,46
rancher/rdns-server,v0.5.8-rancher-amd64,2019/12/27,108,74,12,0,0,194
okteto/test-auth,dev,2020/02/06,2,10,29,4,0,45
rancher/slack-irc,3.12.0,2018/08/13,333,485,42,4,0,864
grafana/benchtool,v0.11.0,2023/09/06,0,2,3,0,0,5
balenalib/odroid-xu4-golang,20230911,2023/09/11,442,111,73,9,0,635
netdata/os-test,ubuntu1904,2020/04/14,0,4,0,0,0,4
newrelic/synthetics-minion-runner,3.0.95,2023/11/03,34,224,238,45,0,541
grafana/vale,6673591,2022/11/15,0,5,4,1,0,10
balenalib/aarch64-alpine-openjdk,8-20231106,2023/11/06,6,6,4,0,0,16
pachyderm/split-loadtest-supervisor,20191119.0802,2019/11/19,null
hashicorp/consul-esm,0.7.1,2023/01/06,0,23,21,0,0,44
grafana/metrictank,v1.1,2021/01/14,4,14,9,3,0,30
docker/dtr-notary-signer,2.8.1,2020/06/17,2,9,8,1,0,20
pachyderm/job-shim,1.3.19,2017/03/30,376,507,68,1,0,952
airbyte/source-klaviyo,2.0.1,2023/11/09,64,21,8,1,0,94
bitnami/git,2.42.1,2023/11/02,136,15,31,5,0,187
rancher/klipper-lb,v0.4.4,2023/05/27,0,8,4,3,0,15
mattermost/mattermost-enterprise-edition,9.2.2,2023/11/08,52,28,6,0,0,86
intel/esp-uos-wifi,v3.1.2,2023/07/25,null
okteto/java-maven-getting-started,1.0.0,2023/02/27,111,76,114,34,0,335
onlyoffice/4testing-ds-converter,6.0.0,2020/10/21,563,567,32,3,0,1165
rancher/rancher-operator,v0.2.0-alpha03,2021/04/13,1,12,42,4,0,59
airbyte/tests,dev-3,2022/01/23,104,111,93,30,0,338
airbyte/source-linkedin-pages,1.0.2,2023/05/30,0,15,27,1,0,43
docker/ucp-agent-s390x,3.1.0-beta3,2018/10/04,0,2,6,16,0,24
airbyte/destination-r2,0.1.0,2022/09/26,80,92,104,34,0,310
balenalib/generic-armv7ahf-debian-python,20230904,2023/09/09,118,37,40,6,0,201
circleci/dynamodb,19,2022/02/22,14,79,42,1,0,136
objectscale/base-service-tools,2.69.0,2021/03/16,18,135,158,6,6,323
rapidfort/haproxy,2.8.3,2023/10/17,26,8,5,1,0,40
balenalib/raspberry-pi2-fedora-golang,20220523,2022/06/04,null
puppet/continuous-delivery-for-puppet-enterprise,4.3.3,2021/02/23,112,78,86,28,6,310
solace/solace-pubsub-standard,10.6.0.34,2023/10/27,190,86,6,0,0,282
rancher/bats-bats,v1.1.0,2018/08/02,0,0,0,2,0,2
cimg/base,2023.11,2023/11/07,160,148,5,0,0,313
balenalib/jetson-tx2-ubuntu,20231103,2023/11/06,37,9,0,0,0,46
balenalib/beaglebone-green-wifi-debian,20230911,2023/09/11,118,36,40,6,0,200
couchbase/operator-certification,2.5.0,2023/08/14,246,105,61,8,0,420
docker/ucp-pause-s390x,3.1.0-beta3,2018/10/04,null
vmware/log-intelligence-fluentd,3.6,2021/03/12,1428,1360,983,149,39,3959
circleci/circleci-inferconfig,0.1412,2023/10/03,207,231,32,0,0,470
airbyte/source-alloydb,3.1.8,2023/09/20,4,53,30,2,0,89
ubuntu/squid,6.1-23.10_edge,2023/11/16,13,12,0,0,0,25
kong/go-plugin-tool,47123c5-alpine-latest,2020/05/22,9,29,74,11,0,123
rancher/agent-windows,v0.2.0,2018/03/15,null
intel/esp-uos-firmware-wifi,v3.1.2,2023/07/25,null
airbyte/destination-aws-datalake,0.1.4,2023/10/25,64,7,5,2,0,78
balenalib/asus-tinker-board-ubuntu-node,20231026,2023/11/02,38,10,1,0,0,49
airbyte/source-google-ads,2.0.4,2023/11/10,64,21,8,1,0,94
docker/ucp-interlock-s390x,3.1.0-beta3,2018/10/04,0,2,6,16,0,24
astronomerinc/ap-keda-metrics-adapter,1.5.0,2020/08/03,133,301,47,1,0,482
dynatrace/easytravel-frontend,7.1,2018/05/11,3,19,11,22,0,55
rancher/enterprise,v1.6.30,2020/05/05,74,91,61,25,0,251
balenalib/artik5-fedora-openjdk,8-20220224,2022/03/05,null
onlyoffice/docspace-ssoauth,1.1.4.1,2023/10/23,1006,167,232,22,0,1427
mattermost/mm-cloud-ee,2786a79-102,2020/10/14,10,55,84,11,0,160
balenalib/raspberry-pi2-ubuntu-golang,20231026,2023/11/02,133,131,0,0,0,264
balenalib/raspberry-pi2-python,20230911,2023/09/12,118,37,40,6,0,201
rancher/mirrored-calico-kube-controllers,v3.26.3,2023/10/06,0,2,3,0,0,5
balenalib/kitra710-debian-node,20230904,2023/09/09,118,38,41,6,0,203
docker/dtr-content-cache,2.8.1,2020/06/17,2,9,8,1,0,20
balena/rpi-supervisor-node,1244-update-lock-weirdness,2020/04/02,732,710,621,70,8,2141
vmware/lightwave-toolchain-photon3,1.0.1,2019/11/27,53,282,388,86,0,809
balenalib/raspberry-pi2-node,20230911,2023/09/12,118,38,41,6,0,203
bitnami/wavefront-hpa-adapter,0.9.10,2023/05/21,0,3,5,0,0,8
balenalib/kitra710-fedora,20230904,2023/09/09,null
snyk/sweater-comb,2.3.9,2023/11/06,0,2,4,0,0,6
rancher/network-diagnostics-agent,v0.1.0,2017/06/17,307,389,24,0,0,720
balenalib/odroid-xu4-fedora-golang,20221210,2022/12/13,null
kasmweb/telegram,1.14.0,2023/09/14,187,380,0,0,0,567
balenalib/am571x-evm-fedora,20220604,2022/06/12,null
balenalib/beaglebone-black-alpine-openjdk,8-20231106,2023/11/07,0,0,4,0,0,4
mirantis/ucp-kube-compose,3.5.3,2019/11/07,4,14,9,1,0,28
rancher/mirrored-fluent-fluent-bit,1.9.5,2022/06/20,28,30,26,5,0,89
lacework/codesec-iac,v1.0.4,2023/10/02,57,47,11,0,0,115
bitnami/redis-cluster,7.2.3,2023/11/09,75,13,8,2,0,98
amazon/aws-ebs-csi-driver,8382640,2021/07/12,132,106,116,38,3,395
balenalib/orbitty-tx2-debian,20231106,2023/11/07,114,20,29,4,0,167
airbyte/source-strava,0.2.0,2023/10/24,0,13,26,1,0,40
apachepinot/pinot-superset,470541885905-20220907,2022/09/07,819,799,612,50,3,2283
rancher/mirrored-dexidp-dex,v2.37.0,2023/06/30,0,13,8,3,0,24
ambassador/aes-envoy,v4.0.0-preview.2.dev.1,2023/10/27,21,5,1,0,0,27
mirantis/ucp-interlock-extension,3.7.1,2023/09/26,2,3,7,2,0,14
grafana/openshift-cloud-log-forwarder,1.0.1,2022/03/08,70,105,21,0,0,196
airbyte/scheduler,0.101.0-alpha,2021/06/04,252,227,214,48,12,753
okteto/chaat,dev,2020/07/22,1386,1132,1068,120,21,3727
sysdig/aws-mfa,0.1.0,2020/02/12,112,107,97,33,7,356
bitnami/grafana,10.2.0,2023/11/08,88,17,20,4,0,129
redislabs/rcp-gcloud,8a3bb250e2bf37a24038396891e68b5f,2019/07/14,351,677,524,101,16,1669
balenalib/fincm3-fedora,20221031,2022/11/04,null
rapidfort/influxdb,2.7.1,2023/10/12,42,11,14,3,0,70
balenalib/ts4900-alpine-golang,20220714,2022/07/27,8,39,40,12,0,99
okteto/python-job-launcher,launcher,2020/08/18,104,80,88,31,7,310
hashicorp/consul-k8s,0.26.0,2021/06/22,5,31,48,8,0,92
bellsoft/liberica-runtime-container,jre-21.0.1-stream-musl,2023/11/17,null
okteto/welcome,44,2018/12/20,1,9,11,4,0,25
objectscale/iamsvc,0.71.3,2021/04/14,13,93,107,14,3,230
grafana/grafana-arm32v7-linux,7.0.6,2020/07/09,4,30,54,9,0,97
onlyoffice/trello-proxy,1.0.7,2023/11/15,0,0,4,0,0,4
airbyte/source-mailjet-mail,0.1.1,2023/04/19,0,16,27,1,0,44
rancher/fluent-fluent-bit,1.6.10,2021/01/08,13,31,27,10,4,85
atlassian/bamboo-server,9.4.1,2023/11/07,102,144,10,6,0,262
docker/dev-environments-default,639923ad2c5ce6f29a24ca8d11c8f38f9206c462,2021/06/21,516,258,413,60,12,1259
amazon/aws-sam-cli-emulation-image-dotnetcore3.1,20220125,2022/01/25,1,50,19,0,0,70
google/apigee-busybox,1.30.1,2019/05/09,null
snyk/broker,4.169.3-rhel-ubi-nexus2,2023/11/14,59,11,0,0,0,70
newrelic/external-dns,ns1,2019/04/02,4,14,8,2,0,28
newrelic/cluster-api-controller-s390x,mv1a,2019/04/17,0,0,0,0,6,6
balenalib/odroid-xu4-ubuntu-golang,20231026,2023/11/02,133,131,0,0,0,264
onlyoffice/gdrive-gateway,1.0.0-rc15,2023/09/18,0,4,8,0,0,12
mattermost/mattermost-prod-app,v5.33.3,2021/03/31,2,23,28,1,0,54
bitnami/tensorflow-serving,2.14.0,2023/11/16,309,30,26,3,0,368
hashicorp/consul-lambda-registrator,0.1.0-beta4,2023/04/28,2,49,30,0,0,81
dynatrace/dynatrace-oneagent-operator,v0.10.2,2021/09/07,98,186,34,0,0,318
rapidfort/airflow,2.7.1,2023/11/17,28,6,3,1,0,38
percona/percona-server-mongodb,7.0.2-1,2023/10/10,0,3,19,0,0,22
rancher/storage-efs,v0.9.0,2018/01/12,395,723,49,3,0,1170
rancher/terraform-provider-harvester,v0.6.3,2023/08/21,4,15,26,1,1,47
balenalib/intel-nuc-openjdk,20231103,2023/11/05,125,43,31,4,0,203
grafana/logql-analyzer,2.9.2-amd64,2023/10/25,0,0,4,0,0,4
balenalib/aarch64-openjdk,20231106,2023/11/07,118,43,25,4,0,190
mattermost/awat,8330887,2022/03/30,3,30,18,3,0,54
newrelic/cluster-api-controller-amd64,79dda1d3,2019/07/01,0,0,0,0,6,6
intel/query-web,evi-2.0.0,2022/10/31,62,89,1,0,0,152
onlyoffice/docspace-notify,1.1.4.1,2023/10/23,1016,143,210,12,0,1381
ubuntu/postgres,14-22.04_edge,2023/08/21,32,11,3,0,0,46
balenalib/generic-armv7ahf-python,20230904,2023/09/09,118,37,40,6,0,201
atlassian/maven,3.5-jdk-8-alpine,2017/09/27,21,69,47,44,0,181
jetbrains/upsource-opscenter,2020.1.1992,2022/03/11,79,148,245,95,0,567
appdynamics/ad-nite-go-services,2019-03-13-1552519571,2019/03/13,210,514,556,132,35,1447
balenalib/qemux86-64-ubuntu-node,20230911,2023/09/11,43,11,5,0,0,59
docker/ucp-kube-compose-s390x,3.1.0-beta3,2018/10/04,0,0,0,2,0,2
rapidfort/nginx-official,1.23.4-perl,2023/05/23,42,30,11,1,0,84
datadog/dd-lib-dotnet-init,v2.41.0,2023/11/05,0,0,4,0,0,4
balenalib/orbitty-tx2-debian-node,20231106,2023/11/07,114,22,30,4,0,170
balenalib/am571x-evm-ubuntu-node,20220715,2022/07/19,88,104,12,0,0,204
balenalib/nitrogen6x-fedora-openjdk,30-20210825,2021/09/03,null
intel/storage-rest,evi-2.0.0,2022/10/31,127,238,43,0,0,408
kumahq/kuma-cp,2.4.4,2023/11/06,0,0,1,0,0,1
balenalib/ts4900-golang,20220714,2022/07/28,467,262,214,28,1,972
rancher/longhornio-longhorn-instance-manager,v1_20220808-s390x,2022/08/08,8,77,71,3,11,170
airbyte/source-google-search-console-singer,0.1.3,2021/07/06,561,319,283,39,7,1209
netdata/base,v2,2023/11/22,83,20,16,1,0,120
balenalib/orbitty-tx2-openjdk,20231106,2023/11/07,125,43,31,4,0,203
rancher/opni-gpu-service-controller,v0.3.1,2022/03/07,8,100,106,7,14,235
rancher/mirrored-sig-storage-snapshot-validation-webhook,v6.2.2,2023/05/27,0,2,1,0,0,3
mirantis/virtlet-base,v1-6348ee2277c565d3895260bccb5ada96,2018/11/30,339,505,35,0,0,879
airbyte/destination-mongodb,0.2.0,2023/07/27,61,172,132,2,0,367
balenalib/qemux86-64-ubuntu-python,20230911,2023/09/11,42,11,4,0,0,57
okteto/guestbook,golang,2020/10/30,97,42,51,16,6,212
kasmweb/core-fedora-37,1.14.0,2023/09/09,null
balenalib/armv5e,20200221,2020/02/29,173,128,168,30,6,505
jetbrains/intellij-http-client,233.11799.6,2023/11/09,0,10,10,0,0,20
balenalib/bananapi-m1-plus-golang,20230904,2023/09/09,442,111,73,9,0,635
balenalib/ts4900-node,18.6-20220714,2022/07/21,124,70,75,18,0,287
vmware/nginx-photon,1.11.13,2017/11/21,8,63,80,49,0,200
redislabs/prometheus-redistimeseries-adapter,version-0.0.17,2020/05/12,2,18,45,4,0,69
pachyderm/goimage,778b7030efafdab9c9d33e97d5b7ea27508c62df,2020/07/14,2,10,32,4,0,48
redislabs/hoverfly,v0.17.7,2019/01/14,83,76,150,28,12,349
grafana/docker-desktop-extension,0.0.5,2023/09/27,0,2,9,0,0,11
mattermost/chaos-dashboard,v0.0.1,2021/08/11,94,39,55,13,6,207
bitnami/nats-exporter,0.13.0,2023/11/08,74,12,10,2,0,98
bellsoft/buildpacks.syft,1.26.0,1980/01/01,null
grafana/grafana-marketing-build,248877623c,2023/06/05,3,23,40,2,0,68
intel/intelligent_traffic_management,4.0,2022/03/23,456,1411,68,0,0,1935
atlassian/jira-core,9.11.3,2023/11/18,23,22,13,1,0,59
balenalib/intel-nuc-alpine-python,20231106,2023/11/07,0,1,4,0,0,5
rapidfort/memcached-ib,1.6.22,2023/10/25,92,34,0,0,0,126
kasmweb/postgres,1.12.0,2022/12/12,0,10,13,0,0,23
balenalib/odroid-xu4-alpine-openjdk,8-20231106,2023/11/07,0,0,4,0,0,4
rancher/dapper,19.03,2020/04/27,2,11,29,4,0,46
onlyoffice/wrata,v1.30.0-197-gb37558a,2023/11/10,5,10,12,0,0,27
airbyte/source-bigcommerce,0.2.0,2023/09/15,0,15,26,1,0,42
newrelic/k8s-nri-nginx,2.0.0,2020/01/28,2,11,29,4,0,46
ubuntu/redis,6.0-22.04_edge,2023/06/19,23,9,2,0,0,34
objectscale/zookeeper-operator,0.28.0,2019/10/09,0,0,0,2,0,2
rancher/helm-project-operator,v0.2.1,2023/06/26,0,11,7,0,1,19
amazon/aws-stepfunctions-local,1.13.2,2023/10/31,0,8,3,0,0,11
balenalib/up-board-ubuntu-python,20230911,2023/09/12,42,11,4,0,0,57
vmware/csp-driver,v1.13.1,2019/03/14,141,580,481,92,18,1312
docker/pipeline_scratch,0.2.0-alpha,2017/04/04,null
rancher/mirrored-library-nginx,1.24.0-alpine-s390x,2023/10/21,0,2,3,0,0,5
airbyte/normalization-tidb,0.4.3,2023/05/12,486,380,330,49,2,1247
balenalib/raspberry-pi2-debian-node,20230911,2023/09/12,118,38,41,6,0,203
balenalib/intel-nuc-alpine,20231106,2023/11/07,0,0,4,0,0,4
balenalib/generic-armv7ahf-debian-openjdk,20230904,2023/09/09,129,64,44,6,0,243
airbyte/connector-builder-server-wrapped,dev-9895397664,2023/08/19,4,74,67,0,0,145
hashicorp/dashboard-init,0.0.4,2018/11/15,0,0,6,14,0,20
rancher/submariner-route-agent,v0.0.1,2019/03/12,45,68,11,0,0,124
mirantis/ucp-kube-dns-sidecar,3.2.15,2021/06/29,0,0,0,2,0,2
astronomerinc/ap-nginx,1.9.4,2023/10/31,0,0,3,0,0,3
graphcore/pytorch-minimal,3.3.0,2023/07/03,140,185,27,0,0,352
ubuntu/grafana-agent,0.35.2-22.04,2023/08/16,22,17,7,0,0,46
pachyderm/example-python-spout-producer,6.x,2021/08/04,34,14,46,13,4,111
grafana/xk6,0.9.2,2023/06/13,464,156,128,14,0,762
airbyte/source-python-http-tutorial,0.1.3,2021/12/30,104,59,74,27,7,271
airbyte/source-postgres,3.2.21,2023/11/09,2,30,15,2,0,49
bitnami/orangehrm-archived,4.9.0-0,2022/01/17,290,278,181,32,14,795
docker/desktop-storage-provisioner,v2.0,2021/04/26,0,6,11,0,0,17
balenalib/beaglebone-green-wifi-fedora-golang,20220523,2022/06/05,null
snyk/snyk-docker-desktop-extension,0.7.4,2023/10/02,null
vmware/photon-2.0-calico-cni,v1.11.2-20180619,2018/06/19,15,72,90,57,0,234
grafana/enterprise-traces,v2.2.4,2023/10/26,0,1,5,0,0,6
intel/oact-rpc-go,v2.22.0,2023/11/07,null
amazon/aws-sam-cli-emulation-image-provided,20220125,2022/01/25,1,154,72,1,0,228
airbyte/source-tempo,0.3.1,2023/03/08,0,16,27,1,0,44
airbyte/source-customer-io,0.2.0,2023/08/29,0,15,26,1,0,42
newrelic/infrastructure,1.48.1,2023/11/02,0,3,2,0,0,5
balenalib/generic-aarch64-fedora-node,20231106,2023/11/06,0,1,1,0,0,2
balenalib/beaglebone-green-fedora-openjdk,30-20210825,2021/09/03,null
hashicorp/counting-init,0.0.9,2018/11/15,0,0,6,14,0,20
rancher/k3d,5.3.0,2022/02/03,9,70,87,17,0,183
atlassian/jira-servicedesk,5.11.3,2023/11/18,25,29,16,2,0,72
intel/gsg_nginx,12.0,2022/12/12,107,108,52,9,0,276
lacework/alert-evidence-materialization,2022-12-29_ANEP-1281_draft_4044af177dd2d4d11f902f86d0afc2916d800af1_RA,2022/12/29,102,270,6,0,0,378
rancher/coreos-prometheus-operator,v0.43.0,2020/10/27,1,7,13,0,0,21
okteto/vote-ssh,dev,2019/05/19,562,1498,1176,245,14,3495
airbyte/seed,0.101.0-alpha,2021/06/03,0,10,2,0,0,12
balenalib/via-vab820-quad-alpine-node,20220714,2022/07/19,7,38,36,10,0,91
datadog/agent-buildimages-windows_1809_x86,v3686353-1e75137,2021/01/12,8,49,134,12,0,203
intel/edge_to_azure_bridge,3.0,2022/04/14,80,88,6,0,0,174
bitnami/kaniko,1.18.0,2023/11/08,0,4,6,0,0,10
balenalib/generic-aarch64-fedora-python,20231106,2023/11/06,null
objectscale/dtsm,3.9.0.0-139102.b4b5064355c,2023/05/03,12,48,43,2,0,105
balenalib/aarch64-alpine-python,20231106,2023/11/06,0,1,4,0,0,5
balenalib/am571x-evm-fedora-openjdk,30-20210825,2021/09/03,null
percona/percona-xtrabackup,8.1.0-1,2023/10/19,97,33,2,0,0,132
balenalib/generic-armv7ahf-fedora-python,20221109,2022/11/16,0,1,0,0,0,1
hashicorp/dev-portal,sha-9855822,2023/01/12,3,139,55,6,0,203
pachyderm/metric-collector,v4,2023/03/31,100,39,34,3,3,179
rancher/ui-plugin-operator,v0.1.1,2023/04/04,0,6,7,0,1,14
balenalib/rpi-golang,20231106,2023/11/07,372,51,44,5,0,472
okteto/rust,1.47.0,2020/11/16,1482,1549,1189,198,39,4457
astronomerinc/ap-airflow,2.4.3-6,2023/03/31,114,80,52,11,0,257
datadog/agent-buildimages-datadog-ci-uploader,v22885174-c6364642,2023/11/06,106,153,12,0,0,271
grafana/celery-exporter,056e4f902d-linux-arm64,2023/10/20,1,2,4,0,0,7
balenalib/generic-armv7ahf-fedora-golang,20221210,2022/12/13,null
grafana/enterprise-logs-provisioner,v1.8.4,2023/10/18,0,0,4,0,0,4
grafana/phlare,0.6.1,2023/06/13,0,19,9,0,0,28
mirantis/ucp-openstack-ccm,3.5.3,2020/03/31,7,32,53,5,0,97
atlassian/confluence,8.6.1,2023/11/18,23,20,7,2,0,52
circleci/rabbitmq-delayed,3.8.9-management-38,2020/10/28,2,15,42,12,0,71
grafana/cortex-ruler,w37-0193e7b7,2018/09/11,0,0,0,2,0,2
airbyte/source-recruitee,0.1.0,2022/11/08,0,17,27,1,0,45
airbyte/source-github,20211124-rc1,2021/11/24,79,59,59,24,1,222
airbyte/connector-builder,0.40.17,2022/10/25,78,39,41,3,0,161
newrelic/nri-network-telemetry,v1.0.3,2020/05/19,2,11,27,4,0,44
hashicorp/levant,0.3.3,2023/10/05,0,1,3,0,0,4
rancher/istio-kubectl,1.5.10,2020/08/19,405,1076,128,0,0,1609
vmware/event-publisher-toolchain,0.2.8,2019/01/23,57,263,299,111,0,730
mattermost/cloud-thanos-store-discovery,v0.1.1,2021/12/08,0,16,24,1,0,41
balenalib/fincm3-golang,20230530,2023/06/27,379,57,48,8,0,492
apachepinot/thirdeye,0.5.0-SNAPSHOT-8900ebb99-20200904,2020/09/04,105,92,106,35,6,344
newrelic/deployer,v1.0.4,2023/11/07,808,723,528,29,2,2090
balenalib/stem-x86-32-alpine-node,16.19.1-20230712,2023/07/15,2,9,7,2,0,20
launchdarkly/ld-find-code-refs-github-action,2.11.4,2023/10/16,0,0,4,0,0,4
okteto/registry-configurator,0.1.5,2021/05/28,101,35,49,15,6,206
sysdig/workload-agent,3.0.1-experimental,2022/07/27,0,0,2,0,0,2
percona/pmm-client,2.40.1,2023/10/20,3,15,8,0,0,26
docker/ucp-interlock-config,3.3.1,2020/06/26,2,19,34,5,0,60
balenalib/kitra520-ubuntu,20220714,2022/08/02,87,82,11,0,0,180
graphcore/pytorch-geometric-jupyter,3.2.1,2023/05/31,297,502,27,0,0,826
greenbone/openvas-smb,22.5.4,2023/10/17,60,6,2,1,0,69
intel/data-analytics,2023.2-py3.10,2023/09/20,100,90,6,1,0,197
netdata/static-builder,v1,2023/11/22,null
airbyte/source-nasa,0.2.0,2023/10/25,0,13,26,1,0,40
okteto/daemon,0.4.0,2023/08/28,0,2,1,0,0,3
balenalib/colibri-imx6dl-ubuntu-openjdk,20210826,2021/09/04,136,435,10,0,0,581
bitnami/service-catalog-archived,0.3.1,2022/01/12,131,85,92,24,6,338
kasmweb/desktop-deluxe,1.14.0,2023/09/14,270,556,0,0,0,826
snyk/ubuntu,nlatest,2023/09/05,21,4,0,0,0,25
balenalib/intel-nuc-node,20231106,2023/11/06,114,22,30,4,0,170
onlyoffice/docs-docservice-ee,7.5.1-1,2023/11/09,0,2,1,1,0,4
rancher/mirrored-metrics-server,v0.6.3,2023/03/21,0,3,4,0,0,7
bitnami/attu,2.3.2,2023/10/24,77,17,9,2,0,105
docker/desktop-kubernetes-etcd,3.5.9-0,2023/05/16,0,12,12,0,0,24
balenalib/intel-nuc-ubuntu,20230911,2023/09/11,42,10,4,0,0,56
objectscale/kubectl,v1.25.15,2023/11/03,0,0,3,0,0,3
airbyte/source-xkcd,0.1.1,2022/10/24,0,15,19,0,0,34
astronomerinc/ap-nats-exporter,0.12.0-1,2023/11/08,0,0,5,0,0,5
mattermost/calls-recorder-daily,v0.4.2-dev,2023/08/16,0,2,1,0,0,3
airbyte/source-mssql,3.0.0,2023/11/07,2,30,15,2,0,49
airbyte/source-lokalise,0.1.0,2022/10/28,0,17,27,1,0,45
rancher/mirrored-thanos-thanos,v0.30.2,2023/01/31,0,4,4,0,0,8
mirantis/ucp-kube-gmsa-webhook,3.5.3,2019/07/17,null
airbyte/source-glassfrog,0.2.0,2023/08/30,0,15,26,1,0,42
hashicorp/vault-k8s,1.3.1,2023/10/25,0,0,4,0,0,4
balenalib/bananapi-m1-plus-debian-golang,20230904,2023/09/09,442,111,73,9,0,635
balenalib/am571x-evm-debian-openjdk,20210602,2021/06/05,230,232,145,39,8,654
balenalib/amd64,20231106,2023/11/06,107,20,23,4,0,154
objectscale/diagnostic-service,0.71.3,2021/04/15,17,149,215,36,6,423
airbyte/source-sftp-bulk,0.1.2,2023/04/19,80,33,28,2,0,143
rancher/hardened-sriov-network-config-daemon,14bd335c17c1b4c6cb7d37c2972c05cc62cadeeb-build20211119,2021/11/19,462,444,36,4,0,946
mirantis/ucp-sf-notifier,3.7.1,2023/09/26,3,4,4,0,0,11
pachyderm/iris-train,rstats-svm,2017/04/20,234,640,709,121,40,1744
rancher/os-logrotate,v1.5.8,2021/02/05,null
airbyte/connector-builder-server,0.50.34,2023/11/09,10,81,103,0,0,194
onlyoffice/box-gateway,1.0.1,2023/09/12,0,4,8,0,0,12
onlyoffice/4testing-docspace-nodejs-runtime,v1.0.0,2023/09/04,1006,177,234,15,0,1432
rancher/storage-abs,v0.9.7,2018/07/09,317,492,36,0,0,845
bitnami/tensorflow,2.14.0,2023/10/30,77,14,9,2,0,102
balenalib/ts4900-fedora-node,36-build-20220714,2022/07/22,0,1,1,0,0,2
atlassian/nucleus,88049123,2018/07/12,430,1227,887,242,52,2838
mirantis/ucp-interlock-config,3.7.1,2023/09/26,2,2,4,2,0,10
okteto/node-getting-started,1.0.0,2023/02/27,90,28,30,2,3,153
balenalib/rpi-debian-python,20231106,2023/11/07,107,35,31,4,0,177
balenalib/stem-x86-32-ubuntu,20210812,2021/08/22,108,183,10,0,0,301
airbyte/source-klarna,0.2.0,2023/10/23,0,13,26,1,0,40
intel/observability-telegraf,1.3.0,2023/09/21,0,3,8,0,0,11
mirantis/jnlp-slave,3.7-1,2018/07/11,595,2213,1660,277,27,4772
rancher/mirrored-library-traefik,2.10.5,2023/10/11,0,6,5,0,0,11
airbyte/source-facebook-marketing,20220315-rc1,2022/03/15,79,46,52,17,1,195
accurics/gitlab-connector,1.3,2021/06/11,0,12,40,4,0,56
airbyte/source-github-singer,0.2.8,2021/06/09,105,62,78,30,7,282
rancher/os-acpid,3929481,2017/02/03,null
couchbase/operator,2.5.0,2023/08/14,0,2,1,0,0,3
newrelic/newrelic-super-agent,nightly,2023/11/21,59,6,3,1,0,69
atlassian/deployment-locker,1.7,2021/08/04,null
kasmweb/terminal,1.14.0,2023/09/14,189,388,0,0,0,577
intel/multimodal-data-visualization-streaming,3.0,2022/07/28,158,382,43,0,0,583
rapidfort/zookeeper,3.9.1,2023/11/15,37,10,3,1,0,51
rancher/harvester-eventrouter,v0.1.1,2023/07/18,0,4,5,0,1,10
balenalib/asus-tinker-board-alpine-golang,20231106,2023/11/07,0,0,4,0,0,4
bitnami/node,20.9.0,2023/10/24,425,80,47,5,0,557
rancher/opni-preprocessing-service,v0.12.1-rc1,2023/11/10,2,10,15,0,7,34
bitnami/prometheus,2.47.2,2023/11/09,74,22,14,2,0,112
rancher/netes,v1.7.6-netes2-1,2017/09/23,597,900,62,1,0,1560
datadog/dd-lib-js-init,v4.18.0,2023/11/03,0,1,4,0,0,5
rancher/heapster-grafana-amd64,v4.4.3,2017/09/05,1,8,4,1,0,14
balenalib/i386-nlp-ubuntu-openjdk,20210225,2021/04/11,151,500,17,0,0,668
lacework/lacework-scan,1.2.0,2023/06/08,2,10,16,2,0,30
airbyte/source-qonto,0.2.0,2023/10/25,0,11,18,0,0,29
balenalib/nitrogen6x,20220714,2022/07/20,124,68,74,18,0,284
balenalib/hummingboard,20230904,2023/09/09,118,36,40,6,0,200
pachyderm/notebooks-user,v2.8.0-rc.2,2023/11/13,59,63,26,1,0,149
airbyte/integration-base,0.1.0,2023/01/18,53,244,51,5,0,353
grafana/tns-loadgen,842bd3b,2021/10/31,2,14,13,0,0,29
adobecoldfusion/coldfusion,latest-2023,2023/11/16,28,29,50,23,0,130
vmware/vss-remediation-worker,440-python3.8-alpine3.12,2023/09/27,66,218,168,28,0,480
rancher/network-manager,v0.8.8,2017/09/30,306,388,24,0,0,718
balenalib/revpi-core-3-alpine-openjdk,8-20231106,2023/11/07,0,0,4,0,0,4
balenalib/up-board-debian-python,20230712,2023/07/30,0,1,0,0,0,1
airbyte/source-appfollow,1.0.0,2023/08/21,140,78,41,3,0,262
rancher/mirrored-cilium-cilium,v1.14.4,2023/11/13,19,8,0,0,0,27
google/apigee-mart-server,1.8.0-preview.2,2022/02/18,10,29,28,3,4,74
rapidfort/oncall,v1.0.51,2023/11/17,0,18,21,1,0,40
docker/ecs-searchdomain-sidecar,1.0,2020/10/26,null
okteto/spring-boot-jib,debug2,1970/01/01,37,69,80,28,7,221
balenalib/asus-tinker-board-s-debian-golang,20230911,2023/09/12,442,111,73,9,0,635
docker/dtr,2.8.1,2020/06/17,5,29,37,4,0,75
airbyte/source-mongodb-v2,1.0.9,2023/11/14,2,30,15,2,0,49
okteto/admission-controller,0.2,2019/05/29,0,0,0,2,0,2
onlyoffice/dropbox-auth,1.0.0-rc7,2023/09/04,0,4,7,0,0,11
hashicorp/nomad-website,539195317e77b29c27ffbc0de027bbbf225e7e2cd2a97862659d2fc51dff90a7,2021/03/30,10,61,90,17,0,178
balenalib/asus-tinker-board-s,20230911,2023/09/11,118,36,40,6,0,200
rancher/dqlite-build,v1.4.1-r1,2020/04/23,null
rapidfort/envoy,1.27.1,2023/10/17,19,2,1,0,0,22
rancher/convoy-agent,v0.12.0,2016/09/30,null
astronomerinc/ap-e2e-test,0.3.6,2023/05/25,1107,460,297,19,3,1886
intel/intelligent_traffic_management_pipeline_server_init_dev,2.0,2022/11/15,45,50,5,0,0,100
balenalib/asus-tinker-board-s-ubuntu-python,20231026,2023/11/02,37,10,0,0,0,47
mirantis/dtr-notary-signer,3.0.0-alpha.2,2021/09/22,0,6,26,3,0,35
balenalib/fincm3-debian-node,20230530,2023/07/02,118,38,41,6,0,203
circleci/rabbitmq,3.7.7,2018/09/10,89,117,194,58,12,470
kasmweb/discord,1.14.0,2023/09/14,187,380,0,0,0,567
intel/opae-nlb-demo,0.28.0,2023/09/22,null
balenalib/colibri-imx6dl-alpine-node,20220714,2022/07/19,7,38,36,10,0,91
balenalib/beaglebone-green-wifi-alpine-python,20231106,2023/11/07,0,1,4,0,0,5
airbyte/container-orchestrator,0.50.34,2023/11/09,4,72,57,0,0,133
datadog/agent-buildimages-windows_1909_x64,v3686353-1e75137,2021/01/12,8,49,134,12,0,203
bellsoft/buildpacks.liberica,1.0.0,1980/01/01,0,4,2,0,0,6
mirantis/jenkins,2.121.3,2018/09/05,314,496,447,151,19,1427
pachyderm/chess-analyze,866d97ff6035463c92030b8f01b861c7,2016/12/01,640,1033,72,1,0,1746
google/dart,2.16-beta,2021/12/13,190,104,123,39,9,465
onlyoffice/docspace-studio-notify,1.1.4.1,2023/10/23,1016,143,210,12,0,1381
bitnami/minio-client,2023.11.10,2023/11/16,74,12,8,2,0,96
onlyoffice/docs-converter-ee,7.5.1-1,2023/11/09,0,2,0,0,0,2
docker/desktop-kubernetes-proxy,v1.28.2,2023/09/13,22,9,7,0,0,38
balenalib/am571x-evm-fedora-node,36-build-20220714,2022/07/22,0,1,1,0,0,2
kasmweb/core-oracle-9,1.14.0,2023/09/09,16,111,914,0,0,1041
balenalib/artik10-fedora,20220714,2022/07/23,null
kong/ubi-kuma-prometheus-sd,1.9.8,2023/07/28,43,40,9,0,0,92
purestorage/cockroach-operator,v1.2.2,2022/01/28,0,8,14,1,0,23
docker/embedded-docs-extension,0.0.1-alpha.2,2022/01/21,0,12,22,1,0,35
okteto/gradle,6.5,2023/08/24,170,328,40,2,0,540
intel/esp-logging-agent,v3.1.2,2023/08/17,92,30,32,6,0,160
astronomerinc/ap-openresty,1.21.4-12,2023/11/08,0,0,2,0,0,2
balenalib/bananapi-m1-plus-fedora-golang,20221210,2022/12/13,null
docker/ucp-calico-cni,3.3.1,2020/06/26,116,270,27,0,0,413
vmware/vfile,0.21,0001/01/01,0,16,8,2,0,26
balenalib/colibri-imx6dl-alpine-python,20220714,2022/07/19,7,38,37,10,0,92
airbyte/source-youtube-analytics-business,0.1.0,2022/11/09,0,17,27,1,0,45
bitnami/neo4j,5.13.0,2023/11/03,74,12,8,2,0,96
balenalib/artik710-python,20230829,2023/09/02,118,37,40,6,0,201
okteto/registry-auth,0.1.2,2020/02/05,3,18,41,4,0,66
balenalib/artik530-fedora-node,36-build-20220803,2022/08/04,0,1,1,0,0,2
rancher/opni-training-controller,v0.1.2,2021/07/12,188,146,139,44,8,525
balenalib/artik5-ubuntu-node,20220715,2022/08/02,88,83,12,0,0,183
mirantis/k8s-daemonupgradecontroller,1.5,2017/06/02,0,1,3,0,0,4
airbyte/source-apify-dataset,2.1.0,2023/10/13,0,14,26,1,0,41
airbyte/destination-firebolt,0.1.0,2022/06/27,80,44,47,9,0,180
hashicorp/packer,1.9.4,2023/08/18,1,2,10,1,0,14
pachyderm/pgbouncer,1.17.0-1,2022/05/05,452,315,214,21,1,1003
bitnami/sealed-secrets-controller,v0.24.3,2023/11/02,null
balenalib/apalis-imx6q-ubuntu-python,20220622,2022/06/23,87,113,13,0,0,213
datadog/watermarkpodautoscaler,v0.6.0,2023/10/10,61,17,8,0,0,86
grafana/loki-canary-boringcrypto,2.9.2,2023/10/25,0,1,5,0,0,6
dynatrace/dynatrace-activegate,1.277.180.20231107-134834,2023/11/07,24,4,0,0,0,28
rancher/git-porter,v2.0.0,2022/06/29,8,40,48,13,0,109
rancher/mirrored-calico-ctl,v3.26.3,2023/10/06,0,2,2,0,0,4
rancher/vm-ubuntu,18.04.1-server-amd64-old,2018/11/26,null
balenalib/raspberry-pi2-openjdk,20230911,2023/09/12,129,64,44,6,0,243
balenalib/beaglebone-green-debian-golang,20230911,2023/09/11,442,111,73,9,0,635
grafana/worldping-gw,37b8b2f,2017/11/23,0,1,1,0,0,2
airbyte/cli,0.40.15,2022/10/13,0,25,21,2,0,48
intel/xpumanager,v1.2.13,2023/06/29,24,17,5,0,0,46
graphcore/pytorch-jupyter,3.2.1,2023/05/31,297,500,26,0,0,823
lacework/ephemeral_job_controller_post_processor,20231113-main-9895c0e,1970/01/01,12,18,14,7,0,51
intel/oact-webui,v2.15.0,2023/10/31,0,0,2,0,0,2
grafana/github-repo-metrics,v2,2018/05/09,55,43,70,17,10,195
balenalib/artik533s-alpine-openjdk,8-jre-20220803,2022/08/04,34,78,48,10,0,170
intel/observability-collectd,1.0,2022/06/03,7,67,49,7,0,130
onlyoffice/documentserver-ie,6.0.2.5,2020/11/09,364,1043,60,0,0,1467
jetbrains/qodana-js,2023.2,2023/09/06,138,48,61,11,0,258
rancher/jenkins-jnlp-slave,3.40-1,2020/01/11,64,95,181,48,10,398
docker/ucp-nvidia-device-plugin,3.3.1,2020/06/26,5,26,25,1,0,57
google/cadvisor,v0.33.0,2019/02/27,0,0,8,8,0,16
rancher/mirrored-messagebird-sachet,0.3.1,2022/04/07,0,16,15,1,0,32
airbyte/base-airbyte-protocol-python,0.1.1,2021/04/03,105,57,77,30,7,276
amazon/amazon-ecs-network-sidecar,2.0.0,2022/12/23,3,26,11,0,0,40
balenalib/raspberry-pi2-ubuntu-openjdk,11-xenial-20231026,2023/11/02,null
pachyderm/mount-server-amd64,97276071e371d5b1ea221437e99cfd87b5599ddf,2023/11/03,94,16,28,2,0,140
bellsoft/liberica-openjre-debian,21.0.1-12,2023/11/14,105,17,20,4,0,146
balenalib/fincm3-debian-openjdk,20230530,2023/07/04,143,72,46,6,0,267
kasmweb/atom,1.14.0,2023/09/14,189,380,0,0,0,569
airbyte/destination-csv,1.0.0,2023/01/10,60,180,144,2,0,386
balenalib/armv5e-python,20191011,2019/10/29,185,170,174,35,8,572
balenalib/odroid-c1-alpine,20220714,2022/07/19,7,37,35,10,0,89
grafana/pyroscope,1.1.5,2023/10/12,0,6,10,0,0,16
kasmweb/only-office,1.14.0,2023/09/14,189,380,0,0,0,569
circleci/postgres,13.5,2021/12/18,120,81,77,26,0,304
balenalib/orbitty-tx2,20231106,2023/11/07,114,20,29,4,0,167
balenalib/beaglebone-green-wifi-alpine-openjdk,8-20231106,2023/11/07,0,0,4,0,0,4
vmware/pmdui-toolchain-photon2,1.0.0,2018/07/24,15,193,194,79,0,481
airbyte/source-facebook-marketing-api-singer,0.1.5,2020/12/16,570,371,312,40,7,1300
balenalib/nitrogen6x-ubuntu-node,20220715,2022/07/19,88,104,12,0,0,204
astronomerinc/ap-kube-state,2.10.0,2023/08/31,0,2,1,0,0,3
objectscale/dcm,0.71.3,2021/04/15,16,142,197,36,3,394
intel/rdma_rhel_intel,1.0,2023/04/11,103,73,8,0,0,184
rapidfort/mongodb-perfomance-test,7461f9faf40138c52dc31f5889eb04bddda66a43,2022/06/26,156,115,124,36,0,431
datadog/docker-dd-agent,12.9.5328,2020/10/08,131,82,107,27,6,353
pachyderm/test,9968828025df9eab37b9b01837c11a80cf624f75,2017/09/28,65,106,17,0,0,188
bitnami/pinniped-cli,0.27.0,2023/11/09,84,17,19,4,0,124
rancher/mirrored-directxman12-k8s-prometheus-adapter-amd64,v0.8.3,2021/01/26,null
balenalib/artik10-alpine-python,20220803,2022/08/04,7,38,37,10,0,92
pachyderm/ubuntu-with-s3-clients,v0.0.2,2022/02/18,357,726,69,0,0,1152
google/apigee-asm-istiod,1.12.9-asm.3,2022/09/30,74,139,14,0,0,227
kasmweb/hunchly,1.14.0,2023/09/14,189,380,0,0,0,569
balenalib/asus-tinker-board-ubuntu-openjdk,11-xenial-20231026,2023/11/02,null
google/apigee-runtime,1.8.0-preview.2,2022/02/18,10,36,34,3,4,87
airbyte/destination-dynamodb,0.1.7,2022/11/03,64,201,189,17,0,471
airbyte/source-workramp,0.1.0,2022/11/14,0,17,27,1,0,45
airbyte/source-instagram,1.0.14,2023/11/13,129,37,13,1,0,180
kasmweb/fedora-37-desktop,1.14.0,2023/09/14,0,3,2,0,0,5
objectscale/management-gateway,0.71.3,2021/04/02,5,52,64,5,2,128
balenalib/revpi-core-3-alpine-python,20231106,2023/11/07,0,1,4,0,0,5
newrelic/fastly-to-insights,1.3.2,2023/11/03,0,1,4,0,0,5
balenalib/armv5e-debian-golang,20200213,2020/02/19,675,536,491,63,9,1774
intel/mcss_covid19_solution,2021.4.2,2021/12/16,277,822,38,0,0,1137
newrelic/k8s-nri-couchbase,2.3.5,2020/02/03,2,10,29,4,0,45
cimg/php,8.2.12,2023/10/25,284,323,45,0,0,652
mattermost/builder,go-1.21.3-node-18.17.1-1,2023/10/12,488,109,84,9,0,690
appdynamics/ad-nite-demo-load,2019-03-13-1552504953,2019/03/13,0,0,4,8,0,12
newrelic/k8s-nri-postgresql,2.3.0,2020/01/03,null
appdynamics/analytics-agent,21.6.0,2021/07/13,145,108,38,4,0,295
airbyte/destination-clickhouse-strict-encrypt,0.2.5,2023/06/23,65,200,176,17,0,458
kong/kced,v0.1.16,2023/06/26,0,10,2,0,0,12
mirantis/ucp-containerd-shim-process,3.7.1,2023/07/28,0,2,2,0,0,4
kong/pulp-content,1.1.38,2022/08/24,4,11,9,4,0,28
airbyte/integration-base-singer,0.1.2,2021/08/02,105,57,77,30,7,276
balenalib/imx6ul-var-dart-fedora-python,20221109,2022/11/16,0,1,0,0,0,1
mattermost/mattermost-test-enterprise,8789a29,2020/03/28,6,45,80,9,0,140
mattermost/mattermost-loadtest,5.11,2019/06/21,205,533,558,123,24,1443
rancher/longhornio-longhorn-engine,v1.3.1,2022/08/11,9,82,82,3,11,187
rancher/ui,wagyu,2017/07/31,511,2270,1379,332,74,4566
mirantis/ucp-azure-ip-allocator,3.7.1,2023/09/26,2,2,4,2,0,10
airbyte/destination-meilisearch,1.0.0,2022/10/27,0,17,27,1,0,45
balenalib/odroid-xu4-python,20230911,2023/09/11,118,37,40,6,0,201
datadog/fips-proxy-dev,0.5.1-dev1,2023/05/17,31,19,2,0,0,52
airbyte/server,0.50.34,2023/11/09,5,72,57,0,0,134
airbyte/source-twilio-singer,0.2.3,2021/06/09,565,341,295,39,7,1247
grafana/agent,v0.37.4,2023/11/06,14,6,1,0,0,21
intel/esp-qemu,v3.1.2,2023/08/16,7,99,77,21,0,204
intel/dlstreamer-edge-ai-extension,0.7.1,2022/05/24,359,1241,52,0,0,1652
balenalib/hummingboard-debian-golang,20230904,2023/09/09,442,111,73,9,0,635
bitnami/ruby,3.2.2,2023/11/21,428,80,48,5,0,561
graphcore/pytorch-tutorials,3.1.0,2023/01/04,401,904,39,1,0,1345
rancher/secrets-bridge,v0.2.0,2016/11/27,null
greenbone/openvas-scanner-build,v22.7.6,2023/10/11,492,99,60,5,0,656
airbyte/source-sendgrid,0.4.1,2023/10/15,64,21,8,1,0,94
airbyte/source-shopify,1.1.4,2023/10/19,64,21,8,1,0,94
ddosify/selfhosted_backend,2.3.1,2023/11/01,412,112,57,3,0,584
hashicorp/consul-ecs,0.7,2023/11/07,0,3,5,0,0,8
rancher/os-pingan,v1.5.8,2021/02/05,135,85,100,23,6,349
circleci/vault-cci,0.4,2021/12/14,3,41,53,14,0,111
rancher/calico-cni,v3.18.1,2021/03/10,0,21,42,0,0,63
bitnami/dokuwiki,20230404.1.0,2023/10/11,160,83,57,5,2,307
rancher/alpine-git,1.0.4,2017/07/27,0,30,12,17,0,59
airbyte/source-google-analytics-data-api,2.0.3,2023/11/03,67,23,9,1,0,100
bitnami/openldap,2.6.6,2023/11/15,92,16,16,2,0,126
rancher/hardened-dns-node-cache,1.22.20-build20231010-s390x,2023/10/10,3,8,13,0,2,26
airbyte/source-s3-bulk,4.1.3-dev.cc832795bb,2023/11/14,129,37,13,2,0,181
balenalib/generic-aarch64-fedora-openjdk,8-20231106,2023/11/06,null
balenalib/generic-aarch64-alpine-openjdk,8-20231106,2023/11/06,8,8,4,0,0,20
jetbrains/datalore-agent,2023.5.1,1970/01/01,182,214,36,0,0,432
rancher/mirrored-neuvector-registry-adapter,0.1.1,2023/08/17,0,0,4,0,0,4
airbyte/source-commercetools,0.2.0,2023/08/24,0,15,26,1,0,42
balenalib/artik10-alpine,20220803,2022/08/03,7,37,35,10,0,89
continuumio/ap-auth-keycloak,4.5.0.Final,2018/10/16,874,1195,354,88,0,2511
cockroachdb/molt-lms,0.2.2,2023/11/13,0,0,4,0,0,4
airbyte/destination-s3-glue,0.1.7,2023/05/04,65,199,174,17,0,455
google/apigee-installer,1.8.1,2022/09/22,0,2,6,0,0,8
balenalib/spacely-tx2-fedora-golang,20231106,2023/11/06,null
okteto/fileserver,0.0.0,2021/12/17,null
redislabs/redis-connect-sqlserver,0.8.0-139,2022/01/22,4,27,36,13,0,80
bitnami/milvus,2.3.3,2023/11/15,74,14,12,2,0,102
airbyte/webapp,0.50.34,2023/11/09,0,2,3,0,0,5
balenalib/intel-nuc-fedora-golang,20231103,2023/11/04,null
rancher/tektoncd-kubeconfigwriter,2000fdb7,2019/05/29,0,0,0,0,6,6
datadog/observability-pipelines-worker,1.6.0,2023/11/03,28,10,0,0,0,38
pachyderm/python-build,2.0.0-alpha.20,2021/05/25,1441,1309,918,142,39,3849
balenalib/hummingboard-ubuntu-openjdk,11-xenial-20230904,2023/09/09,null
airbyte/source-quickbooks,3.0.0,2023/09/27,0,15,26,1,0,42
docker/binfmt,820fdd95a9972a5308930a2bdfb8573dd4447ad3,2019/05/20,null
hashicorp/learn-website,85289765ffa05e170f7e2faedbbfefa46cd3d8d8e4b307fabae676ce5bf0e131,2020/07/27,18,131,201,40,0,390
rancher/mirrored-ingress-nginx-kube-webhook-certgen,v1.3.0,2022/08/01,0,3,6,0,0,9
airbyte/base-python-test,0.1.1,2021/04/03,105,57,77,30,7,276
airbyte/source-zendesk-support-singer,0.2.3,2021/07/02,105,61,79,30,7,282
intel/intel-idxd-config-initcontainer,0.28.0,2023/09/22,null
bitnami/mysqld-exporter,0.15.0,2023/11/08,74,14,9,2,0,99
rapidfort/etcd-ib,v3.5.10,2023/11/22,2,0,2,0,0,4
grafana/prometheus-pulsar-remote-write,v0.3.0,2023/03/09,0,16,6,0,0,22
intel/oneapi-iotkit,2023.2.1-devel-ubuntu22.04,2023/07/31,183,173,34,0,0,390
balenalib/artik533s-debian-golang,20220714,2022/07/22,467,265,220,28,1,981
airbyte/source-genesys,0.1.0,2022/11/13,0,15,19,0,0,34
pachyderm/jupyterhub-pachyderm-user,1.1.0,2020/04/15,131,132,56,4,0,323
google/tf-serving-scann,2.11.0,2022/12/08,169,325,36,0,0,530
airbyte/source-google-search-console,1.3.6,2023/10/26,64,21,8,1,0,94
balenalib/raspberrypi3-fedora-golang,20220523,2022/06/04,null
rancher/lb-controller,v0.3.1,2016/10/16,0,9,27,8,0,44
okteto/charts,dev,2020/12/19,25,75,78,12,0,190
docker/ucp-interlock-proxy,3.3.1,2020/06/26,2,19,34,5,0,60
datadog/dd-trace-py,testrunner,2023/02/17,734,322,280,24,3,1363
balenalib/nitrogen6x-ubuntu-openjdk,20210826,2021/09/04,136,435,10,0,0,581
balenalib/qemux86-64-debian-openjdk,20231106,2023/11/06,125,43,31,4,0,203
airbyte/source-zendesk-sunshine,0.2.0,2023/08/24,0,15,26,1,0,42
bellsoft/buildpacks.spring-boot,5.23.0,1980/01/01,null
redislabs/redisml,edge,2019/02/21,49,24,49,9,7,138
docker/kube-compose-api-server,v0.5.0,2022/02/14,0,6,14,1,0,21
kong/inso,2023.5.8,2023/09/07,0,12,10,1,0,23
datadog/agent-buildimages-deb_x64,v20433308-6861270,2023/09/25,3,25,22,1,0,51
balenalib/via-vab820-quad-fedora-golang,20220507,2022/05/12,null
balena/rpi-supervisor,1299,2020/07/31,6,26,55,9,0,96
kasmweb/postman,1.14.0,2023/09/14,191,404,12,8,0,615
balenalib/raspberrypi3-alpine-golang,20231106,2023/11/07,0,0,4,0,0,4
objectscale/objectscale-lcm,1.3.0-274.bf1767e,2023/11/14,0,2,3,0,0,5
sysdig/node-image-analyzer,0.1.29,2023/10/10,101,49,8,0,0,158
airbyte/source-mailchimp,0.8.2,2023/11/14,64,21,9,1,0,95
docker/dtr-api,2.8.1,2020/06/17,7,73,99,18,1,198
airbyte/source-dixa,0.3.0,2023/10/30,0,13,26,1,0,40
intel/alpine,test-rm,2023/01/09,0,18,16,0,0,34
rancher/os2-framework,5517767-amd64,2021/10/22,32,214,199,8,8,461
kong/kubernetes-ingress-controller,3.0,2023/11/03,null
balenalib/artik533s-ubuntu-golang,20220803,2022/08/03,245,463,67,0,0,775
balenalib/armv7hf-fedora-python,20221031,2022/11/04,0,1,1,0,0,2
intel/rpbs_benchmark_service,1.0,2023/08/21,50,25,7,0,0,82
rancher/os-nvidiadriver,v1.5.8,2021/02/05,1360,1402,151,3,1,2917
onlyoffice/docs-spellchecker-de,6.2.2.17,2021/04/27,544,491,32,3,0,1070
balenalib/apalis-imx6q-alpine-golang,20220714,2022/07/27,8,39,40,12,0,99
rancher/rke-tools,v0.1.96,2023/10/30,1,19,18,0,0,38
bitnami/prometheus-rsocket-proxy,1.5.3,2023/11/09,74,22,16,4,0,116
rancher/busybox,1.31.1,2020/06/02,null
dynatrace/dynatrace-synthetic-vuc,1.277.38.20231010-152746,2023/10/10,22,14,5,0,0,41
mattermost/mattermost-team-edition,19698_b6746054,2023/07/31,62,47,10,0,0,119
rancher/telemetry,v0.6.1,2019/10/31,108,74,12,0,0,194
rancher/harvester-load-balancer,v0.2.2,2023/08/29,1,6,10,0,1,18
appdynamics/machine-agent-analytics,23.10.0,2023/10/30,129,30,6,1,0,166
onlyoffice/4testing-appserver-migration,test-2022081607,2022/08/16,1037,333,357,24,1,1752
tenable/audit-utils,20231109.14,2023/11/09,22,9,0,0,0,31
amazon/aws-cli,2.13.35,2023/11/13,0,2,0,0,0,2
kasmweb/opensuse-15-desktop,1.14.0,2023/09/14,6,27,49,3,1,86
rancher/mirrored-sig-storage-csi-node-driver-registrar,v2.9.1,2023/11/09,0,0,1,0,0,1
rapidfort/redis6-ib,6.2.14,2023/10/25,85,34,0,0,0,119
bitnami/consul-exporter,0.9.0,2023/11/08,74,14,12,2,0,102
bitnami/jruby,9.4.3-0,2023/10/24,425,86,48,4,0,563
mirantis/external-dns,v0.5.3,2018/06/15,0,2,2,2,0,6
rancher/mirrored-grafana-grafana-image-renderer,3.8.0,2023/08/25,0,5,9,1,4,19
appdynamics/dotnet-core-agent,23.10.0,2023/10/20,null
docker/cloudbees-jenkins-distribution,2.277.4.2,2021/04/28,253,209,306,79,10,857
airbyte/source-netsuite,0.1.3,2023/01/20,0,14,19,0,0,33
google/apigee-cassandra-backup-utility,1.8.0-preview.2,2022/01/20,9,35,29,6,4,83
redislabs/redisgears,1.2.5,2022/07/05,117,80,87,25,0,309
mirantis/ucp-nvidia-device-plugin,3.7.1,2023/09/26,34,35,9,0,0,78
rancher/nginx-ingress-controller,0.10.2,2018/01/25,88,108,197,64,9,466
bitnami/redis-sentinel-exporter-archived,1.7.1,2021/07/18,130,84,86,25,6,331
greenbone/gvmd,23.1,2023/11/14,94,16,16,2,0,128
onlyoffice/docs-converter,7.5.1-1,2023/11/09,0,2,0,0,0,2
airbyte/bootloader,0.50.34,2023/11/09,5,72,56,0,0,133
balenalib/ts4900-debian-golang,20220714,2022/07/28,467,262,214,28,1,972
atlassian/nfs-server-test,2.1,2023/02/02,228,158,20,0,0,406
rancher/mirrored-prometheus-prometheus,v2.42.0,2023/02/01,0,14,11,0,0,25
docker/extended-logs-extension,0.1.2,2022/04/28,0,12,10,1,0,23
balenalib/artik10-fedora-golang,20220714,2022/07/23,null
balenalib/hummingboard-openjdk,20230904,2023/09/09,129,64,44,6,0,243
airbyte/source-salesforce-singer,0.2.5,2021/08/02,561,317,280,39,7,1204
airbyte/source-tmdb,0.1.0,2022/11/16,0,17,27,1,0,45
airbyte/workload-api-server,final-0,2023/11/14,4,69,54,0,0,127
bitnami/nginx-ldap-auth-daemon-archived,0.20200116.0,2022/04/05,135,83,79,22,6,325
rancher/coreos-configmap-reload,v0.0.1,2017/01/02,null
balenalib/orangepi-plus2,20230911,2023/09/11,118,36,40,6,0,200
hashicorp/sentinel-website,621533a472164fac1133e38562d81440dc48783a,2020/07/06,13,82,133,29,0,257
airbyte/source-my-hours,0.1.1,2022/06/09,0,17,28,1,0,46
ddosify/selfhosted_hammermanager,1.2.2,2023/06/20,77,30,25,2,0,134
balenalib/imx6ul-var-dart-python,20230911,2023/09/12,118,37,40,6,0,201
objectscale/csi-baremetal-loopbackmgr,0.69.0,2021/03/07,68,68,16,0,0,152
balenalib/via-vab820-quad-alpine,20220714,2022/07/19,7,37,35,10,0,89
mirantis/ucp-calico-node,3.7.1,2023/09/26,33,20,8,0,0,61
rancher/storage-nfs,v0.9.7,2018/07/09,125,242,12,0,0,379
docker/ucp-azure-ip-allocator,3.3.1,2020/06/26,2,8,7,1,0,18
datadog/agent-amd64,7.29.1,2021/07/12,34,118,102,5,0,259
hashicorp/terraform-k8s,1.1.2,2022/11/23,0,15,21,1,0,37
balenalib/odroid-c1,20220714,2022/07/20,124,68,74,18,0,284
datadog/chaos-handler,8.3.0,2023/10/26,null
rancher/favorite-tweets,v1.0.2,2019/02/11,589,1564,1276,267,16,3712
rancher/goreleaser,v0.0.1-alpha,2023/03/07,5,42,31,8,0,86
rancher/hardened-whereabouts,v0.6.2-build20231009,2023/10/09,2,6,10,0,2,20
airbyte/source-datadog,0.3.0,2023/08/29,0,15,26,1,0,42
grafana/pdc-agent,0.0.20,2023/11/08,0,0,4,0,0,4
balenalib/asus-tinker-board-golang,20230904,2023/09/09,442,111,73,9,0,635
atlassian/pipelines-agent-log-sidecar,stg-stable,2019/07/03,91,162,172,44,11,480
intel/image-segmentation,tf-spr-3d-unet-mlperf-inference,2023/03/31,33,24,6,0,0,63
balenalib/orangepi-plus2-ubuntu-openjdk,11-xenial-20231026,2023/11/02,null
rancher/mirrored-kube-rbac-proxy,v0.14.0,2022/12/15,0,3,5,0,0,8
kong/kong-build-tools,rpm-1.8.3,2023/02/16,908,998,48,0,0,1954
balenalib/up-board-alpine,20231106,2023/11/07,0,0,4,0,0,4
okteto/doppler-injector,0.2,2019/02/15,4,14,8,2,0,28
balenalib/artik533s-ubuntu-openjdk,20210826,2021/09/21,136,435,10,0,0,581
rancher/mirrored-jettech-kube-webhook-certgen,v1.5.2,2021/04/07,0,5,10,0,4,19
balenalib/raspberrypi3-golang,20230530,2023/06/27,379,57,48,8,0,492
rancher/mirrored-kiwigrid-k8s-sidecar,1.24.6,2023/07/06,0,10,5,3,0,18
balenalib/zynq-xz702-fedora-node,36-build-20220714,2022/07/22,0,1,1,0,0,2
balenalib/parallella-ubuntu,20230904,2023/09/09,42,10,4,0,0,56
kasmweb/api,1.14.0,2023/09/14,28,10,1,0,0,39
rancher/os-iscsi,v2.0.873-2,2019/07/23,556,1489,1160,245,14,3464
bitnami/grafana-image-renderer,3.8.4,2023/10/27,160,72,39,3,0,274
bitnami/fluxcd-source-controller,1.1.2,2023/11/15,75,16,10,2,0,103
mattermost/matterwick,v0.3.17,2023/11/14,5,26,15,1,0,47
atlassian/pipelines-docker-daemon,v20-beta,2021/03/04,10,56,62,9,0,137
mattermost/poc-simple-service-daily,v0.0.4,2022/06/22,0,4,5,0,0,9
mattermost/calls-offloader,v0.4.1,2023/10/12,3,10,6,0,0,19
astronomerinc/ap-build,0.3.0-2,2023/08/03,190,219,49,0,0,458
intel/intel-optimized-ml,xgboost-1.4.2,2021/09/07,79,80,8,1,0,168
airbyte/source-postgres-singer,0.1.4,2020/10/26,590,409,394,42,11,1446
atlassian/agent-setup-git,1.6,2016/06/28,1,62,59,23,0,145
balenalib/ts4900-debian-python,20220604,2022/06/12,124,81,76,20,0,301
balenalib/odroid-c1-debian-node,18.6-20220714,2022/07/21,124,70,75,18,0,287
rancher/kolla-base,mitaka,2016/06/16,435,2519,1677,451,78,5160
rancher/docker-elasticsearch-kubernetes,5.6.2,2017/09/28,17,76,47,13,0,153
hashicorp/envoy,1.27.2,2023/10/23,7,0,0,0,0,7
grafana/enterprise-metrics-boringcrypto,v2.10.4,2023/11/14,0,1,4,0,0,5
rancher/mirrored-prometheus-operator-prometheus-operator,v0.65.1,2023/05/05,0,4,3,0,0,7
balenalib/amd64-ubuntu,20230929,2023/10/07,39,10,4,0,0,53
redislabs/debezium-server,2.0.0.cassandra,2022/11/28,120,197,47,1,0,365
datadog/agent-buildimages-windows_1909_x86,v3686353-1e75137,2021/01/12,8,49,134,12,0,203
airbyte/source-zendesk-singer,0.1.1,2020/12/11,105,80,89,31,7,312
mattermost/chimera,6908324,2021/09/22,0,3,6,0,4,13
newrelic/infrastructure-bundle,3.2.25-rc,2023/11/15,0,7,4,0,0,11
balenalib/hummingboard-debian-python,20230904,2023/09/09,118,37,40,6,0,201
balenalib/armv7hf-debian-openjdk,20230929,2023/10/02,122,64,39,6,0,231
balenalib/parallella-debian,20230904,2023/09/09,118,36,40,6,0,200
rancher/webhook-receiver,v0.2.7,2022/06/08,0,10,7,1,2,20
bellsoft/alpaquita-linux-base,stream-musl-231114,2023/11/14,null
okteto/git-installer,1.2.9,2021/03/11,234,153,186,46,9,628
amazon/opendistro-for-elasticsearch,1.13.3,2021/12/11,566,569,116,10,0,1261
rancher/mirrored-sig-storage-snapshot-controller,v6.2.1,2023/01/04,0,2,2,0,0,4
kasmweb/core-remnux-focal,1.13.1,2023/06/06,250,506,0,0,0,756
vmware/vsphere-storage-for-docker,0.21,0001/01/01,0,1,5,2,0,8
airbyte/source-e2e-test-cloud,2.1.5,2023/10/07,6,59,70,17,0,152
airbyte/destination-weaviate-preview,dev2,2023/09/18,65,24,9,4,0,102
rancher/mirrored-coreos-prometheus-operator,v0.40.0,2020/06/18,0,8,12,0,0,20
greenbone/gvm-libs,23.3.0,2023/03/30,90,34,26,2,0,152
rancher/mirrored-kubernetes-external-dns,v0.7.3,2020/08/05,4,21,46,4,0,75
bitnami/dotnet,7.0.14,2023/11/14,428,78,50,5,0,561
objectscale/objectscale-performance,1.4.0-397.adb0726,2023/11/13,0,3,4,0,0,7
objectscale/ecs-flex-vsphere-plugin,0.71.3,2021/04/14,5,52,64,5,2,128
airbyte/source-mailerlite,0.1.0,2022/10/28,0,17,27,1,0,45
greenbone/notus-scanner,22.6,2023/11/20,73,14,11,1,0,99
balenalib/raspberry-pi2-alpine-python,20231106,2023/11/07,0,1,4,0,0,5
rancher/rke-service-sidekick,v0.1.2,2018/04/02,null
airbyte/integration-singer-postgres-destination,0.1.2,2020/10/08,582,416,399,41,11,1449
datadog/fakeintake,v94025128,2023/07/04,22,9,2,0,0,33
cockroachdb/tpc-e,master,2023/04/27,71,24,20,2,0,117
rancher/os-waagent,v2.2.34-1,2019/01/14,73,165,170,42,19,469
google/apigee-envoy-adapter,v2.1.1,2023/06/07,0,5,8,0,0,13
airbyte/destination-rockset,0.1.4,2022/08/08,81,99,128,34,0,342
airbyte/source-e2e-test,2.1.5,2023/10/06,6,59,70,17,0,152
kasmweb/oracle-8-desktop,1.14.0,2023/09/14,4,16,853,0,0,873
balenalib/beaglebone-green-wifi-debian-node,20230911,2023/09/12,118,38,41,6,0,203
balenalib/kitra710-debian-python,20230829,2023/09/02,118,37,40,6,0,201
airbyte/airbyte-bigquery-destination-abprotocol,0.1.0,2020/10/20,100,75,85,24,6,290
intel/user-oob-client-for-azure,v0.7,2022/09/13,185,454,41,0,0,680
balenalib/artik10-ubuntu,20220714,2022/08/02,87,82,11,0,0,180
astronomerinc/ap-git-sync,3.6.9,2023/08/16,99,24,29,5,0,157
astronomerinc/ap-git-daemon,3.18.4-1,2023/11/06,0,0,3,0,0,3
balenalib/raspberry-pi2-debian,20230911,2023/09/11,118,36,40,6,0,200
balenalib/artik10-alpine-golang,20220803,2022/08/04,8,39,40,12,0,99
balenalib/beaglebone-black-debian-openjdk,20230911,2023/09/12,129,64,44,6,0,243
airbyte/destination-elasticsearch,0.1.6,2022/10/26,60,180,145,2,0,387
balenalib/colibri-imx6dl-debian-python,20220604,2022/06/12,124,81,76,20,0,301
amazon/aws-sam-cli-emulation-image-go1.x,20220125,2022/01/25,1,154,72,1,0,228
objectscale/telegraf,0.54.0,2020/11/06,2,49,53,6,2,112
bitnami/golang,1.21.4,2023/11/08,417,77,44,5,0,543
bellsoft/buildpacks.java-native-image,1.0.0,1980/01/01,0,4,2,0,0,6
intel/recommendation,wide-deep-large-ds-int8-inference,2021/07/24,678,988,164,7,0,1837
rancher/ui-plugin-catalog,1.0.1,2023/10/03,3,5,10,0,2,20
bitnami/oras,1.1.0,2023/11/09,null
bitnami/kubeapps-oci-catalog,2.9.0,2023/10/26,74,12,8,2,0,96
amazon/aws-virtual-gpu-device-plugin,v0.1.1,2020/03/03,43,460,137,8,0,648
airbyte/source-freshcaller,0.3.0,2023/11/07,0,13,26,1,0,40
rancher/mirrored-istio-mixer,1.7.8,2021/02/24,1,9,15,1,4,30
amazon/aws-lambda-provided,alami.2023.11.12.08,2023/11/12,null
intel/reconfigurable-ri-server,4.0,2022/12/21,32,38,27,3,0,100
airbyte/source-db2-strict-encrypt,0.1.19,2023/03/22,61,183,134,2,0,380
objectscale/resource-service,0.71.3,2021/04/15,16,142,197,36,3,394
bitnami/memcached-exporter,0.13.0,2023/11/08,74,14,9,2,0,99
portainer/pri-fidoiot,rv-master,2022/02/02,98,249,8,4,0,359
docker/dtr-notary-signer-s390x,2.5.0-beta3,2018/01/17,0,16,41,34,0,91
onlyoffice/docspace-login,1.1.4.1,2023/10/23,1004,151,215,12,0,1382
balenalib/beaglebone-black-debian-python,20230911,2023/09/12,118,37,40,6,0,201
rancher/rancher-flexvol,567229c-dirty,2016/09/14,97,122,23,0,0,242
balenalib/artik5-python,20220714,2022/07/22,124,69,76,18,0,287
rancher/k8s-dns-sidecar-amd64,1.15.0,2018/11/12,0,0,0,2,0,2
google/apigee-udca,1.8.0-preview.2,2022/04/05,7,30,32,3,4,76
airbyte/destination-redshift,0.6.10,2023/11/09,6,47,62,17,0,132
intel/spark,evi-2.0.0,2022/10/31,67,152,312,136,0,667
airbyte/destination-starburst-galaxy,0.0.1,2023/04/21,67,211,191,20,0,489
airbyte/source-cart,0.2.1,2023/02/23,0,16,27,1,0,44
grafana/loki-query-tee,2.9.2-amd64,2023/10/25,0,1,5,0,0,6
balenalib/asus-tinker-board-s-debian,20230911,2023/09/11,118,36,40,6,0,200
balenalib/nitrogen6x-debian-openjdk,20210602,2021/06/05,230,232,145,39,8,654
circleci/python,3.11-rc,2021/12/18,868,1036,796,103,5,2808
balenalib/hummingboard-fedora-node,36-build-20230530,2023/06/29,0,1,1,0,0,2
airbyte/source-elasticsearch,0.1.1,2022/12/02,60,179,144,2,0,385
balenalib/beaglebone-black-ubuntu-openjdk,11-xenial-20230712,2023/07/14,null
airbyte/source-pocket,0.1.0,2022/11/10,0,17,27,1,0,45
balenalib/spacely-tx2-ubuntu-openjdk,11-xenial-20231103,2023/11/06,null
airbyte/source-captain-data,0.1.0,2023/07/25,0,15,26,1,0,42
rancher/fluentd,v0.1.31,2021/11/16,75,65,56,20,0,216
adobecoldfusion/pmt2021,2021.0.4,2022/12/02,60,89,60,27,0,236
circleci/mariadb,10.7.1,2022/02/22,111,326,8,0,0,445
okteto/golang-http-template,0.1.1,2020/06/01,706,537,508,64,9,1824
pachyderm/tf_job_s3_gateway,1.9.2,2019/08/02,462,737,173,18,0,1390
rancher/git-mirror,v2.0.0,2022/06/29,4,26,29,7,0,66
airbyte/source-sftp,0.1.2,2022/06/17,76,75,63,19,0,233
rancher/k8s-dns-dnsmasq-nanny-amd64,1.15.0,2018/11/12,0,0,0,2,0,2
rancher/mongodb-conf,v0.1.1,2017/02/27,null
grafana/grafana-image-renderer,3.8.4,2023/10/19,0,3,5,1,4,13
airbyte/mirrored-keycloak,21.1,2023/06/28,17,34,7,0,0,58
intel/dlstreamer-pipeline-server-k8s-sidecar,2022.2.0,2022/10/22,77,34,39,3,0,153
newrelic/php-daemon,10.14.0,2023/11/13,null
bitnami/schema-registry,7.5.2,2023/11/09,74,16,14,8,0,112
rancher/mirrored-istio-install-cni,1.19.0,2023/09/01,29,14,8,0,0,51
balenalib/beaglebone-green-wifi-alpine-golang,20231106,2023/11/07,0,0,4,0,0,4
rancher/mirrored-neuvector-updater,latest-amd64,2023/11/20,null
onlyoffice/4testing-docspace-notify,2.0.0.33,2023/11/15,1016,142,207,12,0,1377
balenalib/fincm3-ubuntu-python,20230530,2023/07/02,54,21,4,0,0,79
puppet/estate-reporting-query,85360599b21e795d92898b540e0faac15c0b2d7b,2020/03/24,0,5,5,0,0,10
balenalib/fincm3-ubuntu-node,20230530,2023/07/04,55,21,5,0,0,81
apachepinot/pinot-presto,0.274,2022/07/20,1105,553,840,113,1,2612
balenalib/beaglebone-green-debian,20230911,2023/09/11,118,36,40,6,0,200
balenalib/artik5-debian,20220714,2022/07/22,124,68,74,18,0,284
google/apigee-stackdriver-prometheus-sidecar,1.0.0-beta,2019/03/25,null
newrelic/k8s-golang-apm-linkage-demo,1.1.0,2019/04/01,6,20,11,2,0,39
dynatrace/dynatrace-push-event-bitbucket-pipe,0.1.0,2021/04/15,4,10,9,1,0,24
rancher/calico-node,v3.18.1,2021/03/11,60,106,32,0,0,198
atlassian/agent-setup-hg,1.15,2016/06/30,0,57,44,18,0,119
rancher/cli2,v2.8.0,2023/10/23,0,4,8,0,1,13
bitnami/nginx-exporter,0.11.0,2023/11/09,74,12,8,2,0,96
airbyte/destination-mysql,0.2.0,2023/06/29,65,199,176,17,0,457
syncfusion/pdfviewer-server,23.1.36,2023/09/15,185,109,54,3,0,351
balenalib/kitra520-fedora,20220714,2022/07/23,null
okteto/syncthing,1.3.0,2019/10/07,4,19,21,1,0,45
qualys/qualys-client-for-jira-integration,1.2.0,2023/10/13,0,5,5,0,0,10
okteto/dns,0.1.0,2020/06/13,3,20,41,4,0,68
mirantis/virtlet,v1.5.1,2019/05/16,339,505,35,0,0,879
okteto/node,18,2023/08/24,484,281,92,10,2,869
objectscale/csi-baremetal-scheduler,0.69.0,2021/03/07,72,84,27,1,0,184
airbyte/source-paystack,0.1.3,2023/03/21,0,16,27,1,0,44
balenalib/odroid-xu4-fedora-openjdk,30-20210825,2021/09/03,null
balenalib/revpi-core-3-ubuntu-golang,20231026,2023/11/02,133,131,0,0,0,264
rancher/mirrored-k8s-dns-kube-dns,1.22.20,2023/02/22,0,2,1,0,0,3
redislabs/rgcluster,1.2.7,2022/07/05,117,80,87,29,0,313
rancher/opni-training-controller-service,v0.12.1-rc1,2023/11/10,8,84,95,6,11,204
rancher/istio-pilot,1.8.3,2021/02/05,302,918,127,2,0,1349
balenalib/armv5e-debian-openjdk,20200221,2020/02/29,259,275,214,44,8,800
formio/sql-connector,2.0.10,2022/09/22,5,80,88,14,0,187
mirantis/ucp,3.7.1,2023/09/26,4,5,8,2,0,19
balenalib/amd64-alpine-golang,20231106,2023/11/07,0,0,4,0,0,4
kasmweb/agent,1.14.0,2023/09/14,25,9,0,0,0,34
balenalib/asus-tinker-board-fedora-python,20221109,2022/11/16,0,1,0,0,0,1
mattermost/mm-ee-test,9986853,2023/05/07,72,78,12,0,0,162
rancher/openzipkin-zipkin,2.14.2,2019/06/15,5,42,84,31,6,168
rancher/system-agent-installer-k3s,v1.28.3-k3s2-linux-s390x,2023/11/08,null
mirantis/ucp-pause,3.7.1,2022/12/22,null
bitnami/mongodb,7.0.3,2023/11/17,81,13,13,3,0,110
percona/mongodb_exporter,2.37.0,2023/04/06,0,2,3,0,0,5
airbyte/source-drift,0.3.0,2023/08/15,0,15,26,1,0,42
rancher/gc-manager,v0.1.0,2017/05/17,97,113,18,0,0,228
balenalib/apalis-imx6q-debian,20220714,2022/07/20,124,68,74,18,0,284
bitnami/grafana-loki,2.9.2,2023/11/08,74,14,10,2,0,100
newrelic/newrelic-infra-operator,0.13.0,2023/11/13,0,0,4,0,0,4
balenalib/stem-x86-32-debian-openjdk,20230904,2023/09/09,129,64,44,6,0,243
percona/dbaas-catalog,0.0.66,2023/09/13,1,8,10,0,0,19
okteto/maven,3,2023/08/24,10,98,67,0,0,175
sysdig/kubewatcher,0.3.0,2019/11/26,503,2377,1485,386,72,4823
adobecoldfusion/coldfusion2021,2021.0.11,2023/10/06,32,57,182,104,0,375
docker/dtr-rethink-s390x,2.5.0-beta3,2018/01/17,2,16,7,15,0,40
graphcore/pytorch-paperspace,3.3.0,2023/07/03,220,346,28,0,0,594
vmware/cascade,1.0,2018/04/13,14,145,161,65,0,385
intel/oneapi,2023.2-devel-ubuntu22.04,2023/07/14,189,178,39,0,0,406
circleci/circleci-cli,0.1.29314,2023/11/08,294,325,45,0,0,664
redislabs/redis-connect-cli,v0.24.1-beta.15,2022/10/31,68,75,10,0,0,153
rancher/library-busybox,1.32.1,2021/04/08,null
rancher/giddyup,v0.19.0,2017/08/24,40,79,82,22,18,241
objectscale/csi-baremetal-scheduler-extender,0.69.0,2021/03/07,71,79,21,0,0,171
okteto/actions-base,1.0,2022/04/06,194,248,192,30,7,671
mattermost/release-bot-daily,66938499,2022/08/25,null
rancher/hardened-kubernetes,v1.21.2,2021/06/28,455,436,101,8,0,1000
balenalib/ts4900-debian-node,18.6-20220714,2022/07/21,124,70,75,18,0,287
puppet/puppetboard,0.3.0,2018/06/05,1,21,15,1,0,38
balenalib/jetson-tx2-alpine-golang,20231106,2023/11/06,0,0,4,0,0,4
docker/ucp-hrm,2.2.22,2019/10/07,4,11,20,1,0,36
rancher/mirrored-plugins-docker,19.03.8,2020/11/19,3,13,33,5,0,54
intel/intel-optimized-lammps,202302,2023/02/13,262,406,56,0,0,724
bitnami/cassandra,4.1.3,2023/11/16,79,24,19,2,0,124
datadog/serverless-init,1.1.3,2023/11/01,0,0,1,0,0,1
rancher/os-amazonmetadata,v1.5.8,2021/02/05,2,10,28,5,0,45
astronomerinc/ap-postgres-operator,1.8.2,2023/02/07,0,3,7,1,0,11
kasmweb/signal,1.14.0,2023/09/14,187,380,0,0,0,567
rancher/cert-manager-controller-arm64,v0.7.2-rio.1,2019/05/15,0,0,0,2,0,2
rancher/mirrored-istio-galley,1.5.9,2020/08/07,405,1084,142,0,0,1631
grafana/tns-lint,6daf0b2,2020/06/29,4,15,37,5,0,61
kong/ubi-kuma-cni,2.4.4,2023/11/06,30,26,8,0,0,64
airbyte/source-postmarkapp,0.1.0,2022/11/09,0,17,27,1,0,45
rancher/mirrored-openpolicyagent-gatekeeper,v3.13.0,2023/08/08,0,3,3,0,0,6
balenalib/artik530-ubuntu-node,20220715,2022/08/02,88,83,12,0,0,183
balenalib/fincm3-alpine-openjdk,8-20230530,2023/06/26,8,18,7,2,0,35
appdynamics/ad-nite-java-services,2019-03-13-1552511460,2019/03/13,114,123,124,40,0,401
kong/httpbin,0.1.0,2022/06/23,214,551,54,3,0,822
balenalib/artik5-ubuntu-golang,20220803,2022/08/03,245,463,67,0,0,775
rancher/mirrored-cilium-hubble-ui,v0.12.1,2023/10/11,2,4,9,5,0,20
rancher/build-master,v0.20.0,2016/06/23,582,863,84,1,0,1530
amazon/lambda-build-node10.x,20190802,2019/08/13,61,640,538,16,0,1255
bitnami/configmap-reload,0.12.0,2023/11/08,74,12,8,2,0,96
jetbrains/upsource-cluster-init,2020.1.1992,2022/03/11,79,148,245,95,0,567
intel/xfastertransformer,1.0.0,2023/11/07,76,75,0,0,0,151
balenalib/am571x-evm-debian-node,18.6-20220714,2022/07/21,124,70,75,18,0,287
balenalib/qemux86-64-debian-python,20231106,2023/11/06,114,21,29,4,0,168
rancher/mongodb-config,v0.1.1,2017/02/27,null
grafana/mimir-build-image,5335_d9796228c4f26ab68a87f048f39245de,2023/06/26,488,211,192,18,0,909
balenalib/via-vab820-quad-golang,20220714,2022/07/28,467,262,214,28,1,972
datadog/fake-datadog,20220621,2022/06/15,1,14,24,1,0,40
okteto/installer,75436354,2023/09/21,0,20,11,0,0,31
bitnami/pinniped,0.27.0,2023/11/09,0,3,4,0,0,7
astronomerinc/ap-alertmanager,0.26.0,2023/08/24,0,4,2,0,0,6
airbyte/source-auth0,0.5.1,2023/10/20,64,21,8,1,0,94
circleci/cci-demo-docker-primary,0.0.2,2017/03/15,153,470,416,136,53,1228
docker/aci-hostnames-sidecar,1.0,2020/10/28,null
rapidfort/redis,7.2.1,2023/10/17,28,4,2,0,0,34
balenalib/armv5e-golang,20200213,2020/02/19,675,536,491,63,9,1774
bitnami/kafka,3.6.0,2023/11/14,84,14,15,6,0,119
hashicorp/spark-nomad,2.1.1,2017/06/06,102,290,337,175,30,934
balenalib/fincm3-alpine-python,20230530,2023/06/21,2,13,6,2,0,23
rapidfort/etcd,3.5.9,2023/10/11,32,12,9,0,0,53
bitnami/vault-k8s,1.3.1,2023/11/09,84,14,15,4,0,117
mattermost/mattermost-cloud-e2e,9839667,2022/12/09,0,10,10,0,0,20
bitnami/gitlab-runner,16.5.0,2023/11/08,109,19,30,5,0,163
balenalib/kitra710-node,20230904,2023/09/09,118,38,41,6,0,203
jetbrains/upsource-frontend,2020.1.1992,2022/03/11,79,148,245,95,0,567
balenalib/odroid-c1-debian-openjdk,20210602,2021/06/05,230,232,145,39,8,654
airbyte/source-amazon-sqs,0.1.0,2021/10/26,0,21,50,8,0,79
cockroachdb/builder-arm64v8,20180403-041732,2018/04/03,445,767,44,0,0,1256
balenalib/aarch64,20231106,2023/11/07,107,20,23,4,0,154
balenalib/intel-nuc-fedora,20231103,2023/11/04,null
balenalib/stem-x86-32-python,20230904,2023/09/09,118,37,40,6,0,201
rancher/mirrored-cilium-cilium-etcd-operator,v2.0.7,2019/09/18,null
puppet/puppet-inventory,0.4.0,2018/05/09,113,148,12,0,0,273
balena/yocto-build-env,9980750,2022/08/11,90,296,14,0,0,400
docker/buildx-bin,0.12.0-rc2,2023/11/14,0,2,4,0,0,6
balenalib/artik710-alpine-node,20230811,2023/08/22,2,1,6,2,0,11
percona/everest-catalog,0.4,2023/11/17,1,6,9,0,0,16
rapidfort/memcached-official,1-bullseye,2023/06/14,20,4,4,0,0,28
airbyte/java-datadog-tracer-base,3.2,2022/10/07,59,140,117,0,0,316
rancher/mirrored-epinio-epinio-server,v1.10.0,2023/09/25,0,10,3,0,0,13
redislabs/vault-ca,1.8,2017/12/26,146,158,15,0,0,319
airbyte/destination-sftp-json,0.1.0,2021/11/24,82,60,60,24,1,227
ddosify/ddosify-docker-extension,0.2.3,2023/03/23,0,12,12,0,0,24
amazon/aws-sam-cli-emulation-image-ruby2.5,20220125,2022/01/25,1,154,76,2,0,233
balenalib/via-vab820-quad-alpine-golang,20220714,2022/07/27,8,39,40,12,0,99
balenalib/odroid-xu4,20230911,2023/09/11,118,36,40,6,0,200
solace/solace-pubsub-connector-jms,1.0.0,2023/10/16,72,36,3,1,0,112
objectscale/nginx,3.9.0.0-1588.729cf194,2023/04/25,4,34,24,0,0,62
hashicorp/tfc-agent,1.14,2023/11/17,24,25,0,0,0,49
astronomerinc/ap-keda,2.3.0,2021/06/30,0,4,12,0,4,20
balenalib/bananapi-m1-plus-ubuntu-node,20231026,2023/11/02,38,10,1,0,0,49
redislabs/redis-connect-mysql,0.5.0-13,2022/01/22,4,28,36,13,0,81
balenalib/kitra520-debian-golang,20220714,2022/07/22,467,265,220,28,1,981
objectscale/object-control,0.71.3,2021/04/15,17,149,215,36,6,423
rancher/prometheus-auth,v0.3.0,2022/12/14,0,9,11,0,2,22
balenalib/apalis-imx6q-python,20220604,2022/06/12,124,81,76,20,0,301
kong/kong-operator,v0.9.0,2021/10/13,124,319,50,2,0,495
balenalib/i386-debian-node,16.19.1-20231106,2023/11/06,107,22,24,4,0,157
intel/intelligent_traffic_management_rule_engine_dev,2.0,2022/12/06,61,88,12,0,0,161
objectscale/mock-notifier,v2.74.0,2021/05/25,2,16,18,0,0,36
airbyte/source-acceptance-test,0.5.0,2023/01/30,0,17,28,1,0,46
airbyte/source-mailersend,0.1.0,2022/11/13,0,17,27,1,0,45
balenalib/bananapi-m1-plus-alpine-golang,20231106,2023/11/07,0,0,4,0,0,4
balenalib/bananapi-m1-plus-alpine-openjdk,8-20231106,2023/11/07,0,0,4,0,0,4
rancher/node-exporter,v0.17.0,2018/11/30,null
okteto/remote,0.4.2,2021/04/28,0,1,3,0,0,4
snyk/kubernetes-operator-bundle,1.100.2,2023/01/03,null
newrelic/k8s-nri-memcached,2.1.0,2019/11/25,null
google/apigee-emulator,1.9.1,2023/04/11,8,42,35,6,4,95
newrelic/k8s-nri-f5,2.1.0,2019/11/25,null
mirantis/ucp-node-exporter,3.7.1,2023/09/26,2,2,6,2,0,12
rancher/pushprox-client,v0.1.0-rancher2-client,2021/06/03,0,7,28,4,0,39
amazon/amazon-ecs-agent,78294847,2020/02/18,null
objectscale/postgres-operator,ubi8-5.2.0-114.c95664e-226,2023/08/29,61,29,10,1,0,101
balenalib/i386-nlp-node,6.17.1-20190503,2021/04/19,53,49,83,12,5,202
redislabs/kuber,4.5.0-18.1,2017/04/29,598,1068,65,1,0,1732
cockroachdb/cockroach-k8s-request-cert,0.4,2018/10/10,null
balenalib/artik530-debian,20220714,2022/07/22,124,68,74,18,0,284
accurics/cli-kubescan-arm64,1.0.41,2022/09/14,0,28,30,1,0,59
balenalib/nitrogen6x-alpine-node,20220714,2022/07/19,7,38,36,10,0,91
balenalib/raspberry-pi2-debian-openjdk,20230911,2023/09/12,129,64,44,6,0,243
mirantis/ucp-etcd,3.7.1,2023/09/26,2,9,14,2,0,27
balenalib/parallella-node,20230904,2023/09/09,118,38,41,6,0,203
balenalib/spacely-tx2,20231106,2023/11/07,114,20,29,4,0,167
rancher/brand-guidelines,2017-05-09,2017/05/10,71,115,156,56,12,410
docker/vpnkit-forwarder,76371f3a7a14e1f0412c719eea60990ff5938cf7,2019/09/06,null
newrelic/newrelic-k8s-metrics-adapter,0.8.0,2023/11/13,0,0,5,0,0,5
mongodb/apix_test,mongot-noauth,2023/08/22,151,46,13,0,0,210
okteto/crond,0.0.2,2020/10/10,2,10,32,4,0,48
kasmweb/gimp,1.14.0,2023/09/14,213,384,0,0,0,597
google/apigee-redis,1.8.1,2022/05/23,0,0,0,0,4,4
balenalib/artik5,20220714,2022/07/22,124,68,74,18,0,284
airbyte/source-appsflyer,0.1.0,2022/11/29,0,17,27,1,0,45
airbyte/source-shopify-singer,0.2.3,2021/06/09,565,337,294,39,7,1242
rancher/fluent-bit-out-syslog,0.1.0,2020/07/30,83,57,12,0,0,152
circleci/config-setup,0.869,2023/11/07,170,192,5,0,0,367
redislabs/redis,7.2.4-72,2023/10/03,null
dynatrace/dynatrace-operator,0.14.2,0001/01/01,null
redislabs/olmtest,100.0.6-1439.0,2023/11/15,null
balenalib/artik533s-alpine-node,20220803,2022/08/04,7,38,36,10,0,91
bitnami/mongodb-exporter,0.39.0,2023/11/15,74,14,9,2,0,99
grafana/prometheus-pulsar-remote-write-build-image,73484513,2020/08/06,138,251,299,33,10,731
rancher/hardened-cilium-runtime,v1.9.6-build20210526,2021/05/26,445,380,21,3,0,849
intel/rpbs_pipeline_builder_micro_frontend,1.0,2023/08/21,0,2,3,0,0,5
balenalib/raspberrypi3-ubuntu-node,20231026,2023/11/02,38,10,1,0,0,49
airbyte/source-vantage,0.1.0,2022/11/13,0,17,27,1,0,45
grafana/tns-app,842bd3b,2021/10/31,2,14,13,0,0,29
vmware/likewise-open-toolchain-photon,1.0.0,2018/04/10,21,213,227,87,0,548
airbyte/source-k6-cloud,0.1.0,2022/11/09,0,17,27,1,0,45
rancher/kim,v0.1.0-beta.7,2021/10/17,4,18,15,0,0,37
ambassador/telepresence-docker-extension,1.0.19,2023/11/14,0,18,39,0,0,57
intel/oneapi-aikit,2023.2.0-devel-ubuntu22.04,2023/08/09,187,183,42,1,0,413
google/apigee-cassandra-client,1.0.0-beta2,2019/04/06,103,78,35,8,0,224
rancher/rke2-upgrade,v1.28.3-rke2r2-s390x,2023/11/08,0,2,7,0,0,9
atlassian/bitbucket-server,8.15.1,2023/11/18,60,71,11,1,0,143
airbyte/source-kustomer,0.1.2,2021/12/24,0,21,51,8,0,80
bitnami/centos-base-buildpack,7-r9,2022/09/07,896,1008,52,0,0,1956
circleci/server-nomad,0.9-8443593,2019/08/16,312,1443,1027,138,12,2932
balenalib/raspberrypi3-debian-python,20230530,2023/06/27,118,37,40,6,0,201
circleci/server-keysets,v1.0-34-8c6e430,2020/09/14,75,68,2,0,0,145
astronomerinc/ap-certgenerator,0.1.6,2023/10/03,0,2,3,0,0,5
balenalib/revpi-core-3-debian-golang,20230530,2023/06/27,379,57,48,8,0,492
vmware/vs-ui,v0.0.1,2017/12/06,71,75,130,42,12,330
balenalib/asus-tinker-board-s-ubuntu-golang,20231026,2023/11/02,133,131,0,0,0,264
airbyte/source-mssql-strict-encrypt,3.0.0,2023/11/07,2,30,15,2,0,49
airbyte/source-surveycto,0.1.2,2023/07/27,77,36,33,3,0,149
hashicorp/vault-service-broker,0.2.0,2017/07/25,null
onlyoffice/4testing-ds-docservice,6.0.0,2020/10/21,563,567,32,3,0,1165
cimg/rlang,4.2.0,2022/06/13,455,1142,64,0,0,1661
docker/ucp-istio-pilot,3.3.1,2020/06/26,471,1162,150,1,0,1784
mirantis/ucp-metallb-controller,3.7.1,2023/09/26,0,2,5,0,0,7
rancher/mirrored-longhornio-longhorn-ui,v1.5.1,2023/07/19,5,17,14,0,7,43
okteto/calculate,golang,2020/10/01,704,514,490,63,9,1780
balenalib/parallella-openjdk,20230904,2023/09/09,129,64,44,6,0,243
rancher/mirrored-calico-operator,v1.31.1,2023/09/01,0,2,1,0,0,3
balenalib/asus-tinker-board-debian-golang,20230904,2023/09/09,442,111,73,9,0,635
kasmweb/ubuntu-jammy-dind,1.14.0,2023/09/14,270,418,33,0,0,721
airbyte/dst-sf-perf,18,2023/03/22,10,121,123,17,0,271
airbyte/source-cockroachdb,0.1.22,2023/03/22,61,183,134,2,0,380
cimg/aws,2023.09.1,2023/09/26,294,340,51,0,0,685
rancher/klipper-helm,v0.4.3,2021/01/08,12,36,68,15,0,131
hashicorp/consul-dataplane,1.3,2023/11/06,11,5,4,0,0,20
vmware/volume-metadata-syncer,v1.0.0,2019/08/16,14,55,70,30,0,169
kasmweb/almalinux-8-desktop,1.14.0,2023/09/14,0,20,843,0,0,863
onlyoffice/4testing-docspace-people-server,2.0.0.33,2023/11/15,1016,142,207,12,0,1377
balena/armv7hf-supervisor-base,v1.4.7,2019/05/28,null
redislabs/rcp-deployer,94370089edddb8d42e02662046f94cdb,2021/10/03,209,507,60,1,0,777
airbyte/src-e2e-parallel-perf,partial-serde-1,2023/05/27,61,181,131,2,0,375
balenalib/amd64-ubuntu-golang,20230929,2023/10/07,146,135,13,0,0,294
balenalib/aarch64-ubuntu-openjdk,11-xenial-20231103,2023/11/06,null
airbyte/kpy-test,1,2021/05/20,143,95,112,34,7,391
balenalib/hummingboard-ubuntu-node,20230904,2023/09/09,43,11,5,0,0,59
balenalib/beaglebone-black-openjdk,20230911,2023/09/12,129,64,44,6,0,243
docker/devenv-vm-service,v0.2.5,2023/06/02,0,13,9,3,0,25
onlyoffice/docspace-healthchecks,1.1.4.1,2023/10/23,1016,144,211,12,0,1383
mirantis/ucp-secureoverlay-mgr,3.7.1,2023/09/26,2,2,6,2,0,12
onlyoffice/4testing-documentserver-ie,99.99.99.2412,2021/04/23,467,1859,88,0,0,2414
balenalib/artik10-ubuntu-openjdk,20210826,2021/09/21,136,435,10,0,0,581
rancher/opni-metrics-service,v0.7.0,2022/11/23,3,43,32,0,10,88
rancher/grafana-grafana,7.2.1,2020/10/08,4,28,66,9,0,107
objectscale/objectscale-capacity,1.4.0-397.adb0726,2023/11/13,0,3,4,0,0,7
balenalib/beaglebone-green-alpine-golang,20231106,2023/11/07,0,0,4,0,0,4
pachyderm/haberdashery,2.8.0-rc.2,2023/11/13,90,27,25,2,1,145
jetbrains/qodana-jvm,2023.2,2023/09/06,141,55,70,13,0,279
atlassian/stash,3.11,2016/08/22,107,307,352,167,34,967
bitnami/kong-ingress-controller,3.0.0,2023/11/14,74,12,8,2,0,96
balenalib/asus-tinker-board-s-ubuntu,20231026,2023/11/02,37,9,0,0,0,46
docker/ucp-kube-dns-s390x,3.1.0-beta3,2018/10/04,0,0,0,2,0,2
bitnami/azure-cli,2.54.0,2023/11/15,77,13,10,2,0,102
purestorage/node-config,v0.1.0,2020/12/15,2,10,32,4,0,48
bitnami/pytorch,2.1.0,2023/11/16,77,13,9,2,0,101
bitnami/sealed-secrets-kubeseal,v0.24.3,2023/11/02,null
airbyte/source-s3,4.2.1,2023/11/14,129,37,13,2,0,181
graphcore/ipu-operator-controller,1.2.0,2023/05/30,0,3,2,0,0,5
rancher/swarmkit,v1.13-1,2017/01/25,2,49,28,26,0,105
balenalib/parallella-fedora-openjdk,30-20210825,2021/09/03,null
intel/intel-gpu-resource-driver,v0.2.0,2023/09/29,0,4,4,0,0,8
docker/desktop-kubernetes-coredns,v1.10.1,2023/02/06,0,3,3,0,0,6
intel/intel-optimized-cassandra,jdk14,2023/02/13,218,396,12,0,0,626
bitnami/apache-exporter,1.0.3,2023/11/08,72,12,7,2,0,93
airbyte/destination-kinesis,0.1.5,2022/09/22,76,72,59,19,0,226
amazon/amazon-ecs-local-container-endpoints,1.3.0,2020/07/16,40,441,120,8,0,609
appdynamics/appdynamics-cloud-log-collector-agent,23.10.0-759,2023/10/24,0,9,6,0,0,15
rancher/istio-proxy_init,1.3.3,2019/10/11,363,521,36,0,0,920
airbyte/source-slack-singer,0.2.3,2021/06/09,566,339,293,39,7,1244
graphcore/tools,3.2.0,2023/03/14,42,19,0,0,0,61
objectscale/ons,0.71.3,2021/04/15,16,142,197,36,3,394
balenalib/i386-nlp-debian-python,20210225,2021/04/18,195,121,141,43,9,509
docker/ucp-interlock-proxy-s390x,3.1.0-beta3,2018/10/04,2,23,10,5,0,40
balenalib/odroid-c1-openjdk,20210602,2021/06/05,230,232,145,39,8,654
balenalib/parallella-golang,20230904,2023/09/09,442,111,73,9,0,635
circleci/node,17.2.0,2021/12/18,842,1025,790,101,5,2763
airbyte/destination-timeplus,0.1.0,2023/06/14,0,15,27,1,0,43
appdynamics/appdynamics-cloud-operator,23.10.0-1114,2023/10/16,0,2,2,0,0,4
balenalib/bananapi-m1-plus-node,20230904,2023/09/09,118,38,41,6,0,203
rapidfort/elasticsearch-official,8.6.2,2023/05/23,5,21,17,0,0,43
portainer/portainer,1.25.0,2022/05/09,5,19,21,0,0,45
vmware/photon-controller-seed,1.0.3,2017/01/12,10,84,108,57,0,259
rapidfort/apache,2.4.57,2023/10/12,47,11,6,1,0,65
balenalib/revpi-core-3-ubuntu-node,20231026,2023/11/02,38,10,1,0,0,49
airbyte/source-trustpilot,0.1.0,2023/03/16,0,14,19,0,0,33
rancher/pipeline-jenkins-boot,v1.0.0,2018/01/11,15,170,203,107,0,495
onlyoffice/4testing-docspace-files-services,2.0.0.33,2023/11/15,1016,142,207,12,0,1377
pachyderm/market_sentiment,dev0.25,2022/05/04,223,488,74,9,0,794
intel/pmem-csi-driver,v1.1.0,2022/12/19,92,35,45,3,3,178
nginxinc/nginmesh_proxy_init,0.7.1,2018/07/11,53,24,57,13,9,156
rancher/harvester-webhook,v1.2.1,2023/10/26,0,1,6,0,0,7
cockroachdb/cockroach-misc,v23.1.0-alpha.7,2023/03/15,69,45,5,0,0,119
rancher/mirrored-gmsa-webhook-k8s-gmsa-webhook,v0.7.0,2023/08/22,0,1,1,0,0,2
balenalib/artik530-fedora,20220714,2022/07/23,null
rapidfort/mongodb-official,6.0.4-focal,2023/11/17,26,41,10,0,0,77
amazon/aws-lambda-ruby,3.2.2023.11.03.14,2023/11/03,0,2,3,0,0,5
amazon/opendistro-for-elasticsearch-data-prepper,1.0.3,2021/12/20,38,264,102,1,0,405
redislabs/operator-internal,100.0.8-2088,2023/11/14,61,34,17,0,0,112
objectscale/csi-baremetal-operator,0.69.0,2021/03/07,121,227,47,3,0,398
netdata/netdata-debug,v1.43.2,2023/10/30,2,3,5,0,0,10
cimg/ruby,3.2.2,2023/08/30,378,476,49,0,0,903
vmware/cascade-event-toolchain-photon,1.0.7,2018/09/18,61,273,276,115,0,725
grafana/grizzly,0.2.1,2023/02/17,0,19,7,0,0,26
kasmweb/core-debian-bookworm,1.14.0,2023/09/09,408,137,112,18,2,677
balenalib/raspberry-pi2-debian-golang,20230911,2023/09/12,379,57,48,8,0,492
solaceiotteam/apim-portal,0.0.10,2021/09/06,199,262,313,42,8,824
ubuntu/mlflow,2.1.1_1.0-22.04,2023/10/02,27,21,3,8,0,59
google/apigee-cassandra,1.0.0-beta2,2019/05/08,101,181,189,48,6,525
onlyoffice/appserver,1.0.485b,2021/01/28,352,2009,1179,243,0,3783
portainer/portainer-docker-extension,2.19.2,2023/11/12,0,16,12,0,0,28
circleci/slanger,0.4,2022/02/23,50,77,101,12,3,243
hashicorp/nomad-autoscaler,0.3.7,2022/06/10,0,15,15,1,0,31
google/apigee-istio-kubectl,1.4.6,2020/02/22,650,1296,137,0,0,2083
newrelic/k8s-nri-kafka,2.9.2,2020/02/05,47,35,52,5,0,139
syncfusion/boldbi,6.16.12,2023/11/03,216,104,100,11,0,431
atlassian/pipelines-agent,1.80,2016/11/29,73,206,229,114,27,649
balena/i386-supervisor-base,v1.4.7,2019/05/28,null
bitnami/phpbb,3.3.11,2023/10/22,152,85,65,6,2,310
balenalib/amd64-ubuntu-openjdk,11-xenial-20230929,2023/10/07,null
intel/intel-sgx-admissionwebhook,0.28.0,2023/09/22,null
rancher/kubernetes-external-dns,v0.7.3,2020/08/05,4,21,46,4,0,75
rancher/mirrored-longhornio-backing-image-manager,v1.5.1,2023/07/19,4,18,23,0,7,52
rancher/os-preload,v0.7.1,2016/11/11,null
rancher/jenkins-plugins-docker,17.12,2018/02/21,0,8,3,3,0,14
pachyderm/issuesummarization,7927321a08ce4e62a42aa13f057b711c,2018/04/25,516,1492,1030,253,52,3343
docker/ucp-cfssl-s390x,3.1.0-beta3,2018/10/04,0,2,6,16,0,24
balenalib/generic-armv7ahf-ubuntu-golang,20230904,2023/09/09,141,146,23,0,0,310
airbyte/source-intruder,0.1.0,2022/11/14,0,17,27,1,0,45
pachyderm/cert-manager-acmesolver,v0.15.1,2020/05/27,0,0,0,0,6,6
datadog/agent-buildimages-system-probe_x64,v22885174-c6364642,2023/11/06,938,454,374,8,0,1774
vmware/postgresql,9.6.5-photon,2017/11/21,11,78,131,50,0,270
newrelic/cluster-api-controller-arm64,mv1a,2019/04/17,0,0,0,0,6,6
objectscale/objmt,0.71.3,2021/04/15,17,149,215,36,6,423
grafana/ebpf-autoinstrument,0.0.3,2023/07/21,22,12,4,0,0,38
rancher/gitwatcher,v0.4.5,2020/01/03,4,14,12,2,0,32
docker/kube-compose-e2e-tests,v0.5.0,2022/02/14,0,7,14,1,0,22
intel/evi-test-tool,master-ae213cd97d6931b1d44fc7689867cf5701e0f15d,2023/09/23,59,16,7,1,0,83
balenalib/nitrogen6x-ubuntu-python,20220622,2022/06/23,87,113,13,0,0,213
onlyoffice/docspace-files-services,1.1.4.1,2023/10/23,1016,143,210,12,0,1381
balenalib/jetson-tx2-debian-golang,20231106,2023/11/07,436,82,52,5,0,575
rancher/mirrored-grafana-grafana,9.1.5,2022/09/13,0,20,26,0,0,46
balenalib/nitrogen6x-ubuntu,20220714,2022/08/02,87,82,11,0,0,180
balenalib/up-board-ubuntu-golang,20230911,2023/09/12,147,146,23,0,0,316
objectscale/deos-fio,3.14,2020/06/15,10,32,65,6,0,113
docker/app,test.pr420,2018/11/21,0,0,0,2,0,2
vmware/vs-event-manager,v0.0.1,2017/12/05,15,81,98,70,0,264
snyk/kubernetes-operator,2.4.17,2023/11/07,69,52,10,0,0,131
objectscale/objs-pre-upgrade-crds,1.4.0-2770,2023/11/15,0,0,3,0,0,3
percona/everest-operator,0.4,2023/10/31,0,1,1,0,0,2
rancher/os-statescript,v0.7.1,2016/11/11,null
circleci/sshd,0.1,2023/01/16,0,0,0,1,0,1
rancher/mesos-master,0.28.1,2016/05/24,235,326,17,0,0,578
balenalib/stem-x86-32-openjdk,20230904,2023/09/09,129,64,44,6,0,243
intel/deep-learning,2023.2-py3.10,2023/09/20,166,173,24,1,0,364
redislabs/redisstatemachine,edge,2023/05/17,73,25,19,2,0,119
balenalib/i386-golang,20231106,2023/11/06,435,81,52,5,0,573
grafana/tempo,2.3.0,2023/10/30,0,1,5,0,0,6
rapidfort/zookeeper-official,3.8.3-jre-17,2023/10/31,null
bitnami/argo-cd,2.9.1,2023/11/15,117,19,31,3,0,170
airbyte/source-twilio,0.10.0,2023/07/27,151,86,61,10,0,308
puppet/puppetserver,7.9.2,2022/10/17,36,138,2,0,0,176
balenalib/imx6ul-var-dart-ubuntu-python,20231026,2023/11/02,37,10,0,0,0,47
airbyte/destination-clickhouse,0.2.5,2023/06/23,65,200,176,17,0,458
docker/doodle,summer2019,2019/06/19,null
bitnami/kubeapps-apis,2.9.0,2023/11/08,74,30,20,2,0,126
docker/hlb-backend,50b36877f5c4f4f9947837690a988f592450d1de,2018/10/23,1,0,14,11,0,26
google/apigee-hybrid-cassandra,1.8.1,2022/09/13,3,31,47,3,4,88
rancher/metrics-server-amd64,v0.3.1,2018/09/17,null
balenalib/qemux86-64-fedora,20231103,2023/11/04,null
rancher/mirrored-neuvector-scanner,latest-amd64,2023/11/21,1,2,1,0,0,4
okteto/movies-frontend,prod,2020/04/02,2,13,13,1,0,29
rancher/os-docker,19.03.15,2021/02/03,null
atlassian/jira-servicemanagement,5.11.3,2023/11/18,25,29,16,2,0,72
amazon/aws-lambda-python,3.12.2023.11.12.08,2023/11/12,0,2,0,0,0,2
opensearchproject/opensearch,2.11.0,2023/11/09,0,3,5,0,0,8
amazon/amazon-ec2-instance-selector,v2.0.3,2021/08/19,null
intel/intel-optimized-tensorflow-serving,2.8.0,2022/03/29,61,40,2,0,0,103
balenalib/rpi-debian-node,16.19.1-20231106,2023/11/07,107,36,32,4,0,179
rancher/harvester-bundle,v0.2.0,2021/04/30,114,190,11,0,0,315
rancher/mirrored-longhornio-longhorn-manager,v1.5.1,2023/07/19,4,21,31,0,7,63
snyk/snyk,swift,2023/11/21,null
airbyte/source-fastbill,0.2.0,2023/08/23,0,15,26,1,0,42
rancher/hardened-calico,v3.13.3,2020/09/25,469,526,104,4,0,1103
balenalib/via-vab820-quad-node,18.6-20220714,2022/07/21,124,70,75,18,0,287
balenalib/apalis-imx6q-debian-node,18.6-20220714,2022/07/21,124,70,75,18,0,287
docker/ecs-secrets-sidecar,1.0,2020/10/26,null
airbyte/source-freshsales,1.0.0,2023/11/13,0,13,26,1,0,40
balenalib/asus-tinker-board-fedora-node,36-build-20230911,2023/09/12,0,1,1,0,0,2
okteto/tfenv-ci,1.4,2022/04/28,9,46,62,17,0,134
newrelic/cluster-api-aws-controller,8325527a,1970/01/01,7,18,13,3,6,47
continuumio/repodb,main,2023/03/27,76,37,26,2,0,141
pachyderm/go-build,2.0.0-alpha.20,2021/06/01,687,433,397,62,9,1588
mattermost/rtcd,v0.12.0,2023/11/09,null
balenalib/qemux86-64-python,20231106,2023/11/06,114,21,29,4,0,168
bitnami/postgrest,11.2.2,2023/11/02,79,13,11,2,0,105
balenalib/artik710-node,20230904,2023/09/09,118,38,41,6,0,203
bitnami/harbor-notary-server,2.8.4,2023/09/15,83,177,229,2,0,491
balenalib/bananapi-m1-plus-debian-node,20230904,2023/09/09,118,38,41,6,0,203
balenalib/up-board-alpine-python,20231106,2023/11/07,0,1,4,0,0,5
grafana/cortex-tools,v0.11.0,2023/09/08,0,3,3,0,0,6
grafana/mt-gateway,v1.1,2021/01/14,4,14,9,3,0,30
onlyoffice/docspace-socket,1.1.4.1,2023/10/23,1004,158,218,18,0,1398
kasmweb/debian-bookworm-desktop,1.14.0,2023/09/14,653,300,256,52,4,1265
airbyte/source-zoom,0.1.1,2022/12/02,0,17,27,1,0,45
onlyoffice/gdrive-auth,1.0.0-rc15,2023/09/18,0,4,7,0,0,11
bitnami/redmine,5.1.0,2023/11/06,275,179,103,4,2,563
rancher/mirrored-coreos-etcd,v3.5.9,2023/05/11,0,9,9,0,0,18
bitnami/magento,2.4.6,2023/10/11,149,235,178,25,2,589
intel/intel-optimized-wordpress,src,2023/03/10,71,24,20,2,0,117
airbyte/destination-bigquery,2.3.15,2023/11/14,3,42,58,17,0,120
balenalib/artik530-alpine-python,20220803,2022/08/04,7,38,37,10,0,92
bitnami/moodle,4.3.0,2023/11/03,163,86,52,4,2,307
mattermost/platform,9.1.1,2023/11/01,108,18,14,1,0,141
airbyte/destination-selectdb,0.1.0,2023/04/05,61,184,133,2,0,380
balenalib/armv7hf-fedora,20221109,2022/12/03,null
onlyoffice/oform-config,1.0.3,2022/01/13,0,19,21,11,0,51
balenalib/aarch64-debian-openjdk,20231106,2023/11/07,118,43,25,4,0,190
astronomerinc/ap-awsesproxy,1.5.0-3,2023/11/09,0,0,3,0,0,3
rancher/helm-controller,v0.15.4,2023/08/16,0,2,5,0,0,7
grafana/cortex-cortex,v1.1.0-grafana-2,2020/06/08,2,15,18,0,0,35
airbyte/source-zoho-crm,0.1.2,2023/03/19,77,33,27,2,0,139
nginxinc/ingress-demo,latest-unprivileged,2021/01/10,165,163,165,47,7,547
balenalib/ts4900-alpine-node,20220714,2022/07/19,7,38,36,10,0,91
formio/formio-upload,1.0.0,2018/11/03,1,11,12,7,0,31
airbyte/metrics-reporter,0.50.34,2023/11/09,4,69,54,0,0,127
sysdig/orchestrator-agent,3.0.1-dev-ossl-debug,2022/08/19,79,93,24,0,0,196
vmware/pmd-toolchain-photon2,1.0.0,2018/07/22,45,322,376,140,0,883
balenalib/colibri-imx6dl-fedora-openjdk,30-20210825,2021/09/03,null
ubuntu/alertmanager,0.25.0-22.04,2023/10/05,22,13,4,0,0,39
redislabs/redisinsight,1.14.0,2023/05/02,80,64,45,5,0,194
rancher/system-upgrade-controller,v0.13.1,2023/08/28,0,2,1,0,0,3
grafana/cortex-test-exporter,v1.1.0-grafana-2,2020/06/08,0,6,9,0,0,15
pingidentity/pingone-ldap-gateway,3.0.1,2023/11/01,10,26,24,6,0,66
balenalib/artik10-fedora-python,20220714,2022/07/23,0,1,1,0,0,2
mirantis/ucp-hrm,2.2.22,2019/10/07,4,11,20,1,0,36
rancher/vm-fedora,27-1.6.x86_64,2018/04/11,null
balenalib/bananapi-m1-plus-fedora,20221210,2022/12/12,null
vmware/vs-image-manager,v0.0.1,2017/11/28,15,81,98,70,0,264
hashicorp/waypoint,0.11.4,2023/08/09,1,46,32,1,0,80
onlyoffice/4testing-appserver-webhooks-wervice,test-2022062807,2022/06/28,372,848,49,0,0,1269
amazon/aws-alb-ingress-controller,v2.4.5,2022/11/09,0,3,9,0,0,12
balenalib/artik5-fedora-node,36-build-20220803,2022/08/04,0,1,1,0,0,2
airbyte/airbyte-e2e-testing-tool,0.4.3,2022/09/30,76,71,61,17,0,225
onlyoffice/4testing-documentserver,99.99.99.2737,2021/12/03,438,1347,68,0,0,1853
couchbase/ubuntu-1404-sdk-build,20180806,2018/08/08,309,385,40,8,0,742
pingidentity/pingauthorize,2310,2023/11/01,3,14,9,0,0,26
vmware/kafka-slo-exporter,v1.1.0,2023/05/29,0,2,1,0,0,3
rancher/mirrored-longhornio-longhorn-share-manager,v1.5.1,2023/07/19,6,22,21,0,7,56
circleci/postgres-upgrade,9.4-to-9.5,2017/10/26,59,172,150,64,27,472
astronomerinc/ap-elasticsearch-exporter,1.6.0,2023/06/30,0,2,1,0,0,3
balenalib/amd64-python,20231106,2023/11/06,107,21,23,4,0,155
intel/intel-fpga-admissionwebhook,0.28.0,2023/09/22,null
bitnami/tensorflow-resnet,2.14.0,2023/11/16,318,26,15,4,0,363
portainer/open-amt-cloud-toolkit-postgres,v2.1.0,2022/02/03,116,63,66,26,0,271
rancher/harvester-seeder,v0.1.0,2023/08/29,4,5,13,0,5,27
rancher/longhornio-backing-image-manager,v3_20220808-s390x,2022/08/08,7,65,51,3,11,137
okteto/result,1,2020/02/19,35,39,65,13,7,159
kasmweb/blender,1.14.0,2023/09/14,187,388,2,0,0,577
balenalib/spacely-tx2-python,20231106,2023/11/07,114,21,29,4,0,168
objectscale/csi-baremetal-node-kernel-5.4,0.69.0,2021/03/07,121,250,32,0,0,403
newrelic/c-daemon,1.3.0,2020/01/08,2,10,9,1,0,22
balenalib/stem-x86-32-alpine,20230530,2023/06/29,2,6,6,2,0,16
onlyoffice/docspace-files,1.1.4.1,2023/10/23,1016,143,210,12,0,1381
bitnami/supabase-postgres,15.1.0,2023/11/20,102,29,17,4,0,152
ngrok/kubernetes-ingress-controller,0.10.1,2023/10/20,0,1,1,0,0,2
intel/oneapi-basekit,2023.2.1-devel-ubuntu22.04,2023/07/31,183,173,34,0,0,390
balenalib/beaglebone-black-python,20230911,2023/09/12,118,37,40,6,0,201
graphcore/poplar,3.3.0,2023/07/03,131,193,24,0,0,348
kasmweb/libre-office,1.14.0,2023/09/14,195,383,0,0,0,578
intel/fm-worker,evi-2.0.0,2022/10/31,32,18,0,0,0,50
docker/dtr-nginx-s390x,2.5.0-beta3,2018/01/17,0,16,41,34,0,91
bitnami/parse-dashboard,5.2.0,2023/11/16,87,20,16,5,0,128
airbyte/destination-qdrant-preview,dev,2023/08/31,64,24,11,4,0,103
kong/immunity,4.2.0,2021/08/03,604,365,335,43,14,1361
dynatrace/easytravel-loadgen,7.1,2018/05/11,196,244,194,46,14,694
datadog/dd-trace-ci,vegeta,1970/01/01,94,46,58,17,6,221
balenalib/orangepi-plus2-fedora-node,36-build-20230911,2023/09/11,0,1,1,0,0,2
circleci/java,8,2017/05/22,110,316,350,194,30,1000
amazon/aws-glue-libs,glue_libs_4.0.0_image_01,2023/11/15,42,194,295,91,0,622
grafana/grafana-oss-image-tags,10.3.0-146415-ubuntu-arm64,2023/11/15,24,10,0,0,0,34
vmware/lightwave-base-photon2,1.0.1,2018/08/24,37,136,237,67,0,477
grafana/usage-stats-handler,v9,2023/11/08,0,11,43,11,0,65
vmware/vs-openfaas-nodejs6-base,0.0.3-dev1,2017/12/12,15,111,151,85,0,362
adobecoldfusion/coldfusion2018,2018.0.18,2023/07/20,59,102,148,61,0,370
rancher/os-fedoraconsole,v1.5.8,2021/02/05,null
rancher/pipeline-jenkins-slave,v1.0.0,2018/01/11,278,496,32,2,0,808
balenalib/am571x-evm-fedora-python,20220622,2022/07/12,0,1,1,0,0,2
airbyte/source-mixpanel,2.0.0,2023/11/03,64,21,8,1,0,94
hashicorp/consul-terraform-sync,0.7.1,2023/10/30,0,0,4,0,0,4
cockroachdb/cdc-sink,pr-470,2023/09/12,0,2,2,0,0,4
balenalib/up-board-debian-node,20230712,2023/07/16,0,1,1,0,0,2
balenalib/kitra710-ubuntu-node,20230904,2023/09/09,43,11,5,0,0,59
atlassian/dcapt,7.6.0,2023/10/11,707,80,152,3,0,942
airbyte/source-commcare,0.1.0,2023/01/05,77,38,36,3,0,154
airbyte/source-square,1.6.1,2023/11/07,0,13,26,1,0,40
balenalib/zynq-xz702-alpine-openjdk,8-3.14-20220112,2022/01/19,2,50,42,13,0,107
graphcore/tensorflow-jupyter,2,2023/03/31,381,814,59,1,0,1255
balenalib/artik10-python,20220714,2022/07/22,124,69,76,18,0,287
rancher/migration-tools,v0.1.3,2020/01/31,38,27,0,0,0,65
intel/esp-gitea,v3.1.2,2023/07/25,0,5,11,0,0,16
rancher/terraform-operator-appliance,v0.0.5,2019/03/26,null
amazon/aws-efs-csi-driver,6954596,2023/03/01,2,34,11,0,0,47
airbyte/source-tvmaze-schedule,0.1.0,2022/10/27,0,17,27,1,0,45
mattermost/mattermost-build-webapp,v5.2.0,2018/08/07,412,1147,807,214,50,2630
balenalib/imx6ul-var-dart-debian-openjdk,20230911,2023/09/12,129,64,44,6,0,243
grafana/drone-vault,master-011e819,2023/04/14,0,15,15,0,0,30
docker/compose-tests,1.25.2-rc1,2020/01/17,144,362,372,68,10,956
hashicorp/consul-terraform-sync-enterprise,0.7.1-ent,2023/10/31,0,0,4,0,0,4
airbyte/cloud-airbyte-api-server,dev-97763408ca,2023/11/02,6,76,60,0,0,142
grafana/grafana-image-tags,10.3.0-146415-ubuntu-arm64,2023/11/15,24,10,0,0,0,34
mirantis/dtr-garant,3.0.0-alpha.2,2021/09/22,2,25,39,4,0,70
bitnami/dex,2.37.0,2023/11/08,84,18,17,4,0,123
airbyte/source-pendo,0.1.0,2023/03/30,0,16,27,1,0,44
intel/python,py310-full,2023/07/25,33,18,6,0,0,57
airbyte/source-wikipedia-pageviews,0.1.0,2022/11/03,0,17,27,1,0,45
rapidfort/envoy-official,v1.22.11,2023/04/12,null
kasmweb/workspaces,1.14.0,2023/09/18,53,48,27,1,0,129
balenalib/orangepi-plus2-alpine-openjdk,8-20231106,2023/11/07,0,0,4,0,0,4
datadog/operator-bundle,0.7.1,2021/10/22,null
intel/ai-structuring,evi-2.0.0,2022/10/31,32,18,0,0,0,50
hashicorp/consul-template,0.35,2023/11/08,0,1,4,0,0,5
snyk/snyk-container-demo,sha-654f899,2023/03/19,407,1129,788,200,50,2574
kong/ubi-kuma-init,2.4.4,2023/11/06,30,26,8,0,0,64
rancher/longhornio-csi-resizer,v1.2.0,2021/05/05,0,5,9,0,4,18
balenalib/i386-nlp-ubuntu-golang,20200213,2020/02/19,507,699,59,0,0,1265
airbyte/destination-amazon-sqs,0.1.0,2021/12/09,0,21,50,8,0,79
docker/tilt-golang-cross,1.19.3,2022/11/03,610,282,239,30,0,1161
pingidentity/pingauthorizepap,2310,2023/11/01,3,6,5,2,0,16
mattermost/kube-spot-termination-notice-handler,v1.23.4,2023/02/10,817,623,379,28,2,1849
docker/engine-community-dm,18.09.9,2019/09/04,null
balenalib/parallella-fedora-python,20221109,2022/11/16,0,1,0,0,0,1
vertica/verticasdk,ubuntu-v23.4.0,2023/11/06,155,161,3,0,0,319
balenalib/parallella-fedora-golang,20221210,2022/12/13,null
rancher/goharbor-harbor-portal,v1.7.5,2019/04/01,14,67,85,37,0,203
objectscale/fluxd,0.54.0,2020/11/06,2,54,65,6,2,129
newrelic/nri-kubernetes,3.20.0,2023/11/13,0,0,4,0,0,4
bitnami/vault,1.15.2,2023/11/16,84,16,15,4,0,119
google/apigee-diagnostics-runner,1.8.1,2022/09/20,0,0,0,0,4,4
datadog/dogstatsd,7.50.0-rc.2,2023/11/14,0,0,4,0,0,4
okteto/hello-job,golang,2020/08/14,97,42,51,16,6,212
jetbrains/upsource,2020.1.2006,2022/10/28,153,273,567,217,0,1210
bitnami/wordpress-nginx,6.4.1,2023/11/17,148,80,50,4,2,284
portainer/authenticator,develop,2023/06/29,null
balenalib/odroid-c1-golang,20220714,2022/07/28,467,262,214,28,1,972
cockroachdb/sql_efficiency_check,main,2022/06/22,0,1,4,0,0,5
objectscale/pravega,0.71.3,2021/03/30,221,263,264,76,8,832
rancher/mirrored-bats-bats,v1.4.1,2022/04/30,0,12,16,1,0,29
newrelic/kps,0.10.3,2019/09/02,4,14,9,1,0,28
airbyte/destination-heap-analytics,0.1.0,2023/01/04,0,16,27,1,0,44
balenalib/spacely-tx2-alpine-python,20231106,2023/11/06,0,1,4,0,0,5
objectscale/objectscale-gateway,0.71.3,2021/04/14,6,65,65,3,6,145
grafana/integration-grafana-publisher,v10,2023/09/13,7,25,25,7,0,64
rancher/clusterscan-operator,v0.0.1,2020/08/25,2,10,32,4,0,48
okteto/okteto,78462652,2023/03/28,1,31,17,0,0,49
rancher/nginx-ingress-controller-amd64,0.16.2-rancher1,2018/07/18,83,137,218,69,6,513
ubuntu/prometheus-alertmanager,0.23-22.04_edge,2023/02/13,33,30,18,0,0,81
datadog/cluster-agent-dev-amd64,7-27-0-snmp-batch-size-config,2021/04/09,8,26,20,2,0,56
airbyte/source-pypi,0.1.0,2022/11/07,0,17,27,1,0,45
rancher/prom-alertmanager,v0.21.0,2020/06/17,0,12,26,0,0,38
jetbrains/qodana-jvm-android,2023.2,2023/09/06,142,62,84,13,0,301
kasmweb/vs-code,1.14.0,2023/09/14,190,384,0,0,0,574
objectscale/livenessprobe,v2.6.0,2022/02/01,0,4,7,0,0,11
astronomerinc/ap-airflow-operator,0.0.1,2019/02/21,null
balenalib/am571x-evm-debian-golang,20220714,2022/07/28,467,262,214,28,1,972
objectscale/geoservice,0.71.3,2021/04/15,17,149,215,36,6,423
docker/ucp-interlock,3.3.1,2020/06/26,5,22,21,1,0,49
bitnami/dreamfactory-archived,4.12.0,2022/12/21,173,212,120,17,2,524
intel/proxyv2,1.19.0-intel.0,2023/09/27,29,13,6,0,0,48
vmware/notary-photon,signer-0.5.1,2017/11/21,8,60,81,49,0,198
objectscale/storageserver,0.71.3,2021/04/15,11,102,116,9,4,242
intel/pccs,v2.4,2023/10/15,22,9,0,0,0,31
rancher/os-bootstrap,3929481,2017/02/03,null
balenalib/aarch64-fedora-openjdk,8-20231106,2023/11/06,null
bitnami/spring-cloud-dataflow-composed-task-runner,2.11.1,2023/11/15,74,12,14,4,0,104
astronomerinc/ap-prometheus,2.45.1,2023/09/29,0,10,7,0,0,17
mathworks/matlab-deps,R2023b-ubuntu22.04,2023/11/20,43,30,0,0,0,73
rapidfort/python-chromedriver,7c9a7149476b73f54b17a674c2de4836bd252b70,2023/11/19,1479,1336,891,90,39,3835
airbyte/api-server,dev-5842ec8,2022/11/03,60,148,130,0,0,338
datadog/operator,1.3.0-rc.1,2023/11/13,18,10,2,0,0,30
vmware/audit-trail-toolchain,0.2.1,2018/09/26,16,163,183,93,0,455
rancher/opni-insights-service,v0.3.1,2022/03/07,8,86,78,4,14,190
astronomerinc/ap-houston-api,4650,2023/05/15,2,19,7,4,0,32
mirantis/ucp-dsinfo,3.7.1,2023/09/26,32,32,11,0,0,75
cimg/postgres,16.1,2023/11/10,290,319,44,0,0,653
vmware/photon-syslog,8.15.0,2017/10/23,10,81,101,57,0,249
grafana/tempo-vulture,2.3.0,2023/10/30,0,0,4,0,0,4
rancher/aks-operator,v1.2.1-rc1,2023/11/02,0,1,3,0,0,4
adobecoldfusion/pmt2018,2018.0.5,2022/12/02,60,89,62,27,0,238
balenalib/spacely-tx2-alpine,20231106,2023/11/06,0,0,4,0,0,4
airbyte/source-activecampaign,0.1.0,2022/10/27,0,17,27,1,0,45
rancher/goharbor-harbor-jobservice,v1.7.5,2019/04/01,14,63,88,37,0,202
appdynamics/nodejs-agent,23.10.0-20-slim,2023/11/06,55,6,1,1,0,63
bitnami/logstash,8.11.1,2023/11/13,76,39,21,6,0,142
circleci/build-image,ultra-minimal-01,2016/08/16,1535,2016,94,12,0,3657
bitnami/kibana,8.10.4,2023/10/17,96,20,19,6,0,141
datadog/agent-buildimages-windows_2004_x64,v3686353-1e75137,2021/01/12,8,49,134,12,0,203
balenalib/orangepi-plus2-fedora,20221210,2022/12/12,null
balenalib/generic-aarch64-ubuntu-python,20231103,2023/11/06,37,10,0,0,0,47
docker/dev-environments-java,639923ad2c5ce6f29a24ca8d11c8f38f9206c462,2021/06/21,555,289,454,69,13,1380
balenalib/hummingboard-fedora,20221210,2022/12/12,null
hashicorp/vault-secrets-operator,0.3.4,2023/10/20,0,1,0,0,0,1
bitnami/wordpress,6.4.1,2023/11/17,148,80,50,4,2,284
objectscale/targetmgr,3.9.0.0-139102.b4b5064355c,2023/05/03,2,14,11,0,0,27
solace/event-management-agent,1.3.1,2023/11/01,0,0,5,0,0,5
rancher/rio-cert-checker,v0.1.0,2019/05/21,6,20,9,2,0,37
grafana/consent-service,19789620,2020/02/06,2,16,38,4,0,60
mattermost/pgbouncer,v0.7.0,2023/11/10,0,0,3,0,0,3
docker/desktop-git-helper,706820a528d3553e3631118f8113adbce5c5f1db,2023/01/25,3,24,32,17,0,76
bitnami/chartmuseum,0.15.0,2023/05/21,75,67,36,5,0,183
appdynamics/secureapp-otel-java-extension,23.10.0-1153,2023/10/24,0,0,4,0,0,4
mattermost/cloud-blackbox-target-discovery,22696c7,2021/11/24,0,16,24,1,0,41
balenalib/raspberrypi3-ubuntu-openjdk,11-xenial-20231026,2023/11/02,null
airbyte/source-braintree-singer,0.2.3,2021/07/06,112,62,79,30,7,290
balenalib/odroid-xu4-ubuntu,20231026,2023/11/02,37,9,0,0,0,46
accurics/broker,9531878,2020/08/15,6,16,48,6,0,76
balenalib/beaglebone-green-wifi-ubuntu-node,20230911,2023/09/11,43,11,5,0,0,59
puppet/kerminator-build-image,474351,2018/11/09,4,30,50,15,0,99
intel/rpbs_gpu_telegraf,1.0,2022/11/29,39,34,3,0,0,76
intel/intelligent_traffic_management_dashboard_dev,2.0,2022/12/06,62,93,15,0,0,170
intel/evi-fm-worker,master-ae213cd97d6931b1d44fc7689867cf5701e0f15d,2023/09/23,55,10,3,1,0,69
rancher/hardened-flannel,v0.23.0-build20231109-s390x,2023/11/09,0,0,2,0,0,2
newrelic/nri-ecs,1.10.8,2023/10/19,8,28,18,2,0,56
rancher/opensearch,v0.11.0-rc1,2023/07/28,11,53,40,0,0,104
netdata/agent-sd,v0.2.9,2023/08/22,0,1,5,0,0,6
objectscale/object-service,0.71.3,2021/04/15,13,92,104,14,3,226
pachyderm/python-datum-batching-ci,937fe6fa62fc7108984071dce1a3639afe7064c4,2023/08/09,140,79,40,3,0,262
vmware/photon-2.0-flannel,v0.9.1-20180619,2018/06/19,17,84,105,59,0,265
mirantis/rethinkcli,v2.3.0,2016/11/28,55,174,168,65,22,484
bitnami/aspnet-core,7.0.14,2023/11/14,422,76,45,3,0,546
onlyoffice/4testing-documentserver-ee,99.99.99.3631,2023/11/12,123,89,1,1,0,214
sysdig/agent-slim,12.17.1,2023/10/24,85,50,16,0,0,151
grafana/har-to-k6,0.14.5,2023/10/13,55,8,2,2,0,67
balenalib/nitrogen6x-alpine-golang,20220714,2022/07/27,8,39,40,12,0,99
rancher/pause,3.6,2021/08/25,null
onlyoffice/4testing-docspace-studio,2.0.0.33,2023/11/15,1016,142,207,12,0,1377
astronomerinc/ap-nginx-es,3.13.5-4,2021/09/05,2,20,45,6,0,73
percona/proxysql2,2.5.5,2023/11/03,87,45,4,0,0,136
balenalib/kitra520-debian-openjdk,20220714,2022/07/22,157,127,85,18,0,387
adobecoldfusion/coldfusion2023,2023.0.5,2023/10/06,30,29,54,23,0,136
balenalib/odroid-c1-fedora-node,36-build-20220714,2022/07/22,0,1,1,0,0,2
portainer/template-swarm-monitoring,prometheus-v2.44.0,2023/05/24,0,10,7,0,0,17
rancher/mirrored-nginx-ingress-controller-defaultbackend,1.5-rancher1,2018/09/28,null
kumahq/kubectl,v1.20.15,2022/04/22,0,12,10,1,0,23
onlyoffice/communityserver,12.5.2.1848,2023/05/25,249,546,86,1,0,882
okteto/non-root,golang,2020/11/05,696,489,481,63,9,1738
mirantis/ucp-metrics,3.7.1,2023/09/26,2,5,7,2,0,16
intel/oneapi-hpckit,2023.2.1-devel-ubuntu22.04,2023/07/31,183,173,34,0,0,390
hashicorp/tfci,v1.1.1,2023/11/08,0,0,4,0,0,4
percona/proxysql,1.4.16,2020/02/05,38,33,25,5,2,103
vmware/cascade-toolchain,1.11.5-1,2019/02/05,18,176,232,105,0,531
balenalib/stem-x86-32-debian-node,16.19.1-20230904,2023/09/09,118,38,41,6,0,203
airbyte/source-launchdarkly,0.1.0,2022/11/10,0,17,27,1,0,45
rancher/mirrored-neuvector-prometheus-exporter,5.2.3,2023/11/14,0,0,4,0,0,4
airbyte/source-rki-covid,0.1.2,2022/12/05,0,17,27,1,0,45
balena/balena-generate-ami-env,9980750,2022/11/04,61,243,13,0,0,317
grafana/jmeter-to-k6,1.0.0,2020/05/22,9,36,47,8,0,100
vmware/govc,4561966a,2023/03/16,null
redislabs/redis-connect-cassandra,0.5.0-136,2022/01/22,1,31,32,7,0,71
rancher/mirrored-pstauffer-curl,v1.0.3,2018/07/11,0,0,6,18,0,24
onlyoffice/docs-converter-de,7.5.1-1,2023/11/09,0,2,0,0,0,2
cockroachdb/postgres-test,20190103-1358,2019/01/03,190,499,418,149,35,1291
objectscale/srs-notifier,2.0.51,2020/09/29,2,17,44,4,0,67
balenalib/aarch64-fedora-node,20231106,2023/11/06,0,1,1,0,0,2
bitnami/pgpool,4.4.4,2023/10/09,88,16,14,2,0,120
rancher/k8s-dns-kube-dns,1.15.10,2020/03/05,16,17,19,8,1,61
puppet/puppet-dev-tools,0.7,2020/02/25,642,537,512,59,10,1760
docker/mobywebsite,staging,2018/01/03,71,75,130,41,12,329
ddosify/golangtestapp,1.21.3-alpine3.18,2023/10/17,0,0,4,0,0,4
mirantis/dtr-notary-server,3.0.0-alpha.2,2021/09/22,0,6,26,3,0,35
airbyte/source-statuspage,0.1.0,2022/11/11,0,17,27,1,0,45
hashicorp/sentinel,0.23.1,2023/10/19,0,3,6,0,0,9
balenalib/armv7hf-fedora-openjdk,8-20221109,2022/12/05,null
bitnami/fluxcd-helm-controller,0.36.2,2023/11/08,74,15,10,2,0,101
rancher/istio-installer,0.1.7,2020/08/18,17,41,68,8,0,134
balenalib/jetson-tx2-fedora-golang,20231106,2023/11/06,null
redislabs/k8s-controller-internal,100.0.8-2088,2023/11/14,62,16,0,0,0,78
intel/its-query-web,master-ae213cd97d6931b1d44fc7689867cf5701e0f15d,2023/09/23,68,17,5,1,0,91
rancher/mirrored-k8s-dns-node-cache,1.22.20,2023/02/22,23,18,10,0,0,51
mirantis/dtr-nginx,3.0.0-alpha.2,2021/09/22,3,28,45,5,0,81
airbyte/source-smaily,0.1.0,2022/11/09,0,17,27,1,0,45
astronomerinc/ap-kubed,0.13.2,2022/03/25,0,5,10,1,0,16
onlyoffice/4testing-docspace-studio-notify,2.0.0.33,2023/11/15,1016,142,207,12,0,1377
objectscale/object-heads,0.71.3,2021/04/15,13,95,143,24,3,278
bitnami/reportserverenterprise-archived,4.2.0-6068,2022/08/02,97,76,78,17,0,268
greenbone/report-formats,community,2023/11/21,null
balenalib/asus-tinker-board-s-fedora,20221210,2022/12/12,null
okteto/cloudbin,1.10.11,2022/04/05,6,46,57,4,0,113
airbyte/destination-oracle,0.2.0,2023/06/29,65,199,176,17,0,457
pachyderm/cert-manager-cainjector,v0.15.1,2020/05/27,0,0,0,0,6,6
pingidentity/pingaccess,2310,2023/11/01,5,16,10,2,0,33
google/shaka-packager,v2.5.1,2021/06/22,null
balenalib/i386-python,20231106,2023/11/06,107,21,23,4,0,155
google/deepconsensus,1.2.0,2023/03/01,127,89,122,16,0,354
bitnami/minideb,stretch,2022/06/16,31,4,23,2,0,60
circleci/nomad-drainer,1.0.227-4ac789f,2019/12/13,2,10,9,1,0,22
balenalib/qemux86-64-node,20231106,2023/11/06,114,22,30,4,0,170
mirantis/k8s-netchecker-server,v1.2.2,2018/01/02,0,23,10,4,0,37
sysdig/agent,12.17.1,2023/10/24,169,64,16,0,0,249
rancher/longhornio-csi-snapshotter,v3.0.3,2020/12/15,0,6,12,0,5,23
airbyte/source-clockify,0.3.0,2023/08/31,0,15,26,1,0,42
okteto/backend,80907703,2023/02/02,0,12,7,0,0,19
rapidfort/nats-ib,v2.9.21,2023/09/08,0,0,1,0,0,1
balenalib/via-vab820-quad-debian,20220714,2022/07/20,124,68,74,18,0,284
amazon/aws-sam-cli-emulation-image-python3.9,20220125,2022/01/25,1,52,14,0,0,67
rancher/mirrored-flannel-flannel-cni-plugin,v1.2.0,2023/07/21,null
puppet/puppetdb,7.10.0,2022/04/04,83,226,2,0,0,311
rapidfort/slim-init,v1.0,2023/11/02,0,0,4,0,0,4
grafana/rollout-operator-boringcrypto,v0.9.0,2023/11/14,0,0,4,0,0,4
rancher/system-agent,v0.3.4,2023/10/30,1,18,17,1,0,37
balenalib/artik710-golang,20230904,2023/09/09,442,114,73,9,0,638
accurics/siac-bot,1.3.14,2021/06/04,2,15,43,4,0,64
astronomerinc/ap-vector,0.32.2-1,2023/11/06,0,0,3,0,0,3
pachyderm/opencv,2.6.0,2023/04/26,191,374,33,0,0,598
bitnami/reportserver,4.6.1-6098,2023/10/09,75,18,14,2,0,109
bitnami/kubeapps-chart-repo-archived,1.10.0,2020/04/01,null
rancher/os-ubuntuconsole,v1.5.8,2021/02/05,211,443,16,0,0,670
pachyderm/example-no-skip,12,2021/03/29,1450,1334,951,147,39,3921
dynatrace/easytravel-mongodb-content-creator,2.0.0.3599,2023/08/04,145,81,39,2,0,267
jetbrains/datalore-external,2023.5.1,1970/01/01,141,309,61,7,0,518
balenalib/colibri-imx6dl-alpine-golang,20220714,2022/07/27,8,39,40,12,0,99
jetbrains/code-with-me-lobby,1867,2023/01/23,140,60,49,5,3,257
couchbase/elasticsearch-connector,4.4.6,2023/05/17,83,70,10,0,0,163
balena/i386-supervisor,1299,2020/07/31,6,26,55,9,0,96
airbyte/source-rd-station-marketing,0.1.2,2023/07/07,0,15,27,1,0,43
docker/desktop-kine,v1.1,2020/04/15,3,18,39,4,0,64
onlyoffice/docspace-bin-share,1.1.4.1,2023/10/23,0,2,6,0,0,8
balenalib/hummingboard-golang,20230904,2023/09/09,442,111,73,9,0,635
bitnami/alertmanager,0.26.0,2023/11/08,74,16,10,2,0,102
intel/afxdp-plugins-for-kubernetes,23.02,2023/03/15,1,17,7,0,0,25
rancher/mirrored-cilium-startup-script,62bfbe88c17778aad7bef9fa57ff9e2d4a9ba0d8,2020/08/26,1,5,13,2,0,21
bitnami/configurable-http-proxy,4.6.0,2023/10/24,77,15,9,2,0,103
graphcore/popart,3.3.0,2023/07/03,143,194,24,0,0,361
newrelic/k8s-webhook-cert-manager,1.4.0,2021/04/14,0,7,30,5,0,42
grafana/cortex-querier,WIP-diskcache-220510df,2018/08/31,0,0,0,2,0,2
rancher/kubectld,v1.0.0,2017/09/21,354,434,24,0,0,812
intel/evi-ai-structuring,master-ae213cd97d6931b1d44fc7689867cf5701e0f15d,2023/09/23,55,10,3,1,0,69
objectscale/atlas,1.1.3,2021/02/23,2,12,17,0,0,31
rancher/harvester-network-helper,v0.3.5,2023/11/20,1,1,4,0,0,6
objectscale/config-upload,1.2.6,2021/03/05,15,58,78,11,0,162
kumahq/merbridge,0.8.5,2022/11/02,216,464,83,0,0,763
airbyte/source-opsgenie,0.3.0,2023/11/09,0,13,26,1,0,40
rapidfort/postgresql12-ib,12.16,2023/10/20,103,41,2,0,0,146
jetbrains/teamcity-server,2023.05.4,2023/09/19,62,83,40,5,0,190
percona/pmm-server,2.40.1,2023/10/20,8,70,44,0,0,122
rancher/kiwigrid-k8s-sidecar,1.1.0,2020/10/13,2,24,48,12,0,86
intel/dlstreamer-pipeline-server-k8s-controller,2022.2.0,2022/10/22,77,40,40,3,0,160
rancher/rio-controller,v0.8.0,2020/10/12,2,8,4,0,0,14
airbyte/source-recurly,0.4.1,2022/08/11,0,18,27,1,0,46
adobecoldfusion/apimanager2018,2018.0.1,2021/12/17,109,246,100,40,0,495
rancher/containerd,v1.3.6-k3s2,2020/08/27,258,400,18,3,0,679
circleci/postgres-script-enhance,0.1,2021/12/07,47,17,46,8,3,121
jetbrains/hub,2023.2.20300,2023/11/02,76,50,37,10,0,173
onlyoffice/4testing-docspace-router,2.0.0.33,2023/11/15,102,140,2,0,0,244
rancher/rke2-runtime,v1.28.3-rke2r2-windows-amd64,2023/11/08,0,27,28,0,0,55
rapidfort/fluentd-official,v1.14.0-1.0,2023/06/16,1,2,0,0,0,3
bellsoft/alpaquita-linux-python,3.11-stream-musl,2023/11/17,null
bitnami/bitnami-shell,11,2023/07/15,86,28,24,6,0,144
rancher/network-diagnostics,v0.1.2,2017/07/19,310,388,24,0,0,722
bellsoft/buildpacks.executable-jar,6.6.1,1980/01/01,null
airbyte/source-merge,0.1.0,2023/05/01,0,16,27,1,0,44
couchbase/centos-70-sdk-build,20180808,2018/08/08,1768,2759,358,8,1,4894
okteto/dotnetcore,6,2023/08/24,105,41,65,9,0,220
vertica/verticapy-jupyterlab,v0.1.5,2023/08/04,1128,405,283,30,2,1848
okteto/vote,1.3,2019/02/24,5,22,22,4,0,53
rapidfort/apache2-ib,2.4.53,2023/11/22,7,9,0,0,0,16
airbyte/source-stripe-abprotocol-singer,0.1.3,2020/10/20,147,113,163,35,7,465
amazon/aws-sam-cli-emulation-image-ruby2.7,20220125,2022/01/25,1,50,15,1,0,67
rancher/mirrored-epinio-epinio-unpacker,v1.10.0,2023/09/25,0,1,4,0,1,6
balenalib/zynq-xz702-debian-node,18.6-20220714,2022/07/21,124,70,75,18,0,287
docker/ucp-proxy,1.1.6,2017/01/18,0,42,21,8,0,71
airbyte/source-braintree,0.2.1,2023/11/08,64,7,4,1,0,76
hashicorp/jsii-terraform,0.19.1,2023/11/21,765,244,223,18,0,1250
bitnami/rails,7.1.2,2023/11/11,188,71,49,5,0,313
airbyte/cloud-temporal-migrator,0.39.27-alpha-2865c30,2022/06/29,79,83,61,18,0,241
balenalib/orbitty-tx2-fedora,20231106,2023/11/06,null
okteto/init-syncthing,0.4.1,2019/01/27,null
mirantis/ucp-kube-compose-api,3.5.3,2019/11/07,4,14,9,1,0,28
grafana/drone-downstream,linux-amd64,2023/10/04,0,4,4,0,0,8
astronomerinc/ap-orbit-ui,0.11.0,2020/01/19,12,105,97,32,0,246
objectscale/install-controller,2.0.52,2020/10/14,14,38,53,6,0,111
docker/disk-usage-extension,0.2.8,2023/08/31,null
syncfusion/word-processor-server,23.1.36,2023/09/15,73,20,21,4,0,118
pachyderm/kubeflow-worker,v13,2018/03/28,0,0,1,0,0,1
appdynamics/zfi-sample-app,demo,2018/11/14,743,705,84,3,0,1535
balenalib/up-board-fedora-golang,20231103,2023/11/04,null
balenalib/artik710-fedora-golang,20230530,2023/06/07,null
rancher/ansible-runner,v0.0.1,2016/07/29,1393,2193,236,7,0,3829
airbyte/source-dynamodb,0.1.2,2023/02/23,61,180,133,2,0,376
amazon/aws-fsx-csi-driver,v0.9.0,2022/11/25,13,130,191,0,0,334
rancher/longhorn-manager,5948788,2018/08/09,207,432,15,0,0,654
rancher/mirrored-longhornio-csi-provisioner,v3.4.1,2023/04/05,0,3,3,0,0,6
vmware/lightwave-proxy-toolchain,2.0.0,2018/02/21,18,213,270,117,0,618
objectscale/ecs-flex-graphql-debug,0.54.0,2020/11/10,4,18,20,1,0,43
balenalib/odroid-xu4-alpine-golang,20231106,2023/11/07,0,0,4,0,0,4
balenalib/via-vab820-quad-debian-python,20220604,2022/06/12,124,81,76,20,0,301
balena/armv7hf-supervisor,1299,2020/07/31,6,26,55,9,0,96
vmware/wavefront-adapter-for-istio,0.1.5,2020/09/02,14,49,60,25,0,148
balenalib/odroid-c1-debian-golang,20220714,2022/07/28,467,262,214,28,1,972
couchbase/cloud-native-gateway,0.1.0,2023/08/05,0,3,3,0,0,6
greenbone/openvas-scanner,22.7.6,2023/10/11,109,41,31,4,0,185
balenalib/artik710-alpine-python,20230803,2023/08/04,2,7,5,2,0,16
rapidfort/airflow-scheduler,2.7.1,2023/11/17,38,17,6,1,0,62
balenalib/raspberrypi3-alpine-openjdk,8-20231106,2023/11/07,0,0,4,0,0,4
cimg/rust,1.73.0,2023/10/05,294,325,48,0,0,667
amazon/aws-xray-daemon,3.3.9,2023/10/31,2,48,29,0,0,79
bitnami/supabase-postgres-meta,0.74.3,2023/11/16,77,14,9,2,0,102
grafana/cortex-ingester,w37-0193e7b7,2018/09/11,0,0,0,2,0,2
hashicorp/consul-telemetry-collector,0.0.2,2023/09/19,0,3,8,0,0,11
cimg/cimg-orb,2023.09.1,2023/09/28,294,340,51,0,0,685
mathworks/matlab-runtime-deps,R2023b-ubuntu22.04,2023/11/20,44,56,0,0,0,100
airbyte/source-outbrain-amplify,0.1.2,2023/08/18,0,13,18,0,0,31
balenalib/asus-tinker-board-node,20230904,2023/09/09,118,38,41,6,0,203
airbyte/python-connector-base,1.2.0,2023/10/30,129,37,13,1,0,180
balenalib/parallella-fedora,20221210,2022/12/12,null
cimg/mysql,8.0.33,2023/08/14,294,325,48,0,0,667
datadog/datadog-agent-runner-circle,1.11.5,2019/02/05,201,480,527,98,15,1321
rapidfort/prometheus-ib,v2.44.0,2023/11/17,21,15,6,0,0,42
bitnami/apisix-dashboard,3.0.1,2023/11/13,74,16,10,2,0,102
ubuntu/telegraf,1.21-22.04_edge,2022/04/18,48,50,5,0,0,103
airbyte/source-gitlab,2.0.0,2023/10/26,64,21,8,1,0,94
okteto/github-runner,2.273.0,2020/09/10,190,147,249,47,9,642
airbyte/source-monday,1.1.3,2023/10/04,0,14,26,1,0,41
kasmweb/ubuntu-bionic-dind-rootless,develop-rolling,2022/03/18,272,879,25,0,0,1176
rancher/mirrored-coreos-prometheus-config-reloader,v0.40.0,2020/06/18,0,1,0,0,0,1
adobecoldfusion/fortuna,beta,2023/03/07,59,64,88,49,0,260
vmware/clair-db,9.6.3,2017/07/19,11,93,139,51,0,294
balenalib/qemux86-64-ubuntu,20230911,2023/09/11,42,10,4,0,0,56
balenalib/beaglebone-green-fedora-golang,20220523,2022/06/05,null
newrelic/tfd-kps,1.0.0,2019/07/19,4,14,9,3,0,30
rancher/mirrored-istio-kubectl,1.5.9,2020/08/07,405,1076,128,0,0,1609
onlyoffice/4testing-docspace-urlshortener,test-2022112110,2022/11/21,1021,303,330,26,0,1680
rancher/mirrored-cilium-operator-generic,v1.14.4,2023/11/13,0,1,0,0,0,1
bitnami/pgbouncer,1.21.0,2023/11/06,95,19,10,2,0,126
sysdig/kube-psp-advisor,1.8.0,2020/05/20,2,10,27,4,0,43
mirantis/ucp-swarm,3.7.1,2023/09/26,3,3,6,2,0,14
docker/ssd,bump_18.09,2019/01/28,192,424,433,74,12,1135
bitnami/harbor-clair-archived,2.5.1,2022/06/10,139,116,71,19,0,345
onlyoffice/4testing-appserver-clear-events,test-2022081607,2022/08/16,1037,333,357,24,1,1752
balenalib/asus-tinker-board-openjdk,20230904,2023/09/09,129,64,44,6,0,243
bitnami/fluxcd-image-automation-controller,0.36.1,2023/11/21,74,13,9,2,0,98
ubuntu/cortex,1.11-22.04_edge,2023/01/16,45,61,30,0,0,136
balenalib/artik530-fedora-golang,20220714,2022/07/23,null
rancher/coreos-etcd,v3.2.24,2018/07/24,0,2,2,2,0,6
docker/buildkit-syft-scanner,1.2,2023/04/18,0,5,3,0,0,8
airbyte/source-exchangeratesapi-singer,0.2.2,2021/04/03,112,62,79,30,7,290
kasmweb/core-cuda-focal,1.14.0,2023/09/09,256,517,15,0,0,788
objectscale/control-service,0.71.3,2021/04/15,17,149,215,36,6,423
rancher/mirrored-longhornio-support-bundle-kit,v0.0.27,2023/08/22,4,7,13,0,1,25
graphcore/pytorch-paperspace-early-access,3.3.0-EA.1-ubuntu-20.04-20230504,2023/05/04,264,470,36,0,0,770
mirantis/virtlet-build,v1-2759075286cbf6a20ac746a342b61c11,2018/05/24,547,832,57,0,0,1436
balenalib/odroid-c1-node,18.6-20220714,2022/07/21,124,70,75,18,0,287
airbyte/source-alpha-vantage,0.1.1,2023/01/05,0,16,27,1,0,44
balenalib/revpi-core-3-ubuntu-python,20231026,2023/11/02,37,10,0,0,0,47
objectscale/secondary-scheduler-operator,1.4.0-124.541af8d,2023/11/13,639,676,83,4,0,1402
google/deepvariant,1.6.0,2023/10/23,121,170,7,0,0,298
amazon/amazon-ec2-metadata-mock,v1.9.2,2021/08/26,0,1,2,0,0,3
sysdig/sysdig-inspect,0.7.3.20230622.151714-dev,2023/06/22,665,499,479,62,7,1712
okteto/vote-queue,0.1,2019/02/26,1,16,13,4,0,34
rancher/mirrored-calico-cni,v3.26.3,2023/10/06,0,11,6,0,0,17
balenalib/imx6ul-var-dart-fedora-node,36-build-20230530,2023/06/29,0,1,1,0,0,2
balenalib/i386-alpine-python,3.8.10-3.13-20210506,2021/06/15,6,42,57,15,0,120
rancher/mirrored-thanosio-thanos,v0.21.1,2021/06/04,0,8,11,0,0,19
puppet/ezbake,2.2.1,2020/08/21,1089,1668,128,4,0,2889
appdynamics/cluster-agent-operator,23.9.0-552,2023/09/20,0,2,5,0,0,7
tenable/cns-onprem-scanner,2.5.9,2022/12/06,8,108,144,14,0,274
airbyte/source-visma-economic,0.2.0,2023/10/20,0,13,26,1,0,40
hashicorp/dashboard-service,0.0.4,2019/01/24,0,0,0,2,0,2
bitnami/kubeapps-pinniped-proxy,2.9.0,2023/10/26,74,12,8,2,0,96
mirantis/ucp-metallb-speaker,3.7.1,2023/09/26,0,4,6,0,0,10
objectscale/k8s-kubectl,2.70.0,2020/05/21,2,10,27,4,0,43
circleci/mysql,8.0.28,2022/02/22,145,71,78,22,6,322
balenalib/zynq-xz702-ubuntu,20220714,2022/08/02,87,82,11,0,0,180
rancher/mirrored-epinio-epinio-ui,v1.10.0-0.0.1-s390x,2023/09/07,0,3,9,1,0,13
onlyoffice/dropbox-gateway,1.0.0-rc7,2023/09/04,0,4,8,0,0,12
balenalib/artik5-fedora-golang,20220714,2022/07/23,null
intel/nginx,v2.4,2023/10/15,32,18,0,0,0,50
balenalib/raspberry-pi2-golang,20230911,2023/09/12,379,57,48,8,0,492
rancher/vm-novnc,v0.2.0,2018/12/21,123,215,12,0,0,350
airbyte/source-n8n,0.1.0,2022/11/08,0,17,27,1,0,45
rancher/mirrored-istio-node-agent-k8s,1.5.9,2020/08/07,405,1084,143,0,0,1632
vmware/resource-checker-codebuild,1.0,2019/01/30,18,231,277,120,0,646
qualys/qiac_security_cli,2.1.1,2023/11/01,3,4,3,0,0,10
airbyte/source-mongodb-strict-encrypt,0.2.5,2023/07/27,61,172,132,2,0,367
rancher/vault-volume-driver,v0.0.6,2017/12/13,58,97,13,0,0,168
vmware/vs-function-manager,v0.0.1,2017/11/28,15,81,98,70,0,264
appdynamics/zfi-service,demo,2018/11/14,15,87,194,109,0,405
balenalib/beaglebone-green-wifi-ubuntu-openjdk,11-xenial-20230911,2023/09/11,null
rancher/goharbor-registry-photon,v2.6.2-v1.7.5,2019/04/01,14,63,88,37,0,202
grafana/loki-build-image,0.32.0,2023/11/06,546,159,160,15,0,880
appdynamics/customer-support-images,java-nonroot-65532,2022/04/26,2,30,31,1,0,64
vmware/vcsim,4561966a,2023/03/16,null
rancher/container-crontab,v0.5.0,2018/03/08,0,10,2,0,0,12
airbyte/keycloak,0.50.34,2023/11/09,17,34,7,0,0,58
kasmweb/ubuntu-bionic-desktop,1.10.0,2021/11/16,341,1184,26,0,0,1551
rancher/mirrored-cilium-clustermesh-apiserver,v1.14.4,2023/11/13,null
grafana/k6-httpbin,v0.8.4,2023/08/18,1,5,9,3,0,18
amazon/aws-sam-cli-emulation-image-dotnetcore2.1,20220125,2022/01/25,1,160,81,1,0,243
rancher/mirrored-sig-storage-csi-resizer,v1.9.2,2023/11/09,null
intel/esp-web,v3.1.2,2023/07/25,null
airbyte/integration-singer-csv-destination,0.1.1,2020/10/07,111,77,87,30,7,312
balenalib/colibri-imx6dl-golang,20220714,2022/07/28,467,262,214,28,1,972
balenalib/artik530-node,20220714,2022/07/20,124,70,75,18,0,287
balenalib/kitra710-ubuntu-openjdk,11-xenial-20230904,2023/09/09,null
balenalib/kitra710-ubuntu,20230904,2023/09/09,42,10,4,0,0,56
newrelic/nri-statsd,2.8.0,2023/09/12,0,2,5,0,0,7
balenalib/qemux86-64-debian-node,20231106,2023/11/06,114,22,30,4,0,170
kong/incubator,gateway-wasmtime-3.0.0.0,2022/09/23,138,295,39,0,0,472
cimg/elixir,1.15.4,2023/08/28,231,299,30,0,0,560
pachyderm/pachdclustermetrics,1.08,2021/07/08,1438,1268,868,88,39,3701
balenalib/asus-tinker-board-ubuntu-golang,20231026,2023/11/02,133,131,0,0,0,264
bitnami/kubeapps-dashboard,2.9.0,2023/10/26,84,14,15,4,0,117
redhat/ubi9-minimal,9.3-1361,2023/11/01,18,10,2,0,0,30
bitnami/postgresql,16.1.0,2023/11/20,96,19,11,2,0,128
mattermost/ponos,v0.0.3,2022/07/08,1,10,16,3,0,30
mattermost/mattermost-push-proxy-amd64,5.26.0,2023/11/01,0,2,4,0,0,6
airbyte/destination-doris,0.1.0,2022/11/14,60,182,144,2,0,388
balenalib/raspberrypi3-node,20230530,2023/07/02,118,38,41,6,0,203
airbyte/source-toggl,0.1.0,2022/11/10,0,17,27,1,0,45
bitnami/phabricator-archived,2021.26.0,2021/09/29,372,322,209,43,14,960
kasmweb/core-debian-bullseye,1.14.0,2023/09/09,895,237,273,25,0,1430
onlyoffice/elasticsearch,7.16.3,2022/07/05,211,429,36,0,0,676
rancher/hardened-cni-plugins,v1.2.0-build20231009-s390x,2023/10/10,2,2,8,0,2,14
intel/fm-master,evi-2.0.0,2022/10/31,32,18,0,0,0,50
docker/dtr-jobrunner,2.8.1,2020/06/17,7,73,99,18,1,198
balenalib/artik533s-fedora-python,20220714,2022/07/23,0,1,1,0,0,2
jetbrains/datalore-connection-checker,2022.1.4,1970/01/01,123,434,29,0,0,586
balenalib/generic-armv7ahf-ubuntu-openjdk,11-xenial-20230904,2023/09/09,null
rancher/harvester-vm-import-controller,v0.1.6,2023/11/17,0,0,2,0,0,2
datadog/extendeddaemonset-check,0.5.0-rc.1,2020/12/24,106,222,33,1,0,362
pachyderm/example-rabbitmq-spout,2.1.0-rc.1,2022/02/15,0,4,14,1,0,19
bitnami/dotnet-sdk,7.0.404,2023/11/14,428,84,52,6,0,570
graphcore/pytorch-geometric,3.3.0,2023/07/03,146,196,27,0,0,369
airbyte/source-fauna,0.1.1,2022/12/14,0,16,28,1,0,45
docker/artifactory-agent,v1.0.45,2023/10/02,0,4,7,0,0,11
balenalib/hummingboard-ubuntu-golang,20230904,2023/09/09,141,146,23,0,0,310
qualys/qagent-rhcos,4.2.1-5,2023/08/24,10,22,22,0,0,54
percona/percona-server-mysql-operator,0.6.0,2023/09/04,32,40,12,0,0,84
okteto/kubelet-reconfig,1.0.2,2023/08/03,0,6,4,3,0,13
astronomerinc/ap-git-sync-relay,0.0.2-1,2023/06/12,1,6,7,4,0,18
rancher/drone-exporter,v0.0.2-amd64,2020/05/06,2,14,36,4,0,56
balenalib/generic-armv7ahf,20230904,2023/09/09,118,36,40,6,0,200
appdynamics/ad-air-mock-services,java,2021/01/15,140,133,105,32,0,410
objectscale/event-service,0.71.3,2021/04/15,17,149,215,36,6,423
balenalib/artik530-debian-openjdk,20220714,2022/07/22,157,127,85,18,0,387
objectscale/prometheus,3.9.0.0-1588.729cf194,2023/04/25,5,43,34,0,0,82
rancher/fluentd-geoip,v0.7.0,2020/01/02,145,328,340,44,10,867
astronomerinc/ap-kube-replicator,0.10.0-rc.8,2019/08/16,null
objectscale/dthealth,0.52.0,2020/10/14,0,8,12,0,0,20
onlyoffice/4testing-docspace-login,2.0.0.33,2023/11/15,343,72,58,2,2,477
airbyte/source-fullstory,0.1.0,2023/05/01,0,16,27,1,0,44
vmware/vs-event-driver,v0.0.1,2017/11/28,15,81,98,70,0,264
grafana/wix-toolset-ci,v3,2019/04/11,236,794,759,199,19,2007
newrelic/synthetics-ping-runtime,1.33.0,2023/10/17,43,15,0,0,0,58
cimg/android,2023.11.1,2023/11/06,193,250,33,1,0,477
intel/evi-clustering-archiving,master-ae213cd97d6931b1d44fc7689867cf5701e0f15d,2023/09/23,83,73,95,28,0,279
astronomerinc/ap-default-backend,0.28.21,2023/11/08,0,0,2,0,0,2
balenalib/fincm3-ubuntu-openjdk,11-xenial-20230712,2023/07/18,null
okteto/helm-installer,1.0.12,2021/02/18,102,65,75,22,6,270
okteto/mail,0.3.3,2018/11/19,0,3,11,11,0,25
mirantis/ucp-multus-cni,3.7.1,2023/09/26,55,19,9,1,0,84
atlassian/pipelines-auth-proxy,stg,2020/08/11,2,20,7,5,0,34
intel/test-hello-world-2,1.0.1,2022/02/24,53,25,0,0,0,78
balenalib/raspberry-pi2-fedora-openjdk,8-20221031,2022/11/04,null
balenalib/hummingboard-debian-node,20230904,2023/09/09,118,38,41,6,0,203
vmware/secureclouds-remediation-worker,437-python3.8-alpine3.12,2023/01/12,70,229,176,29,0,504
okteto/tfh,0.1.0,2023/09/28,null
balenalib/via-vab820-quad-ubuntu-node,20220715,2022/07/19,88,104,12,0,0,204
dynatrace/dynatrace-aws-s3-log-forwarder,v0.4.5-x86_64,2023/09/12,0,27,23,0,0,50
onlyoffice/controlpanel,3.5.0.516,2023/04/17,113,157,13,0,0,283
pachyderm/pachyderm_tflite_ex,v1,2019/04/11,350,535,124,7,0,1016
bitnami/influxdb-relay-archived,0.20200717.0,2022/04/20,null
bitnami/zookeeper,3.9.1,2023/11/15,85,17,16,4,0,122
vmware/go-kcl-toolchain,0.1.4,2021/10/22,496,433,343,61,2,1335
mirantis/ucp-interlock,3.7.1,2023/09/26,2,3,7,2,0,14
onlyoffice/docspace-migration-runner,1.1.4.1,2023/10/23,73,40,100,3,0,216
balenalib/artik533s-fedora-node,36-build-20220803,2022/08/04,0,1,1,0,0,2
rapidfort/nginx,1.25.2,2023/10/17,39,5,3,1,0,48
grafana/loki-helm-test,canary-test-9084cc9-WIP,2022/10/04,0,10,10,0,0,20
balenalib/parallella-debian-openjdk,20230904,2023/09/09,129,64,44,6,0,243
balenalib/artik533s-debian-node,20220714,2022/07/20,124,70,75,18,0,287
google/apigee-watcher,1.8.1,2022/09/12,0,3,6,0,0,9
couchbase/mobile-testkit,fix_update-docker-repo-path,2017/06/22,1591,2352,397,16,1,4357
jetbrains/teamcity-agent,2023.05.4,2023/09/19,64,106,107,10,0,287
onlyoffice/docspace-backup-background,1.1.4.1,2023/10/23,1016,143,210,12,0,1381
docker/dev-environments-go,639923ad2c5ce6f29a24ca8d11c8f38f9206c462,2021/06/21,1008,562,664,78,12,2324
bitnami/harbor-exporter,2.9.1,2023/11/08,74,12,8,2,0,96
balenalib/generic-armv7ahf-debian,20230904,2023/09/09,118,36,40,6,0,200
cimg/node,21.1.0,2023/10/26,294,325,48,0,0,667
balenalib/colibri-imx6dl-fedora-python,20220622,2022/07/12,0,1,1,0,0,2
rancher/opni-drain-service,v0.12.1-rc1,2023/11/10,2,10,15,0,7,34
balenalib/artik533s-python,20220714,2022/07/22,124,69,76,18,0,287
bitnami/spring-cloud-dataflow,2.11.1,2023/11/07,74,13,15,4,0,106
rancher/sonobuoy-sonobuoy,v0.19.0,2020/09/15,34,16,45,6,7,108
cockroachdb/kitsune,main,2023/02/13,0,0,1,0,0,1
balenalib/orangepi-plus2-debian,20230911,2023/09/11,118,36,40,6,0,200
airbyte/source-google-workspace-admin-reports,0.1.8,2022/02/24,0,22,52,8,0,82
rancher/os-syslog,v1.5.8,2021/02/05,null
mirantis/ucp-kube-state-metrics,3.7.1,2023/05/31,0,2,1,0,0,3
rancher/jenkins-boot,v0.1.1,2017/12/20,15,170,203,107,0,495
grafana/grafana-docs-dev,arm,2021/05/19,656,1758,162,5,0,2581
okteto/slack-notifier,0.1.1,2019/01/23,11,33,53,9,0,106
intel/hsm-sds-server,1.19.0,2023/09/06,24,17,6,0,0,47
balenalib/amd64-fedora-openjdk,8-20231103,2023/11/04,null
airbyte/source-zenloop,0.1.10,2023/06/29,0,15,27,1,0,43
datadog/trace-paketo-buildpack,1.0.0,1980/01/01,null
airbyte/source-newsdata,0.1.0,2022/11/10,0,17,27,1,0,45
airbyte/source-harvest,0.1.20,2023/10/15,64,21,8,1,0,94
bitnami/grafana-tempo,2.3.0,2023/11/08,74,14,10,2,0,100
apachepinot/zookeeper,3.7.0,2023/02/14,868,369,405,31,0,1673
balenalib/nitrogen6x-node,18.6-20220714,2022/07/21,124,70,75,18,0,287
intel/crypto-reference-stack,1.0,2021/04/14,240,346,45,0,0,631
pachyderm/ide-hub,2.0.0-b4,2021/08/26,472,1139,79,1,0,1691
pachyderm/worker-amd64,97276071e371d5b1ea221437e99cfd87b5599ddf,2023/11/03,1,7,8,0,0,16
docker/ucp-metrics-s390x,3.1.0-beta3,2018/10/04,0,2,6,16,0,24
mattermost/podman,1.8.0,2020/03/10,231,167,243,47,9,697
couchbase/observability-stack,dp2,2022/06/10,17,123,159,13,0,312
okteto/php,8,2023/08/24,240,95,54,9,0,398
rancher/mirrored-minio-mc,RELEASE.2023-06-28T21-54-17Z-s390x,2023/06/29,77,54,10,0,0,141
balenalib/aarch64-ubuntu-node,20231103,2023/11/06,35,10,1,0,0,46
objectscale/supportassist-ese-notifier,2.71.3,2021/04/14,2,18,23,0,0,43
balenalib/generic-armv7ahf-alpine-openjdk,8-20230904,2023/09/09,8,8,8,2,0,26
grafana/drone-grafana-docker,0.3.2,2020/09/29,3,24,46,5,0,78
balenalib/amd64-debian-python,20231106,2023/11/06,107,21,23,4,0,155
jetbrains/datalore-introspection,2022.1.4,1970/01/01,123,434,29,0,0,586
mirantis/ucp-auth-store,3.7.1,2023/09/26,3,6,7,2,0,18
okteto/weaver-sidecar,0.1.10,2023/01/17,66,50,10,0,0,126
rancher/pushprox-proxy,v0.1.0-rancher2-proxy,2021/06/03,0,7,28,4,0,39
balenalib/raspberrypi3-openjdk,20230530,2023/07/04,143,72,46,6,0,267
balenalib/am571x-evm-ubuntu,20220714,2022/08/02,87,82,11,0,0,180
lacework/container-auto-scan-inline,1.1.2,2023/03/28,182,93,91,12,0,378
balenalib/zynq-xz702-alpine-node,20220714,2022/07/19,7,38,36,10,0,91
airbyte/mssql_ssltest,dev,2021/05/12,148,256,14,0,0,418
balenalib/apalis-imx6q-debian-golang,20220714,2022/07/28,467,262,214,28,1,972
vmware/vsan-prometheus-servicediscovery,v20210225,2021/02/26,14,100,109,45,0,268
bitnami/dataplatform-exporter-archived,1.0.1,2022/05/18,0,1,1,0,0,2
amazon/aws-sagemaker-kfp-components,20200402,2020/04/02,44,464,131,11,0,650
balenalib/artik5-openjdk,20220714,2022/07/22,157,127,85,18,0,387
grafana/cortex-query-tee,v1.1.0-grafana-2,2020/06/08,2,16,36,4,0,58
intel/istioctl,1.19.0-intel.0,2023/09/27,29,14,6,0,0,49
balenalib/rpi-alpine-golang,20231026,2023/11/01,0,0,4,0,0,4
rancher/hardened-coredns,v1.7.1,2020/09/25,259,408,32,3,0,702
adobecoldfusion/pmt,latest-2021,2022/12/02,60,89,60,27,0,236
onlyoffice/docspace-router,1.1.4.1,2023/10/23,114,209,10,0,0,333
onlyoffice/docspace-people-server,1.1.4.1,2023/10/23,1016,143,210,12,0,1381
ubuntu/mysql,8.0-22.04_edge,2023/11/20,20,5,0,0,0,25
grafana/grafana-enterprise-arm64v8-linux,7.0.6,2020/07/09,4,30,54,9,0,97
balenalib/raspberrypi3-fedora-python,20221109,2022/12/02,0,1,0,0,0,1
redislabs/redistimeseries,99.99.98,2023/10/08,72,19,17,2,0,110
rancher/rancher-ecr-credentials,v3.0.0,2018/03/08,78,100,15,0,0,193
atlassian/jira-software,9.11.3,2023/11/18,23,22,14,1,0,60
rancher/mirrored-cluster-api-controller,v1.4.4,2023/06/27,0,2,1,0,0,3
balenalib/generic-armv7ahf-ubuntu,20230904,2023/09/09,42,10,4,0,0,56
kasmweb/parrotos-5-desktop,1.14.0,2023/09/14,0,6,6,0,0,12
amazon/aws-for-fluent-bit,2.32.0.20231031,2023/11/03,0,2,0,0,0,2
bellsoft/liberica-openjre-alpine-musl,21.0.1-12,2023/11/14,0,0,4,0,0,4
balenalib/asus-tinker-board-alpine-openjdk,8-20231106,2023/11/07,0,0,4,0,0,4
mirantis/ucp-istio-mixer,3.4.15,2023/05/11,1,12,18,0,6,37
airbyte/source-zoom-singer,0.2.4,2021/07/06,561,319,283,39,7,1209
balenalib/beaglebone-green-wifi-fedora-openjdk,30-20210825,2021/09/03,null
airbyte/source-amazon-ads,3.4.1,2023/10/15,64,21,8,1,0,94
bitnami/envoy,1.28.0,2023/11/15,74,12,8,2,0,96
onlyoffice/documentserver-ucs,7.5.1.1,2023/11/08,116,107,3,1,0,227
mattermost/elrond,9775779,2023/07/06,0,15,15,2,0,32
balenalib/kitra710-golang,20230904,2023/09/09,442,114,73,9,0,638
balenalib/raspberry-pi2-fedora-node,36-build-20230911,2023/09/12,0,1,1,0,0,2
bitnami/opencart,4.0.2-3,2023/10/11,152,83,60,5,2,302
grafana/smtprelay,v1.5.0-0-gd399838,2021/10/05,75,58,47,17,0,197
balenalib/beaglebone-black-fedora-python,20220928,2022/10/04,0,1,1,0,0,2
onlyoffice/4testing-ds-example,6.0.0,2020/10/21,563,567,32,3,0,1165
balenalib/aarch64-alpine,20231106,2023/11/06,0,0,4,0,0,4
bellsoft/buildpacks.alpaquita-build,musl,2023/04/17,null
airbyte/actions-runner,test,2023/08/18,55,34,47,3,0,139
balenalib/colibri-imx6dl-fedora,20220604,2022/06/12,null
rancher/mirrored-calico-apiserver,v3.26.3,2023/10/06,0,2,5,0,0,7
rancher/mirrored-cloud-provider-vsphere-csi-release-driver,v3.1.1,2023/10/24,3,8,11,3,0,25
onlyoffice/telegram-github-changes-bot,v1.0.0-298-g01a9e56,2023/11/09,0,1,4,0,0,5
airbyte/source-tidb,0.3.0,2023/03/16,61,181,131,2,0,375
airbyte/source-salesloft,1.2.0,2023/07/11,0,15,27,1,0,43
bitnami/mariadb-galera,11.1.3,2023/11/15,90,18,16,2,0,126
objectscale/objectscale-health,1.4.0-397.adb0726,2023/11/13,0,3,4,0,0,7
balenalib/generic-armv7ahf-alpine,20230904,2023/09/09,2,0,7,2,0,11
appdynamics/agent-config-client,23.8.0-721,2023/08/24,0,0,4,0,0,4
balenalib/aarch64-golang,20231106,2023/11/07,435,82,52,5,0,574
cockroachdb/builder,20230830-211921,2023/08/30,192,249,15,0,0,456
airbyte/source-copper,0.3.0,2023/08/29,0,15,26,1,0,42
balenalib/apalis-imx6q-ubuntu-openjdk,20210826,2021/09/04,136,435,10,0,0,581
solace/docker-qpid-proton,ubuntu,2018/06/19,648,792,92,0,0,1532
mattermost/pgbouncer-config-reload,v1.1.1,2023/09/28,6,7,12,0,0,25
cockroachdb/acceptance,20221005-223354,2022/10/06,84,347,68,34,0,533
vmware/photon-2.0-k8s-dns-kube-dns-amd64,1.14.10-20180619,2018/06/19,15,72,90,57,0,234
balenalib/beaglebone-black-fedora-openjdk,30-20210825,2021/09/03,null
airbyte/source-confluence,0.2.0,2023/08/18,0,15,26,1,0,42
bitnami/phpmyadmin,5.2.1,2023/10/11,149,84,53,4,2,292
hashicorp/consul-replicate,0.4.0-scratch,2017/08/10,null
kasmweb/remmina,1.14.0,2023/09/14,193,397,0,0,0,590
mattermost/mattermost-push-proxy-arm64,5.26.0,2023/11/01,0,2,4,0,0,6
objectscale/alertmanager,3.7.0.0-1334.45d1715e,2021/09/22,6,58,84,3,5,156
kasmweb/java-dev,1.14.0,2023/09/14,228,524,0,0,0,752
kasmweb/pinta,1.14.0,2023/09/14,215,458,0,0,0,673
balenalib/generic-aarch64-ubuntu-golang,20231103,2023/11/06,139,131,0,0,0,270
sysdig/dockerfile-benchmarker,0.0.1,2020/03/16,2,10,29,4,0,45
mirantis/dtr-trivy-adapter,0.14.0,2020/07/31,10,47,78,15,0,150
okteto/civo-webhook,0.5.3,2023/10/18,0,2,4,0,0,6
newrelic/synthetics-node-api-runtime,1.2.1,2023/11/07,102,144,2,0,0,248
docker/imagefs,0.4.0-alpha,0001/01/01,null
rancher/mirrored-longhornio-longhorn-engine,v1.5.1,2023/07/19,5,33,65,0,7,110
rancher/slackin-extended,v2.1.3,2020/10/22,3,77,71,14,0,165
grafana/oncall,v1.3.58,2023/11/14,8,7,11,0,0,26
rancher/terraform-controller-executor,v0.0.13-alpha1,2020/11/19,11,56,105,14,0,186
appdynamics/dl-proxy,23.10.0,2023/10/31,26,10,0,0,0,36
newrelic/newrelic-fluentbit-output,1.17.3,2023/06/20,28,27,19,1,0,75
balenalib/artik5-fedora-python,20220714,2022/07/23,0,1,1,0,0,2
percona/everest-operator-bundle,0.4,2023/10/31,null
balenalib/intel-nuc-alpine-golang,20231106,2023/11/07,0,0,4,0,0,4
balenalib/via-vab820-quad,20220714,2022/07/20,124,68,74,18,0,284
circleci/picard,1.0.196890-89790297,2023/08/10,0,32,18,0,0,50
adobecoldfusion/coldfusionaddons,latest-2023,2023/05/19,270,430,125,46,0,871
mirantis/dtr-rethink,2.9.14,2023/09/28,2,33,29,2,0,66
airbyte/source-callrail,0.1.0,2022/11/15,0,17,27,1,0,45
balena/amd64-balena-multibuild-scripts,0.1.0,2019/10/01,4,14,9,1,0,28
rancher/harvester-csi-driver,v0.1.6,2023/10/18,1,8,11,0,2,22
newrelic/k8s-nri-mongodb,2.4.1,2020/02/10,2,11,29,4,0,46
vmware/likewise-open-toolchain-photon3,1.0.0,2019/12/04,24,216,233,65,0,538
snyk/kubernetes-scanner,v0.20.3,2023/10/16,null
datadog/extendeddaemonset,v0.9.0-rc.2,2022/09/27,68,74,14,1,0,157
airbyte/source-spacex-api,0.1.1,2023/11/07,0,13,26,1,0,40
hashicorp/waypoint-odr,0.11.4,2023/08/09,1,38,26,0,0,65
docker/dtr-registry,2.8.1,2020/06/17,2,9,8,1,0,20
newrelic/nri-forwarder,1.48.1,2023/11/02,0,2,2,0,0,4
balenalib/armv7hf-debian-golang,20230929,2023/10/02,441,111,74,9,0,635
objectscale/qualification-service-tools,0.69.0,2021/03/15,18,136,158,6,6,324
balenalib/raspberrypi3-alpine,20231106,2023/11/07,0,0,4,0,0,4
cockroachdb/loadgen-kv,0.2,2018/03/08,null
balenalib/up-board-fedora-openjdk,8-20231103,2023/11/04,null
okteto/buildkit-proxy,v0.0.1,2022/11/21,0,3,6,0,0,9
bitnami/appsmith,1.9.44,2023/11/08,87,23,25,4,0,139
balenalib/asus-tinker-board-s-python,20230911,2023/09/12,118,37,40,6,0,201
atlassian/default-image,4.20230906,2023/09/06,171,202,33,0,0,406
grafana/grafana-build,main,2023/11/15,0,7,9,0,0,16
vmware/photon-2.0-k8s-heapster-amd64,1.4.2-20180619,2018/06/19,15,72,90,57,0,234
airbyte/destination-google-sheets,0.2.3,2023/09/25,64,23,8,1,0,96
pachyderm/cert-manager-webhook,v0.15.1,2020/05/27,0,0,0,0,6,6
kong/pulp-api,1.1.38,2022/08/24,4,11,9,4,0,28
balenalib/jetson-tx1-ubuntu-node,20230530,2023/06/26,55,21,5,0,0,81
rancher/helm-locker,v0.0.1,2022/05/11,0,17,10,0,2,29
objectscale/confd-sidecar,3.9.0.0-1588.729cf194,2023/04/25,4,30,24,0,0,58
balenalib/generic-armv7ahf-fedora-node,36-build-20230530,2023/06/29,0,1,1,0,0,2
airbyte/workload-launcher,final-8,2023/11/15,4,74,61,0,0,139
datadog/dd-appsec-php-ci,toolchain,2023/08/23,492,191,124,24,0,831
kasmweb/retroarch,1.14.0,2023/09/14,199,395,0,0,0,594
intel/rpbs_app,1.0,2023/08/21,0,2,3,0,0,5
cockroachdb/cockroach-k8s-init,0.2,2017/05/31,132,246,16,0,0,394
rancher/network-policy-manager,v0.2.8,2018/07/08,306,388,24,0,0,718
onlyoffice/box-callback,1.0.1,2023/09/12,0,5,8,0,0,13
kasmweb/share,1.14.0,2023/09/14,28,10,1,0,0,39
balenalib/fincm3-alpine-golang,20221109,2022/11/25,6,30,30,9,0,75
airbyte/source-polygon-stock-api,0.1.1,2023/02/27,0,16,27,1,0,44
astronomerinc/ap-nats-server,2.10.2-1,2023/11/08,0,0,4,0,0,4
lacework/lacework-admission-controller,0.23.2,2023/11/10,0,2,1,0,0,3
balenalib/artik10,20220714,2022/07/22,124,68,74,18,0,284
airbyte/source-punk-api,0.1.0,2022/11/16,0,17,27,1,0,45
jetbrains/code-with-me-relay,1161,2023/01/23,0,19,18,0,0,37
objectscale/kube-scheduler,v0.26.7,2023/07/25,0,7,10,0,0,17
balenalib/revpi-core-3-fedora-golang,20220523,2022/06/04,null
bitnami/drupal-nginx,10.1.6,2023/11/03,163,82,54,5,2,306
mattermost/mattermost-test-team,9f6859c,2020/03/28,6,44,77,9,0,136
datadog/docker-library,zookeeper_3_4_10,2017/11/09,16,51,40,22,0,129
balenalib/zynq-xz702-ubuntu-openjdk,20210826,2021/09/04,136,435,10,0,0,581
graphcore/simple-server-framework,1.0.0,2023/07/20,167,268,32,0,0,467
airbyte/source-ringcentral,0.1.0,2023/05/18,0,16,27,1,0,44
intel/cri-resmgr-agent,v0.8.4,2023/08/25,0,6,4,0,0,10
couchbase/centos-69-sdk-nodevtoolset-build,20180809,2018/08/09,1623,2007,257,7,0,3894
percona/percona-distribution-postgresql,16,2023/09/13,8,32,82,0,0,122
onlyoffice/docspace-api-system,1.1.4.1,2023/10/23,1016,143,211,12,0,1382
balenalib/zynq-xz702-ubuntu-node,20220715,2022/07/19,88,104,12,0,0,204
pachyderm/pdk,train-9195916,2023/10/03,506,262,75,10,2,855
jetbrains/datalore-database-command,2023.5.1,1970/01/01,67,102,7,0,0,176
balenalib/raspberrypi3-fedora,20221031,2022/11/04,null
objectscale/record-manager,0.71.3,2021/04/15,17,149,215,36,6,423
newrelic/k8s-operator,snapshot,2020/05/29,0,6,11,0,6,23
syncfusion/boldreports,5.3.8,2023/10/26,53,43,20,0,0,116
kong/statsd-exporter-advanced,0.3.1,2020/04/20,null
pachyderm/pachyderm,2.7.0-test.2,0001/01/01,null
airbyte/source-zendesk-talk,0.1.9,2023/08/03,140,81,41,3,0,265
airbyte/destination-pinecone,0.0.20,2023/11/13,64,21,10,4,0,99
rapidfort/couchdb_3-ib,3.3.2,2023/11/22,21,4,2,0,0,27
mattermost/mattermost-prod-db,v5.33.3,2021/03/31,10,26,42,7,0,85
rancher/goharbor-harbor-adminserver,v1.7.5,2019/04/01,14,63,88,37,0,202
objectscale/objectstore-pre-update,0.71.3,2021/03/24,2,17,22,0,0,41
objectscale/ecs-service-broker,2.3.1,2023/04/12,61,34,13,2,0,110
airbyte/source-gitlab-singer,0.1.3,2021/07/06,561,320,282,39,7,1209
airbyte/mirrored-keycloak-amd,21.1,2023/06/28,17,34,7,0,0,58
datadog/agent-dev,7-48-1-usm-extended-http-capturing-py3-jmx,2023/10/15,27,46,17,0,0,90
rancher/pipeline,v0.1.1,2018/01/11,161,285,17,0,0,463
vmware/hcx-helm,3.2,2021/01/07,20,137,170,64,0,391
portainer/portainer-ee,2.19.2,2023/11/12,0,17,13,0,0,30
rancher/harvester-network-controller,v0.3.5,2023/11/20,1,1,4,0,0,6
airbyte/airbyte-workload-api-server,final-0,2023/11/14,4,69,54,0,0,127
airbyte/source-news-api,0.1.1,2023/04/30,0,16,27,1,0,44
dynatrace/dynatrace-configuration-as-code,2.9.2,2023/11/06,0,0,4,0,0,4
balenalib/amd64-ubuntu-node,20230929,2023/10/07,40,11,5,0,0,56
balenalib/artik5-ubuntu-openjdk,20210826,2021/09/21,136,435,10,0,0,581
bitnami/jaeger,1.51.0,2023/11/08,74,12,12,2,0,100
airbyte/destination-bitdotio,0.1.0,2022/10/14,64,201,189,17,0,471
rapidfort/couchdb,3.3.2,2023/11/15,58,12,12,3,0,85
mirantis/gpu-example,cuda-10.2,2020/02/16,153,207,15,0,0,375
snyk/runtime-fixtures,ubuntu,2022/03/14,87,160,4,0,0,251
balenalib/qemux86-64-fedora-python,20231103,2023/11/04,null
rapidfort/nats,2.9.18,2023/06/20,23,6,7,0,0,36
docker/ucp-init-azure,2.1.0,2017/02/09,18,117,93,51,0,279
graphcore/pytorch-minimal-early-access,3.3.0-EA.1-ubuntu-20.04-20230504,2023/05/04,180,281,34,0,0,495
hashicorp/boundary,0.14.2,2023/10/31,0,1,3,0,0,4
astronomerinc/ap-cli-install,0.26.20,2023/11/08,0,0,2,0,0,2
balenalib/amd64-alpine-openjdk,8-20231106,2023/11/07,0,0,4,0,0,4
pachyderm/compile,go1.13.8,2020/02/14,620,875,78,0,0,1573
airbyte/destination-typesense,0.1.1,2023/08/23,0,15,26,1,0,42
balenalib/revpi-core-3-fedora-openjdk,8-20221031,2022/11/04,null
adobecoldfusion/coldfusionaddons2023,2023.0.0,2023/05/19,270,430,125,46,0,871
balenalib/hummingboard-fedora-openjdk,30-20210825,2021/09/03,null
ubuntu/dotnet-deps,7.0_beta,2023/11/01,null
dynatrace/edgeconnect,1.46.0,2023/11/06,12,3,1,0,0,16
redis/redis-stack-server,7.2.0-RC3,2023/07/10,27,17,2,0,0,46
primekey/ejbca-ce,8.0.0,2023/06/29,3,46,32,6,0,87
hashicorp/terraform,1.7.0-alpha20231108,2023/11/08,0,0,4,0,0,4
newrelic/synthetics-minion,3.0.95,2023/11/06,40,19,4,0,0,63
percona/percona-orchestrator,3.2.6-10,2023/09/19,134,29,9,0,0,172
okteto/react-getting-started,dev,2020/05/06,518,1482,1198,250,12,3460
balena/balena-redis,0.0.4,2021/01/06,2,6,32,4,0,44
bitnami/chartmuseum-archived,0.15.0,2023/05/21,75,67,36,5,0,183
rancher/mirrored-bci-busybox,15.4.11.2,2022/09/26,0,3,2,0,2,7
airbyte/source-gridly,0.1.1,2022/12/08,0,14,19,0,0,33
intel/apphsm,v2.4,2023/10/15,37,22,2,0,0,61
okteto/registry,2.7.2-dev2,2021/02/05,0,7,8,3,0,18
rancher/mirrored-longhornio-longhorn-instance-manager,v1.5.1,2023/07/19,4,29,57,0,7,97
airbyte/source-google-pagespeed-insights,0.1.1,2023/05/26,0,15,27,1,0,43
bitnami/ksql,7.5.2,2023/11/09,74,16,12,7,0,109
newrelic/kubernetes-operator,v0.0.8,2021/07/10,0,6,13,0,4,23
balenalib/am571x-evm-alpine-openjdk,8-3.14-20220112,2022/01/19,2,50,42,13,0,107
balenalib/asus-tinker-board-debian-openjdk,20230904,2023/09/09,129,64,44,6,0,243
rancher/longhorn-manager-test,5766348,2018/07/10,650,2164,1783,380,40,5017
portainer/pause,3.9,2023/08/30,null
okteto/wasp,alpha,2021/02/26,434,511,453,93,9,1500
adobecoldfusion/apimanageraddons,latest-2023,2023/05/17,37,26,8,3,0,74
balenalib/spacely-tx2-golang,20231106,2023/11/07,436,82,52,5,0,575
stackhawk/hawkscan,3.4.7,2023/11/10,51,32,5,0,0,88
mirantis/ucp-istio-pilot,3.4.15,2023/05/11,471,1162,150,1,0,1784
google/apigee-deployment-admissionhook,1.1.1,2020/02/05,0,0,0,0,6,6
rancher/storage-secrets-bridge-v2,v0.9.7,2018/07/09,125,218,12,0,0,355
balenalib/artik530-debian-golang,20220714,2022/07/22,467,265,220,28,1,981
airbyte/source-surveymonkey,0.2.3,2023/10/15,64,21,8,1,0,94
nginxinc/nginx-unprivileged,1.25.3,2023/11/20,81,20,7,1,2,111
kasmweb/nginx,1.25.1,2023/06/16,2,9,9,2,0,22
okteto/test,2,2022/04/20,113,123,80,23,0,339
atlassian/fisheye,4.8.13,2023/10/27,160,190,26,6,0,382
airbyte/destination-mqtt,0.1.3,2022/09/07,76,75,64,19,0,234
balenalib/artik710-alpine,20230904,2023/09/09,2,0,7,2,0,11
balenalib/raspberrypi3-python,20230530,2023/06/27,118,37,40,6,0,201
airbyte/source-nytimes,0.1.1,2023/03/02,0,16,27,1,0,44
airbyte/source-pagerduty,0.2.0,2023/10/23,0,13,26,1,0,40
onlyoffice/4testing-docspace-api,2.0.0.33,2023/11/15,1016,142,207,12,0,1377
kong/fpm,0.8.1,2023/03/01,809,523,333,23,2,1690
balenalib/asus-tinker-board-ubuntu-python,20231026,2023/11/02,37,10,0,0,0,47
balenalib/beaglebone-green-node,20230911,2023/09/11,118,38,41,6,0,203
rancher/machine,v0.15.0-rancher106-s390x,2023/10/04,3,6,12,0,2,23
intel/intel-optimized-mysql,src,2023/02/11,210,314,50,0,0,574
cockroachdb/acceptance-gss-psql,20230920-104814,2023/09/20,117,37,21,3,0,178
docker/containerd-shim-process,6244e3d,2018/08/10,null
onlyoffice/docspace-proxy,1.1.1.1,2023/07/27,167,40,37,3,4,251
vertica/vertica-k8s,23.4.0-0,2023/09/21,66,139,19,0,0,224
hashicorp/vault-enterprise-fips,1.15.2-ent.fips1402,2023/11/07,71,16,0,0,0,87
docker/ucp-pause,3.3.1,2020/02/04,null
airbyte/source-yahoo-finance-price,0.2.0,2023/08/22,0,15,26,1,0,42
rapidfort/keycloak-official,22.0.5-0,2023/10/24,0,1,0,0,0,1
docker/ucp-hyperkube,3.3.1,2020/06/26,6,23,24,1,0,54
kong/kong-gateway,3.5.0.0,2023/11/07,22,4,0,0,0,26
docker/ucp-containerd-shim-process,3.3.1,2019/12/16,null
pingidentity/ldap-sdk-tools,2310,2023/11/01,0,2,1,0,0,3
calcom/cal.com,v3.4.7,2023/11/07,483,266,68,9,2,828
rancher/rpardini-docker-registry-proxy,0.6.1,2020/12/02,3,13,38,5,0,59
rancher/hardened-cilium-llvm,4c18d06f1d545ed6fde810c2b97935dc8938ddc8-build20210521,2021/05/21,544,491,32,3,0,1070
docker/ucp-kube-dns-sidecar,3.2.7,2020/06/26,0,0,0,2,0,2
balenalib/artik533s-debian-openjdk,20220714,2022/07/22,157,127,85,18,0,387
onlyoffice/4testing-docspace-socket,2.0.0.33,2023/11/15,343,74,58,2,2,479
mattermost/sync-helpwanted-tickets,1.1.2,2023/07/26,520,291,114,17,6,948
balenalib/artik533s-ubuntu,20220714,2022/08/02,87,82,11,0,0,180
grafana/pentagon,62,2022/01/25,0,21,33,1,0,55
redhat/ubi8-init,8.8-15,2023/09/13,154,38,6,0,0,198
balenalib/amd64-golang,20231106,2023/11/06,435,83,52,5,0,575
pachyderm/ubuntu_with_s3_clients,0.1,2021/05/02,487,618,58,0,0,1163
graphcore/pytorch-geometric-paperspace,3.3.0,2023/07/03,220,346,28,0,0,594
airbyte/source-oura,0.1.0,2022/10/28,0,17,27,1,0,45
airbyte/source-microsoft-dataverse,0.1.2,2023/08/25,0,13,18,0,0,31
balenalib/artik5-ubuntu-python,20220715,2022/08/02,87,83,13,0,0,183
balenalib/am571x-evm-alpine-python,20220714,2022/07/19,7,38,37,10,0,92
datadog/agent-buildimages-rpm_arm64,v20433308-6861270,2023/09/25,33,177,115,0,0,325
bitnami/rabbitmq-cluster-operator,2.5.0,2023/11/09,0,1,1,0,0,2
ubuntu/kafka,3.1-22.04_edge,2023/07/06,33,39,11,5,0,88
dynatrace/dynatrace-oneagent,1.277.165.20231024-150054,2023/10/25,7,2,0,0,0,9
redislabs/gesher,0.6,2022/01/05,0,4,11,1,0,16
balenalib/spacely-tx2-node,20231106,2023/11/07,114,22,30,4,0,170
airbyte/source-mongodb-internal-poc,0.0.1,2023/08/01,61,172,132,2,0,367
rapidfort/fluentd-ib,1.15.3,2023/06/28,28,11,4,0,0,43
rancher/agent-base,v0.3.0,2016/12/22,306,388,24,0,0,718
rancher/curlimages-curl,7.73.0,2020/10/14,2,10,27,4,0,43
rancher/git-logrotate,v0.7.0,2020/01/02,null
