onlyoffice/4testing-docspace-doceditor,2.0.0.33,2023/11/15,315,72,56,2,0,445
vmware/kube-fluentd-operator,v1.18.1,2023/11/07,0,2,2,0,0,4
vmware/vs-openfaas-watchdog,revbf667b8,2017/12/11,211,543,569,143,35,1501
balenalib/parallella-debian-golang,20230904,2023/09/09,448,109,72,9,0,638
vmware/vsan-prometheus-exporter,v20210717,2021/07/17,15,96,110,45,0,266
rancher/vm-frontend,v0.2.0,2019/03/07,232,803,873,256,33,2197
circleci/builder-base,1.1,2017/01/11,304,355,22,2,0,683
bitnami/redis-exporter,1.55.0,2023/11/09,74,13,6,2,0,95
balena/rpi-supervisor-base,v1.4.7,2019/05/28,null
balenalib/qemux86-64-alpine-node,20231106,2023/11/07,0,3,3,0,0,6
ubuntu/apache2,2.4-23.04_edge,2023/11/07,15,3,0,0,0,18
rancher/hardened-cluster-autoscaler,v1.8.6-build20231010-s390x,2023/10/10,2,5,11,1,2,21
graphcore/poplar-minimal,3.3.0,2023/07/03,32,10,0,0,0,42
airbyte/destination-elasticsearch-strict-encrypt,0.1.6,2022/10/26,29,129,211,15,1,385
bitnami/express,4.18.2,2023/11/03,98,93,89,30,0,310
greenbone/boreas,v22.5.0,2023/05/02,90,36,29,4,0,159
rancher/nginx-ingress-controller-chroot,nginx-1.9.4-hardened1rc6-s390x,2023/10/26,2,2,12,0,0,16
balenalib/spacely-tx2-debian,20231106,2023/11/07,114,21,27,4,0,166
vmware/vs-secret-store,v0.0.1,2017/11/28,15,81,98,70,0,264
circleci/nomad-metrics,1.0,2020/11/17,0,1,0,0,0,1
balenalib/colibri-imx6dl-openjdk,20210602,2021/06/05,230,233,143,39,8,653
balenalib/i386-alpine-openjdk,8-20230911,2023/09/11,8,10,6,2,0,26
circleci/ecr-login,0.1.0-circle8,2020/05/27,null
intel/trusted-certificate-issuer,0.5.0,2023/03/10,51,44,1,0,0,96
balenalib/nitrogen6x-debian-python,20220604,2022/06/12,124,82,74,20,0,300
grafana/loki-canary-test,canary-test-58315f7-WIP,2022/09/23,0,12,14,0,0,26
rancher/docker,v1.11.2-3,2017/09/01,null
hashicorp/nomad-autoscaler-enterprise,0.3.6,2022/02/18,0,5,11,1,0,17
astronomerinc/ap-cadvisor,0.11.1,2020/01/23,0,10,2,0,0,12
balenalib/raspberrypi3,20230911,2023/09/11,118,37,38,6,0,199
balenalib/intel-nuc-ubuntu-openjdk,11-xenial-20230911,2023/09/11,null
vmware/vs-openfaas-python3-base,0.0.5-dev1,2017/12/12,15,128,162,93,0,398
datadog/apigentools,1.6.6,2023/09/21,2,3,3,2,0,10
bitnami/kafka-exporter,1.7.0,2023/11/08,74,15,7,2,0,98
jetbrains/qodana-python,2023.2,2023/09/06,142,61,66,11,0,280
airbyte/source-google-analytics-v4,0.2.2,2023/10/15,64,22,6,1,0,93
lacework/codesec,v1.0.4,2023/10/02,57,52,15,0,0,124
objectscale/throttler,0.54.0,2020/11/06,2,50,56,6,2,116
airbyte/source-convertkit,0.1.0,2022/10/27,0,17,25,1,0,43
onlyoffice/docspace-webhooks-service,test,2022/09/08,1014,332,356,22,1,1725
docker/dockerfile,1.6,2023/07/12,0,4,5,0,0,9
rancher/autoscale,v0.0.1,2016/06/23,0,27,24,10,0,61
airbyte/source-sendinblue,0.1.0,2022/11/10,0,17,25,1,0,43
airbyte/source-clickhouse-strict-encrypt,0.1.17,2023/03/22,30,131,203,15,1,380
balenalib/imx6ul-var-dart-alpine-openjdk,8-20231106,2023/11/07,0,2,2,0,0,4
balenalib/kitra520-fedora-golang,20220714,2022/07/23,null
balenalib/intel-nuc-ubuntu-node,20230911,2023/09/11,43,10,5,0,0,58
rancher/jenkins-jenkins,2.107-slim,2018/02/14,205,351,361,117,18,1052
balenalib/generic-armv7ahf-node,20230904,2023/09/09,118,39,39,6,0,202
airbyte/destination-rabbitmq,0.1.1,2022/09/09,0,17,25,1,0,43
bellsoft/buildpacks.native-image,5.9.0,1980/01/01,null
pachyderm/iris-infer,rstats,2017/04/20,234,640,709,121,40,1744
pachyderm/ubuntus3clients,v0.0.1,2020/03/05,705,1053,115,7,0,1880
docker/desktop-kubernetes-scheduler,v1.28.2,2023/09/13,0,2,4,0,0,6
pachyderm/pachyderm_jupyter,2019,2019/04/09,36,40,69,16,8,169
pachyderm/housing-prices,1.11.0,2020/07/23,455,956,191,20,0,1622
rancher/git-analyze,v0.7.0,2020/01/02,null
jetbrains/qodana-jvm-community,2023.2,2023/09/06,140,52,56,10,0,258
bitnami/fluxcd-kustomize-controller,1.1.1,2023/11/08,116,16,25,3,0,160
bitnami/postgres-exporter,0.15.0,2023/11/09,74,13,6,2,0,95
grafana/carbon-relay-ng,1.4.4,2023/07/27,0,11,6,3,0,20
mirantis/ucp-csi-resizer,3.5.3,2022/04/05,0,8,14,0,6,28
mirantis/ucp-interlock-proxy,3.7.1,2023/09/26,2,2,4,2,0,10
balenalib/jetson-tx2-debian-openjdk,20231106,2023/11/07,125,44,29,4,0,202
docker/dtr-content-cache-s390x,2.5.0-beta3,2018/01/17,0,2,2,2,0,6
kasmweb/tor-browser,1.14.0,2023/09/14,185,384,5,0,0,574
rancher/mirrored-calico-pod2daemon-flexvol,v3.26.3,2023/10/06,null
lacework/gcp-cfg-cli,v1.0,2019/01/21,837,1616,90,1,0,2544
balenalib/jetson-tx2-fedora,20231106,2023/11/06,null
balenalib/asus-tinker-board-fedora,20221210,2022/12/12,null
airbyte/destination-mysql-strict-encrypt,0.2.0,2023/06/29,34,145,243,30,1,453
cockroachdb/cockroach-unstable,v23.2.0-alpha.6,2023/11/08,15,14,0,0,0,29
airbyte/source-tiktok-marketing,3.9.2,2023/11/02,64,22,6,1,0,93
rancher/mirrored-elemental-seedimage-builder,1.3.4,2023/09/12,null
balenalib/revpi-core-3-python,20230530,2023/06/27,118,38,38,6,0,200
newrelic/k8s-nri-redis,1.4.0,2020/01/17,null
rapidfort/consul-official,1.16,2023/10/31,null
docker/dtr-s390x,2.4.12,2019/05/06,9,33,53,11,0,106
balenalib/odroid-xu4-ubuntu-node,20231026,2023/11/02,38,9,1,0,0,48
rapidfort/traefik,v2.9.10,2023/04/06,0,8,4,0,0,12
intel/esp-dyn-profile,v3.1.2,2023/07/25,null
onlyoffice/gdrive-builder,1.0.0-rc15,2023/09/18,0,6,5,0,0,11
objectscale/fabric-proxy,0.71.3,2021/04/05,2,17,21,0,0,40
balenalib/i386-nlp-debian-openjdk,20210225,2021/04/19,242,241,157,48,10,698
objectscale/ecs-flex-graphql,0.71.3,2021/04/14,11,33,29,1,0,74
balena/ca-private,0.0.13,2023/05/19,476,213,166,14,0,869
ubuntu/cassandra,4.0-22.04_edge,2023/05/17,38,60,10,0,0,108
rancher/hyperkube-base,v0.0.18,2023/10/16,39,33,0,0,0,72
grafana/agent-operator,v0.37.4,2023/11/06,14,3,0,0,0,17
rancher/longhornio-longhorn-ui,v1.3.1,2022/08/11,7,45,39,3,11,105
objectscale/snmp-notifier,2.114.0-264.7f91db2,2023/08/25,2,5,4,0,0,11
balenalib/generic-armv7ahf-ubuntu-node,20230904,2023/09/09,43,10,5,0,0,58
rancher/tiller,v2.11.0,2018/09/25,0,0,0,2,0,2
datadog/cws-instrumentation-dev,will-inject-k8s-user-info,2023/11/06,null
balenalib/odroid-c1-ubuntu-openjdk,20210826,2021/09/04,136,435,10,0,0,581
balenalib/spacely-tx2-ubuntu-python,20231103,2023/11/06,37,9,0,0,0,46
rancher/mirrored-kube-state-metrics-kube-state-metrics,v2.6.0,2022/08/24,0,3,4,1,0,8
balenalib/jetson-tx2-ubuntu-python,20230530,2023/06/11,54,20,4,0,0,78
intel/intelligent_traffic_management_video_inference,1.0,2022/06/17,445,1315,60,0,0,1820
docker/desktop-kubernetes-apiserver,v1.28.2,2023/09/13,0,2,4,0,0,6
bitnami/rabbitmq,3.12.8,2023/11/09,98,19,13,4,0,134
pachyderm/example-joins-inner-outer,2.1.0,2022/02/10,828,951,729,95,3,2606
airbyte/destination-databricks,1.1.0,2023/06/08,34,145,246,30,1,456
greenbone/scap-data,202311150504,2023/11/15,null
amazon/amazon-keyspaces-toolkit,0.7.8,2021/12/14,21,127,212,27,1,388
airbyte/cron,0.50.34,2023/11/09,13,53,60,4,1,131
mattermost/fleet-controller,7549599,2022/09/16,0,13,14,1,0,28
pachyderm/mount-server-arm64,97276071e371d5b1ea221437e99cfd87b5599ddf,2023/11/03,94,17,26,2,0,139
balenalib/generic-armv7ahf-fedora-openjdk,30-20210825,2021/09/03,null
atlassian/forge-tunnel,0.8.0-next.4,2020/02/11,591,831,93,6,0,1521
redislabs/redis-bionic,5.0.5,2019/06/06,93,72,2,0,0,167
vmware/photon-2.0-kube-proxy-amd64,v1.10.2-20180619,2018/06/19,17,94,117,76,0,304
balenalib/beaglebone-black-fedora-node,36-build-20230712,2023/07/17,0,1,1,0,0,2
airbyte/destination-iceberg,0.1.4,2023/07/27,37,139,246,28,1,451
balenalib/revpi-core-3-node,20230530,2023/07/02,118,39,39,6,0,202
onlyoffice/docs-proxy-de,7.5.1-1,2023/11/09,0,0,1,1,0,2
mattermost/release-bot,v0.0.1,2022/12/28,0,0,1,0,0,1
balenalib/fincm3-debian-python,20230530,2023/06/27,118,38,38,6,0,200
docker/resource-usage-extension,1.0.3,2023/05/25,0,10,2,3,0,15
balenalib/fincm3-openjdk,20230530,2023/07/04,143,73,44,6,0,266
bellsoft/liberica-openjdk-alpine-musl,21.0.1-12,2023/11/14,0,2,2,0,0,4
rancher/kibana,5.6.4,2017/11/08,50,130,107,42,20,349
google/dart-runtime,2.16-beta,2021/12/13,190,105,121,39,9,464
cockroachdb/example-orms-builder,20200729-1723,2020/07/29,926,1011,914,175,26,3052
airbyte/source-secoda,0.1.0,2022/11/08,0,17,25,1,0,43
rancher/library-traefik,2.4.9,2021/06/22,4,18,37,4,0,63
snyk/snyk-iac-rules,1.8.0,2023/06/05,0,4,2,0,0,6
airbyte/source-bamboo-hr,0.2.2,2022/10/06,77,39,38,3,0,157
astronomerinc/ap-configmap-reloader,0.12.0,2023/10/04,null
onlyoffice/docs-proxy,7.5.1-1,2023/11/09,0,0,1,1,0,2
rancher/confd,v0.12.0-alpha3,2017/02/10,1,36,13,3,0,53
balenalib/zynq-xz702-python,20220604,2022/06/12,124,82,74,20,0,300
intel/intel-optimized-clickhouse,23.11_oh,2023/04/24,48,52,6,0,0,106
grafana/enterprise-logs,v1.8.4,2023/10/18,0,4,3,0,0,7
objectscale/dell-supportassist-ese,2.71.3,2021/04/14,264,610,13,0,0,887
bitnami/wavefront-proxy-archived,12.4.0,2023/06/14,75,25,16,2,0,118
onlyoffice/documentserver-develop,develop,2022/10/24,364,1117,79,0,0,1560
rancher/mirrored-prom-prometheus,v2.18.2,2020/06/09,2,22,28,0,0,52
balenalib/armv7hf-golang,20230929,2023/10/02,447,109,73,9,0,638
grafana/otel-lgtm,0.1.0,2023/11/03,148,82,29,0,0,259
okteto/nginx,alpine,2018/11/13,2,18,6,5,0,31
airbyte/source-teradata,0.1.0,2023/04/06,30,129,203,15,1,378
onlyoffice/doc-builder-testing,next-release,2023/11/09,499,225,53,3,0,780
cockroachdb/visus,v0.2.0,2023/11/05,null
airbyte/airbyte-csv-destination-abprotocol,0.1.0,2020/10/20,100,74,77,24,6,281
rancher/mirrored-cilium-hubble-ui-backend,v0.12.1,2023/10/11,0,3,2,0,0,5
pachyderm/sentimentalist,1.11,2020/09/03,1475,1449,1074,153,37,4188
pachyderm/go-test-results,0.0.11,2023/08/10,0,6,10,0,0,16
vmware/vs-identity-manager,v0.0.1,2017/11/28,15,81,98,70,0,264
balenalib/bananapi-m1-plus,20230911,2023/09/11,118,37,38,6,0,199
airbyte/source-infinite-feed,dev,2021/05/07,105,86,92,27,6,316
balenalib/aarch64-ubuntu-golang,20231103,2023/11/06,139,131,0,0,0,270
jetbrains/upsource-cassandra,2020.1.1992,2022/03/11,97,153,199,63,11,523
rancher/mirrored-jetstack-cert-manager-controller,v0.8.1,2019/06/18,0,0,0,2,0,2
balenalib/hummingboard-node,20230904,2023/09/09,118,39,39,6,0,202
portainer/dev-toolkit,2023.10,2023/10/19,180,167,18,3,0,368
balenalib/parallella,20230904,2023/09/09,118,37,38,6,0,199
balenalib/parallella-debian-node,20230904,2023/09/09,118,39,39,6,0,202
balenalib/aarch64-fedora-python,20231106,2023/11/06,null
mattermost/mattermost-prod-web,v5.33.3,2021/03/31,8,31,55,9,0,103
okteto/codefresh-installer,1.0.2,2020/07/30,102,76,80,22,6,286
balenalib/zynq-xz702-debian-openjdk,20210602,2021/06/05,230,233,143,39,8,653
balenalib/qemux86-64-alpine-openjdk,8-20231106,2023/11/07,0,2,2,0,0,4
appdynamics/ad-air-load,java,2021/01/15,53,104,130,34,17,338
balenalib/beaglebone-green-ubuntu,20231026,2023/11/02,37,8,0,0,0,45
bitnami/sealed-secrets,0.24.3,2023/11/09,null
bitnami/postgresql-repmgr,16.1.0,2023/11/13,96,20,9,2,0,127
balenalib/via-vab820-quad-fedora,20220604,2022/06/12,null
intel/esp-smb,v3.1.2,2023/07/25,null
pachyderm/breast_cancer_classifier,1.11.6,2022/05/04,232,548,80,8,0,868
onlyoffice/4testing-documentserver-de,7.5.1.35,2023/11/15,123,89,1,1,0,214
balenalib/asus-tinker-board-s-alpine-node,18.14.1-20231106,2023/11/07,0,3,3,0,0,6
balenalib/via-vab820-quad-ubuntu-golang,20220523,2022/06/03,222,535,46,0,0,803
kong/kong-mesh-ecs-controller,0.1.0,2022/02/16,0,16,20,1,0,37
docker/dockerfile-copy-arches,v0.1.3.x86_64,2018/08/20,0,1,0,3,0,4
balenalib/apalis-imx6q-alpine,20220714,2022/07/19,7,37,33,10,0,87
balenalib/beaglebone-green-wifi-ubuntu,20231026,2023/11/02,37,8,0,0,0,45
astronomerinc/ap-dind-golang,24.0.6,2023/09/21,2,15,21,2,0,40
accurics/cli-kubescan-amd64,1.0.41,2022/09/01,0,28,28,1,0,57
airbyte/source-omnisend,0.1.0,2022/10/30,0,17,25,1,0,43
rancher/opni-opensearch-update-service,v0.12.1-rc1,2023/11/10,0,1,1,0,0,2
balenalib/beaglebone-black-ubuntu-node,20230530,2023/07/02,55,20,5,0,0,80
datadog/system-tests,uwsgi-poc.base-v1,2023/10/18,252,65,30,2,0,349
bitnami/wavefront-proxy,12.4.0,2023/06/14,75,25,16,2,0,118
lacework/datacollector-windows,1.7.2.3973,2023/11/14,null
balenalib/qemux86-64-debian-golang,20231103,2023/11/05,442,82,51,5,0,580
airbyte/source-shortio,0.2.0,2023/08/03,0,15,24,1,0,40
onlyoffice/gdrive-callback,1.0.0-rc15,2023/09/18,0,6,6,0,0,12
okteto/worker,1,2020/02/19,107,81,29,4,0,221
ubuntu/nginx,1.24-23.10_edge,2023/11/07,13,1,0,0,0,14
rancher/dns-windows,v0.17.0,2017/12/11,null
balenalib/raspberry-pi2-alpine-node,18.14.1-20231106,2023/11/07,0,3,3,0,0,6
airbyte/source-lemlist,0.2.0,2023/09/01,0,15,24,1,0,40
airbyte/secrets-migration,dev-28,2021/10/19,103,103,99,27,6,338
astronomerinc/ap-blackbox-exporter,0.24.0-3,2023/11/06,0,6,2,0,0,8
bitnami/harbor-core,2.9.1,2023/11/08,74,13,6,2,0,95
onlyoffice/docspace-migration,test,2022/09/08,1014,332,356,22,1,1725
amazon/aws-sam-cli-emulation-image-python3.7,20220125,2022/01/25,6,132,89,15,1,243
balenalib/hummingboard-alpine-python,20230904,2023/09/09,2,3,5,2,0,12
okteto/go-todo-list,dev,2021/03/11,724,502,475,75,16,1792
rancher/portainer-agent,v0.1.0,2017/03/03,0,1,5,2,0,8
pachyderm/gh-sum,v8,2018/05/02,511,1478,1010,242,53,3294
lacework/win-golang,1.21.0,2023/08/31,null
bitnami/aws-cli,2.13.30,2023/11/15,80,15,8,2,0,105
airbyte/source-outreach,0.5.0,2023/09/21,0,15,24,1,0,40
bitnami/mysql,8.2.0,2023/10/29,314,25,6,2,0,347
newrelic/k8s-nri-haproxy,2.1.0,2019/11/25,null
greenbone/pg-gvm-build,22.4,2022/07/25,528,294,251,30,1,1104
rancher/opni-python-base,3.9,2023/11/10,0,1,1,0,0,2
rancher/submariner,v0.0.1,2019/03/12,65,125,12,0,0,202
mirantis/ucp-kube-dns-dnsmasq-nanny,3.2.15,2021/06/29,0,0,0,2,0,2
vmware/sources-for-knative-adapter,v0.29.0,1970/01/01,0,4,7,0,0,11
rancher/storage-example,v0.6.1,2017/01/13,97,113,18,0,0,228
balenalib/spacely-tx2-fedora-python,20231106,2023/11/06,null
objectscale/crunchy-pgbackrest,ubi8-2.38-2,2022/07/05,247,183,47,0,0,477
graphcore/tensorflow,2,2023/03/14,167,356,59,1,0,583
kasmweb/ubuntu-focal-desktop,1.14.0,2023/09/14,270,583,0,0,0,853
airbyte/source-orb,1.1.0,2023/04/04,0,16,25,1,0,42
google/apigee-cert-manager-controller,v0.12.0,2019/11/28,0,0,0,0,6,6
solaceiotteam/solace-amplify-discovery-agent,0.2.4,2022/11/03,0,14,14,0,0,28
airbyte/source-google-directory,0.2.1,2023/06/22,0,15,25,1,0,41
airbyte/ci-runner,dev,2023/09/21,55,28,16,0,0,99
intel/intel-dlb-initcontainer,0.28.0,2023/09/22,null
circleci/welcome-config-image,0.2.1,2021/03/30,560,1526,1271,286,14,3657
balenalib/generic-armv7ahf-alpine-node,18.14.1-20230904,2023/09/09,2,3,6,2,0,13
intel/evi-ai-inference-cpu,master-ae213cd97d6931b1d44fc7689867cf5701e0f15d,2023/09/24,55,9,3,1,0,68
mattermost/chewbacca-bot,v0.1.7,2021/06/01,0,8,29,4,0,41
intel/classical-ml,2023.2-py3.10,2023/09/20,100,90,9,1,0,200
amazon/aws-otel-collector,v0.35.0,2023/11/02,0,0,1,0,0,1
rancher/prom-prometheus,v2.22.0,2020/10/15,6,34,34,0,0,74
couchbase/sdk-doctor,v1.0.5,2018/11/15,0,0,0,2,0,2
airbyte/source-gocardless,0.1.0,2022/10/19,0,17,25,1,0,43
balenalib/amd64-debian-node,20231106,2023/11/06,107,23,22,4,0,156
pachyderm/python-sdk-ci-testing,97276071e371d5b1ea221437e99cfd87b5599ddf,2023/11/03,64,8,2,1,0,75
airbyte/airbyte-api-server,0.50.34,2023/11/09,13,51,59,4,1,128
balenalib/kitra520-golang,20220714,2022/07/22,473,263,219,28,1,984
bitnami/spring-cloud-dataflow-shell,2.11.1,2023/10/13,88,17,8,4,0,117
amazon/opendistro-for-elasticsearch-kibana,1.13.2,2021/04/05,546,530,99,13,0,1188
percona/haproxy,2.8.1,2023/11/03,126,27,3,0,0,156
mattermost/circleci-weblate-client,521a212,2020/07/30,1533,1548,1238,185,37,4541
rancher/rio-dashboard,preview,2019/11/18,203,360,38,3,0,604
rancher/mirrored-prometheus-operator-prometheus-config-reloader,v0.65.1,2023/05/05,null
cimg/deploy,2023.09.1,2023/09/25,294,337,51,0,0,682
bitnami/open-service-broker-azure-archived,1.8.4,2022/01/16,130,78,77,23,6,314
balenalib/armv7hf-fedora-node,36-build-20230911,2023/09/11,0,1,1,0,0,2
balenalib/asus-tinker-board-s-fedora-golang,20221210,2022/12/13,null
balenalib/artik533s-debian,20220714,2022/07/22,124,69,72,18,0,283
kasmweb/steam,1.14.0,2023/09/14,187,379,0,0,0,566
grafana/loki-canary,2.9.2,2023/10/25,0,3,3,0,0,6
objectscale/postgresql-repmgr,11.11.0-debian-10-r43,2021/03/30,158,111,120,35,6,430
netdata/netdata,v1.43.2,2023/10/30,0,4,0,0,0,4
onlyoffice/trello-client,1.0.7,2023/11/15,0,4,1,0,0,5
balenalib/fincm3-alpine,20230904,2023/09/09,2,2,5,2,0,11
rancher/kiali-kiali,v1.29.0,2021/01/22,241,338,30,3,0,612
kong/statsd-exporter,0.3.1,2020/04/20,null
intel/esp-aws-cli,v3.1.2,2023/07/25,0,1,0,1,0,2
intel/power-node-agent_ocp-4.13,v2.3.1,2023/09/08,29,32,8,0,0,69
balenalib/orangepi-plus2-debian-node,20230911,2023/09/11,118,39,39,6,0,202
balenalib/colibri-imx6dl-alpine,20220714,2022/07/19,7,37,33,10,0,87
balenalib/jetson-tx1-ubuntu-python,20230530,2023/06/26,54,20,4,0,0,78
datadog/chaos-injector,8.3.0,2023/10/26,39,28,25,5,0,97
cockroachdb/acceptance-gss-python,20221214-141947,2022/12/14,804,734,540,37,0,2115
balenalib/colibri-imx6dl-ubuntu,20220714,2022/08/02,87,81,11,0,0,179
continuumio/ap-git-storage,1.3.0,2018/05/31,0,28,16,31,0,75
rapidfort/mysql-official,8.0.35-debian,2023/11/15,22,7,2,0,0,31
rancher/mirrored-cilium-operator-azure,v1.14.4,2023/11/13,null
cimg/go,1.21.4,2023/11/07,294,325,45,0,0,664
puppet/gogrpc,go-1.17,2021/11/01,503,407,329,61,2,1302
docker/ucp-kube-compose-api,3.3.1,2019/11/07,4,14,9,1,0,28
balenalib/fincm3-fedora-python,20221109,2022/12/02,0,1,0,0,0,1
purestorage/log-upload,1.1.2,2023/10/31,0,8,6,0,0,14
airbyte/mirrored-keycloak-arm,21.1,2023/06/28,15,36,7,0,0,58
kasmweb/ubuntu-jammy-desktop,1.14.0,2023/09/14,323,512,35,0,0,870
redislabs/redis-connect,0.10.5.1,2023/10/04,1,11,6,1,0,19
bitnami/whereabouts,0.6.2,2023/11/09,74,17,8,2,0,101
balena/amd64-supervisor-base,v1.4.7,2019/05/28,null
rancher/channelserver,v0.6.0,2023/07/28,0,7,3,0,1,11
airbyte/source-kafka,0.2.3,2022/12/06,29,131,209,15,1,385
puppet/cd4pe-beta,3.13.7-rc,2021/04/16,52,74,83,16,7,232
okteto/java-gradle-getting-started,1.0.0,2023/02/27,111,79,112,36,0,338
docker/ucp-init-aws,2.1.0,2017/02/09,2,51,32,31,0,116
grafana/loki-operator,2.8.6,2023/10/17,0,5,2,0,0,7
newrelic/nri-kube-events,2.4.0,2023/11/13,0,1,1,0,0,2
google/apigee-canary-deployment-controller,1.0.0-rc4,2019/08/15,143,105,37,4,0,289
airbyte/destination-databend,0.1.2,2023/03/27,0,16,25,1,0,42
balenalib/spacely-tx2-ubuntu-node,20231103,2023/11/06,38,9,1,0,0,48
balenalib/nitrogen6x-fedora,20220604,2022/06/12,null
airbyte/cloud-cron,dev-97763408ca,2023/11/02,13,53,61,4,1,132
balenalib/armv5e-debian,20200221,2020/02/29,173,129,166,30,6,504
newrelic/k8s-nri-elasticsearch,4.2.0,2019/11/25,null
rancher/harvester-ui,v1.2.1,2023/10/25,0,102,56,17,0,175
vertica/vertica-ce,23.4.0-0,2023/09/21,610,516,6,0,0,1132
intel/intel-vpu-plugin,0.27.1,2023/06/20,55,9,3,1,0,68
airbyte/source-pexels-api,0.1.0,2022/11/18,0,17,25,1,0,43
grafana/cortex-alertmanager,w37-0193e7b7,2018/09/11,0,0,0,2,0,2
grafana/grafana-arm64v8-linux,7.0.6,2020/07/09,4,30,54,9,0,97
newrelic/fluentd,3.0.0,2020/03/26,55,215,179,13,8,470
google/apigee-authn-authz,1.8.0-preview.2,2021/08/29,0,0,0,0,4,4
balenalib/artik5-node,20220714,2022/07/20,124,71,73,18,0,286
tenable/was-scanner,2.6.1-1170,2023/11/14,1,5,1,0,0,7
airbyte/source-always-works-shim,dev,2021/05/18,104,61,77,30,7,279
rancher/lb-service-rancher,v0.9.14,2020/05/01,135,141,14,0,0,290
docker/compose,1.29.2,2021/05/10,0,2,25,4,0,31
bellsoft/buildpacks.gradle,6.11.0,1980/01/01,null
amazon/aws-lambda-go,1.2023.11.12.10,2023/11/12,null
rancher/pipeline-ui,v1.0.1,2018/01/11,71,75,130,41,12,329
vmware/photon-2.0-k8s-dns-sidecar-amd64,1.14.10-20180619,2018/06/19,15,72,90,57,0,234
airbyte/source-gong,0.1.0,2022/11/10,0,17,25,1,0,43
newrelic/infrastructure-k8s,2.13.11,2023/09/16,8,35,21,2,0,66
bitnami/kube-rbac-proxy,0.15.0,2023/11/08,0,1,3,0,0,4
solace/solace-pubsub-connector-tibcoems,1.0.0,2023/08/25,72,59,7,1,0,139
rancher/server-base,v1.0.0,2017/12/17,66,55,7,0,0,128
bellsoft/liberica-openjdk-centos,21.0.1-12,2023/11/14,543,499,32,3,0,1077
okteto/private,1,2022/09/09,676,303,279,42,8,1308
objectscale/nvmetargetviewer,3.9.0.0-139102.b4b5064355c,2023/05/03,3,36,24,1,0,64
balenalib/up-board-ubuntu-node,20230911,2023/09/12,43,10,5,0,0,58
balenalib/artik530-ubuntu,20220714,2022/08/02,87,81,11,0,0,179
balenalib/ts4900-ubuntu-golang,20220523,2022/06/03,222,535,46,0,0,803
grafana/mimir-continuous-test,2.10.4,2023/11/13,0,2,2,0,0,4
pachyderm/tweet-scraper,v3,2020/06/22,712,561,525,65,9,1872
rancher/hardened-kube-proxy,v1.20.2,2021/01/22,443,394,21,3,0,861
docker/assemble-backend,v0.5.0,2019/05/01,6,14,25,5,0,50
balenalib/jetson-tx2-alpine-openjdk,8-20231106,2023/11/06,8,10,2,0,0,20
rancher/mirrored-banzaicloud-logging-operator,3.17.10,2022/11/25,0,3,7,0,0,10
balenalib/asus-tinker-board-s-ubuntu-node,20231026,2023/11/02,38,9,1,0,0,48
hashicorp/vault-website,0.1.23,2019/10/16,12,186,106,14,0,318
rancher/windows-scheduler,v0.0.2,2017/02/17,306,388,24,0,0,718
objectscale/nds,0.71.3,2021/04/15,16,142,194,36,3,391
rancher/hardened-containerd,v1.7.7-k3s1-build20231010-s390x-linux,2023/10/11,2,13,17,0,2,34
rancher/rancher-agent,v2.8.0-rc3,2023/10/26,0,7,14,0,1,22
mirantis/ucp-nvidia-gpu-feature-discovery,3.7.1,2023/09/26,32,30,9,0,0,71
formio/pdf-server,5.3.5-rc.1,2023/11/14,206,176,1,0,0,383
balenalib/bananapi-m1-plus-debian,20230911,2023/09/11,118,37,38,6,0,199
docker/telemetry,1.0.0.linux-x86_64-test,0001/01/01,0,1,3,0,0,4
rancher/mirrored-flannelcni-flannel,v0.20.2,2022/11/30,3,22,22,2,0,49
airbyte/source-delighted,0.2.3,2023/09/08,64,24,6,1,0,95
cockroachdb/docs-builder,20210405-130258,2021/03/24,4,16,37,2,0,59
mattermost/mattermost-oncall-handler,v0.1.2,2023/05/11,3,16,5,0,0,24
rancher/goharbor-redis-photon,v1.7.5,2019/04/01,16,77,103,38,0,234
nginx/unit-preview,wasm-wasi-http,2023/11/02,83,14,17,4,0,118
okteto/compose,18.09.1,2019/01/17,4,15,16,10,0,45
balenalib/i386-debian-openjdk,20231106,2023/11/06,118,44,23,4,0,189
solace/pubsubplus-eventbroker-operator,1.0.2,2023/11/14,15,13,0,0,0,28
airbyte/source-psl-test,0.1.5-dev.db682fcfb4,2023/07/19,151,84,61,10,0,306
airbyte/source-freshservice,1.2.0,2023/08/16,0,15,24,1,0,40
bitnami/opensearch,2.11.0,2023/10/17,84,21,19,4,0,128
kasmweb/vmware-horizon,1.11.0,2022/07/06,416,1255,3,0,0,1674
onlyoffice/4testing-docs-docservice-de,7.5.1-1-saas,2023/11/08,0,0,1,1,0,2
grafana/grafana-dev-arm32v7-linux,master-91219227-4f9f-465a-8ea0-70670344aaaa-ubuntu,2020/05/15,129,277,40,4,0,450
docker/labs-debug-tools-extension,0.0.44,2023/11/14,13,38,20,4,0,75
cimg/openjdk,21.0.0,2023/10/17,299,326,49,0,0,674
balenalib/rpi-alpine,20231026,2023/11/01,0,2,2,0,0,4
bitnami/jasperreports,8.2.0,2023/10/11,112,42,53,13,0,220
objectscale/dellmon-pre-upgrade-crds,3.9.0.0-1588.729cf194,2023/04/25,2,10,2,0,0,14
rancher/docs,staging,2023/01/09,4,59,40,4,0,107
bitnami/discourse,9.0.4,0001/01/01,null
intel/multimodal-data-visualization,3.0,2022/07/27,0,54,83,1,0,138
balenalib/artik530-alpine,20220803,2022/08/03,7,37,33,10,0,87
airbyte/source-aws-cloudtrail,0.1.5,2023/02/28,77,34,26,2,0,139
tenable/terrascan,1.18.3,2023/08/03,1,14,4,1,0,20
docker/compose-bin,v2.23.0,2023/10/18,0,2,4,0,0,6
rancher/mirrored-k8scsi-csi-resizer,v1.1.0,2020/12/18,0,5,12,0,5,22
opensearchproject/logstash-oss-with-opensearch-output-plugin,8.9.0,2023/08/10,34,32,12,2,0,80
objectscale/bookkeeper,0.71.3,2021/03/30,626,807,85,11,0,1529
mirantis/ucp-calico-cni,3.7.1,2023/09/26,0,16,7,0,0,23
docker/dtr-registry-s390x,2.5.0-beta3,2018/01/17,0,16,41,34,0,91
balenalib/i386-alpine,20231106,2023/11/07,0,2,2,0,0,4
airbyte/source-babelforce,0.2.0,2023/08/24,0,15,24,1,0,40
okteto/chat,dev,2020/07/22,1361,1133,1066,120,19,3699
rancher/opni-ui,v0.3.1,2022/01/25,188,374,438,116,3,1119
balenalib/hummingboard-alpine,20230904,2023/09/09,2,2,5,2,0,11
airbyte/temporal,0.50.34,2023/11/09,5,39,33,2,0,79
objectscale/nvmeengine,3.9.0.0-139102.b4b5064355c,2023/05/03,3,36,24,1,0,64
balenalib/nitrogen6x-alpine-python,20220714,2022/07/19,7,38,35,10,0,90
docker/pilot,1.1.2,2019/04/12,446,623,51,0,0,1120
percona/percona-server-mongodb-operator,1.15.0,2023/10/06,28,21,5,0,0,54
percona/percona-xtradb-cluster-operator,1.13.0,2023/07/06,31,35,7,0,0,73
intel/ai-inference-cpu,evi-2.0.0,2022/10/31,34,17,0,0,0,51
rancher/storage-longhorn,v0.9.7,2018/07/09,88,163,12,0,0,263
kong/pulp-core,1.1.38,2022/08/24,4,11,9,4,0,28
balenalib/raspberrypi3-fedora-node,36-build-20230911,2023/09/12,0,1,1,0,0,2
newrelic/kube-webhook-certgen,v1.5.2-1-g18cfc89,2021/08/10,0,3,6,0,4,13
atlassian/bamboo,9.4.1,2023/11/07,102,144,10,6,0,262
airbyte/source-jira,0.10.2,2023/10/26,64,22,6,1,0,93
balenalib/artik5-debian-node,20220714,2022/07/20,124,71,73,18,0,286
okteto/buildkit,v0.7.2-6,2020/11/30,12,33,68,5,0,118
onlyoffice/4testing-docspace-ssoauth,2.0.0.33,2023/11/15,317,77,61,2,0,457
balenalib/jetson-tx1-debian-node,20230712,2023/07/18,118,42,40,6,0,206
amazon/dynamodb-local,2.1.0,2023/10/24,0,9,8,1,0,18
circleci/runner,9292817-dev,2022/12/26,74,135,2,0,0,211
rancher/etcd-tools,319,2023/11/15,6,53,39,8,0,106
rancher/opni,0.12.1-rc1,0001/01/01,null
mirantis/gerrit,2.14.11,2018/09/03,131,254,90,49,0,524
balenalib/via-vab820-quad-fedora-python,20220622,2022/07/12,0,1,1,0,0,2
jetbrains/upsource-psi-broker,2020.1.1992,2022/03/11,79,148,241,95,0,563
rapidfort/yourls,1.9.2-apache,2023/11/02,51,7,4,1,0,63
intel/evi-storage-rest,master-ae213cd97d6931b1d44fc7689867cf5701e0f15d,2023/09/23,140,48,16,1,0,205
airbyte/connector-acceptance-test,2.0.1,2023/09/08,539,285,91,10,0,925
atlassian/opsgenie-edge-encryption,2.3,2021/12/20,158,136,140,53,1,488
okteto/rails-blog,0.1.3,2019/01/29,583,1578,1303,272,14,3750
balenalib/apalis-imx6q-debian-python,20220604,2022/06/12,124,82,74,20,0,300
balenalib/aarch64-ubuntu-python,20231103,2023/11/06,34,9,0,0,0,43
sysdig/sdc-cli,0.2.8,2020/05/07,4,19,44,6,0,73
balenalib/zynq-xz702-fedora-python,20220622,2022/07/12,0,1,1,0,0,2
rancher/k8s,v1.12.10-rancher1-1,2019/09/03,414,613,35,0,0,1062
intel/intelligent_traffic_management_cloud_connector,2.0,2022/11/10,61,88,13,0,0,162
kasmweb/audacity,1.14.0,2023/09/14,199,393,0,0,0,592
redislabs/pcf-tile-manager-tests,100.0.9000481,2020/05/13,562,1545,1377,247,14,3745
mattermost/cloud-db-factory-horizontal-scaling,323a159,2020/06/16,3,15,27,4,0,49
intel/intel-sgx-plugin,0.28.0,2023/09/22,null
docker/ucp,3.3.1,2020/06/26,2,8,9,1,0,20
rancher/banzaicloud-logging-operator,3.9.0,2021/01/20,0,5,11,0,4,20
puppet/facter,5.5.1,2018/05/09,113,148,12,0,0,273
circleci/filebeat,console,2016/12/05,41,93,101,22,20,277
redhat/ubi8,8.8-1067,2023/09/13,143,41,6,0,0,190
couchbase/centos-72-jenkins-core,20170613,2017/07/06,705,877,130,12,0,1724
balenalib/armv7hf-debian-node,20230929,2023/10/02,111,39,34,6,0,190
docker/ucp-istio-mixer,3.3.1,2020/06/26,1,12,18,0,6,37
airbyte/source-jdbc,0.3.4,2022/06/17,76,77,63,19,0,235
objectscale/storagemanagement-service,0.71.3,2021/04/15,17,149,212,36,6,420
datadog/dd-lib-python-init,v2.1.7,2023/11/15,0,2,2,0,0,4
balenalib/parallella-alpine-node,18.14.1-20230904,2023/09/09,2,3,6,2,0,13
rancher/mirrored-sig-storage-csi-snapshotter,v6.2.1,2023/01/04,0,3,3,0,0,6
balenalib/armv7hf-fedora-golang,20221109,2022/12/03,null
grafana/shipwright,93616b8,2022/06/11,0,41,62,11,0,114
airbyte/source-github-test,0.3.9,2022/12/08,77,38,32,3,0,150
mirantis/ucp-csi-attacher,3.5.3,2022/04/05,0,8,14,0,6,28
grafana/plugin-builds,83986700d258dae901ead75668ed5d910256aee5pre,2023/10/04,2,4,10,2,0,18
okteto/ruby-getting-started,1.0.0,2023/02/27,779,595,343,23,0,1740
onlyoffice/4testing-ds-converter-de,6.2.0-eu-r2,2021/03/04,536,493,32,3,0,1064
balenalib/armv7hf-ubuntu-python,20231026,2023/11/02,34,9,0,0,0,43
grafana/test.k6.io,v0.0.5,2023/08/18,null
greenbone/gvm-tools,v23.11.0,2023/11/14,70,15,9,1,0,95
grafana/vectorapi,61165515c6,2023/10/30,77,12,13,3,0,105
mirantis/dtr-registry,3.0.0-alpha.2,2021/09/22,3,25,39,5,0,72
rancher/k8s-metrics-server,v0.3.6,2020/08/11,257,403,18,3,0,681
balenalib/zynq-xz702-golang,20220714,2022/07/28,473,260,213,28,1,975
mirantis/cluster,v1.9.0,2020/11/05,13,49,74,17,0,153
rancher/fleet,v0.9.0,2023/11/07,2,7,12,0,3,24
rancher/mirrored-k8s-dns-sidecar,1.22.20,2023/02/22,0,2,1,0,0,3
tenable/nessus,10.6.2-ubuntu-20231113,2023/11/13,25,26,0,0,0,51
rancher/mirrored-squareup-ghostunnel,v1.5.2,2019/11/20,5,17,34,2,0,58
docker/ucp-kube-dns-dnsmasq-nanny,3.2.7,2020/06/26,0,0,0,2,0,2
kong/go-echo,0.4.0,2023/10/25,null
kasmweb/core-ubuntu-bionic,1.14.0,2023/09/09,null
rancher/os,437034c,2017/06/20,0,19,15,6,0,40
balenalib/odroid-c1-debian-python,20220604,2022/06/12,124,82,74,20,0,300
rancher/mirrored-pause,3.7,2022/03/12,null
balenalib/spacely-tx2-fedora-openjdk,8-20231106,2023/11/06,null
percona/percona-xtradb-cluster,8.0.34,2023/10/24,74,33,0,0,0,107
onlyoffice/4testing-docspace-backup,2.0.0.33,2023/11/15,993,142,206,12,0,1353
balenalib/beaglebone-black-fedora-golang,20220523,2022/06/05,null
rapidfort/memcached,1.6.21,2023/10/09,21,3,1,0,0,25
mirantis/rudder-federation,v0.1,2017/08/01,0,1,5,2,0,8
kasmweb/edge,1.14.0,2023/09/14,187,379,0,0,0,566
rancher/k3d-tools,5.3,2022/02/03,3,13,17,1,0,34
airbyte/destination-redis,0.1.4,2022/10/31,29,129,210,15,1,384
sysdig/sysdig,0.34.1,2023/11/07,281,210,15,0,0,506
bitnami/sonarqube,10.2.1,2023/10/11,89,47,35,4,0,175
circleci/runner-agent,machine-3.0.14-4844-3a4f06d,2023/11/09,24,9,0,0,0,33
balenalib/ts4900-alpine-openjdk,8-3.14-20220112,2022/01/19,2,50,42,13,0,107
datadog/agent-arm64,7.29.1,2021/07/12,34,118,102,5,0,259
objectscale/grafana,0.54.0,2020/11/06,2,70,81,11,3,167
rancher/mirrored-git-sync,v3.5.0,2022/03/11,122,61,77,23,3,286
atlassian/confluenec-servert,7.0.3,2021/03/29,150,388,412,128,0,1078
apachepinot/pinot-base-build,17-ms-openjdk,2023/06/14,201,257,25,0,0,483
balenalib/apalis-imx6q-alpine-python,20220714,2022/07/19,7,38,35,10,0,90
rancher/os-centosconsole,v1.5.8,2021/02/05,820,679,48,3,0,1550
okteto/go-getting-started,1.0.0,2023/02/27,657,230,208,14,3,1112
balenalib/artik530-golang,20220714,2022/07/22,473,263,219,28,1,984
airbyte/source-notion,2.0.8,2023/11/01,64,22,6,1,0,93
balenalib/artik710-debian,20230904,2023/09/09,118,37,38,6,0,199
rancher/mirrored-neuvector-enforcer,5.2.3,2023/11/10,0,2,0,0,0,2
bitnami/phppgadmin-archived,7.13.0,2022/01/13,297,279,171,31,12,790
rancher/flannel,v0.11.0,2020/08/11,474,529,26,3,0,1032
airbyte/source-partnerstack,0.1.0,2022/11/09,0,17,25,1,0,43
kasmweb/core-rockylinux-8,1.14.0,2023/09/09,0,14,806,0,0,820
puppet/puppet-agent-ubuntu,7.20.0,2022/10/11,31,30,2,0,0,63
balenalib/orangepi-plus2-ubuntu-python,20231026,2023/11/02,37,9,0,0,0,46
bitnami/kubeapps-asset-syncer,2.9.0,2023/11/08,0,5,2,0,0,7
vmware/vke-canary,1.2,2019/01/11,15,124,156,82,0,377
grafana/grafana-plugin-ci,1.9.5,2023/10/17,207,46,68,2,0,323
airbyte/source-timely,0.3.0,2023/10/25,0,13,24,1,0,38
balenalib/ts4900-openjdk,20210602,2021/06/05,230,233,143,39,8,653
rapidfort/nginx-ib,1.25.2,2023/09/21,null
purestorage/dbdeployer,v1.2.2,2022/01/28,0,8,14,1,0,23
grafana/logstash-output-loki,2.9.2-amd64,2023/10/25,538,505,81,5,0,1129
accurics/terrascan,9814799,2020/08/16,2,14,43,4,0,63
rancher/vm,v0.2.0,2018/12/20,120,109,18,0,0,247
hashicorp/consul-smi-controller,v0.0.0-alpha.2,2019/07/17,4,14,9,3,0,30
google/apigee-istio-sidecar-injector,1.4.6,2020/02/22,650,1305,152,0,0,2107
snyk/snyk-cli,1.1228.0-gradle-5.4,2023/09/28,153,93,152,32,0,430
grafana/cloudsql-proxy,v1.18.1-prometheus2,2020/10/20,13,37,27,10,4,91
dynatrace/dynatrace-synthetic,1.275.47.20231003-143936,2023/10/03,23,18,5,0,0,46
rancher/mirrored-k8scsi-csi-attacher,v3.1.0,2020/12/16,0,5,13,0,5,23
percona/dbaas-operator,0.1.17,2023/07/04,0,2,1,0,0,3
balenalib/nitrogen6x-python,20220604,2022/06/12,124,82,74,20,0,300
google/apigee-istio-node-agent-k8s,1.4.6,2020/02/22,651,1313,157,0,0,2121
mattermost/mm-ee-cloud,21227_6978bb53_d6e98f0f,2023/11/02,52,29,6,0,0,87
balenalib/odroid-c1-ubuntu-golang,20220523,2022/06/03,222,535,46,0,0,803
atlassian/pipelines-docker-daemon-tini-init,stg-stable,2018/08/01,0,8,3,3,0,14
airbyte/destination-milvus-preview,dev,2023/08/31,64,25,9,4,0,102
balenalib/amd64-debian-golang,20231106,2023/11/06,441,82,51,5,0,579
portainer/extract-matomo,test-dockerfile,2023/02/13,0,14,4,0,0,18
vmware/notary-signer-photon,v0.5.1-v1.5.2,2018/07/18,8,54,72,36,0,170
balena/balena-push-env,9980750,2022/08/11,86,257,14,0,0,357
amazon/aws-sam-cli-emulation-image-python3.6,20220125,2022/01/25,6,131,90,15,1,243
balenalib/ts4900-ubuntu-python,20220622,2022/06/23,87,112,13,0,0,212
circleci/nomad-gc,0.0.87-74a5faf,2020/01/08,2,8,9,1,0,20
balenalib/fincm3-ubuntu-golang,20230712,2023/07/14,173,176,39,0,0,388
balenalib/armv7hf-alpine-golang,20231106,2023/11/07,0,2,2,0,0,4
astronomerinc/ap-curator,8.0.8-4,2023/11/06,0,3,0,0,0,3
newrelic/k8s-nri-apache,1.5.0,2019/12/10,null
airbyte/destination-snowflake,3.4.10,2023/11/08,9,39,58,18,0,124
okteto/movies,frontend,2019/09/09,560,1567,1267,266,14,3674
lacework/iac-scanner-jenkins,20220921,2022/09/21,228,636,65,1,0,930
google/apigee-istio-mixer,1.4.6,2020/02/22,1,12,18,0,6,37
kasmweb/core-almalinux-8,1.14.0,2023/09/09,0,18,819,0,0,837
objectscale/zookeeper,0.30.0,2019/10/09,153,223,286,59,8,729
airbyte/np-dest,dev,2021/05/21,97,36,49,16,6,204
vmware/cascade-cli-toolchain,0.0.3,2018/10/23,198,433,451,96,14,1192
balenalib/artik530-ubuntu-golang,20220803,2022/08/03,245,463,67,0,0,775
intel/esp-dnsmasq,v3.1.2,2023/07/25,0,0,1,0,0,1
airbyte/connector-atelier-server,0.50.8,2023/07/17,22,79,80,9,0,190
intel/dlstreamer-pipeline-server,0.7.1,2022/02/22,445,1315,60,0,0,1820
launchdarkly/ld-find-code-refs-bitbucket-pipeline,2.11.4,2023/10/16,0,2,2,0,0,4
circleci/elixir,1.13.1,2022/01/01,857,1050,768,100,3,2778
redislabs/service-broker-internal,72_b401787,2019/01/08,0,0,4,2,0,6
cimg/unity,9.9.9,2022/02/11,235,663,358,39,0,1295
amazon/aws-sam-cli-emulation-image-nodejs12.x,20220125,2022/01/25,5,33,27,13,1,79
intel/query-rest,evi-2.0.0,2022/10/31,48,52,40,17,0,157
balena/cert-manager,0.1.17,2023/06/27,4,16,36,9,0,65
google/apigee-istio-proxy-init,1.2.0,2019/06/18,40,33,0,0,0,73
bellsoft/alpaquita-linux-gcc,13.2-stream-musl,2023/11/15,null
grafana/e2ealerting,master-63bd62ca,2020/11/09,2,18,42,4,0,66
grafana/bigtable-backup,master-418c0dd,2019/08/02,4,14,6,2,0,26
airbyte/cloud-worker,test,2022/10/13,35,140,216,14,1,406
cimg/testing,2023.10,2023/09/05,207,231,32,0,0,470
rapidfort/mongodb-ib,6.0.5,2023/10/25,96,41,8,0,0,145
balena/open-balena-s3,2.28.15,2023/11/02,336,93,60,5,2,496
balena/arm64-balena-multibuild-scripts,0.1.0,2019/10/01,6,22,33,3,0,64
bitnami/mastodon,4.2.1,2023/11/08,280,192,112,8,0,592
balenalib/fincm3-python,20230530,2023/06/27,118,38,38,6,0,200
launchdarkly/ld-gh-actions-pr-starts-with-verb,1.0,2019/03/03,51,54,86,21,9,221
passbolt/passbolt,3.12.0-3,2023/04/11,176,125,96,22,0,419
rancher/harvester-cluster-repo,v1.2.1,2023/10/26,0,2,4,0,0,6
rancher/hardened-sriov-cni,v2.6,2021/02/24,240,327,18,3,0,588
rancher/hardened-sriov-network-device-plugin,v3.3.1,2021/02/26,443,393,33,3,0,872
objectscale/objectscale-restapi,1.3.0-144.697e704,2023/09/07,2,7,6,0,0,15
pachyderm/mount-server,2.8.0-rc.2,2023/11/13,94,17,26,2,0,139
portainer/portable-env,1.0.3,2023/07/28,4,30,22,5,0,61
airbyte/source-alloydb-strict-encrypt,3.1.5,2023/08/23,32,124,201,15,1,373
balenalib/orangepi-plus2-node,20230911,2023/09/11,118,39,39,6,0,202
okteto/api,1.5.73,2020/03/27,3,18,43,4,0,68
rancher/lb-service-haproxy,v0.9.14,2020/05/01,263,490,23,0,0,776
airbyte/source-twilio-taskrouter,0.1.0,2022/11/18,0,17,25,1,0,43
hashicorp/demo-webapp,v3,2018/10/04,0,0,0,2,0,2
balenalib/rpi-alpine-python,20231026,2023/11/01,0,3,2,0,0,5
kasmweb/rockylinux-9-desktop,1.14.0,2023/09/14,0,5,4,0,0,9
airbyte/source-waiteraid,0.1.0,2022/10/28,0,17,25,1,0,43
airbyte/destination-postgres,0.4.0,2023/06/29,34,145,243,30,1,453
okteto/math,0.1.0,2019/05/01,6,15,25,6,0,52
portainer/portainer-extension,2.13.0-alpha.1,2022/04/28,4,35,33,1,0,73
circleci/fakes3,0.2.4,2016/09/07,504,3040,1867,503,75,5989
balena/arm-balena-multibuild-scripts,0.1.0,2019/10/01,6,22,33,3,0,64
bitnami/contour-operator,1.24.0,2023/05/15,0,2,3,0,0,5
balena/aarch64-supervisor-node,1244-update-lock-weirdness,2020/03/31,721,608,598,76,9,2012
objectscale/csi-baremetal-basemgr,0.69.0,2021/03/07,68,66,10,0,0,144
balenalib/intel-nuc-debian-golang,20231106,2023/11/06,442,82,51,5,0,580
circleci/php,8.0.12,2021/11/18,550,445,386,71,2,1454
okteto/webhook,1.5.73,2020/03/26,2,20,41,4,0,67
balenalib/beaglebone-green-wifi-fedora-python,20220928,2022/10/04,0,1,1,0,0,2
airbyte/normalization,0.6.1-alpha,2020/12/04,161,117,174,44,9,505
sysdig/sysdig-image-scanning-trigger,0.1.2,2020/05/06,2,10,27,4,0,43
jetbrains/datalore-server,2023.5.1,2023/10/18,58,103,11,0,0,172
kong/kong,20231115,2023/11/15,20,3,0,0,0,23
mirantis/ucp-csi-liveness-probe,3.5.3,2022/04/05,0,0,0,0,6,6
kong/kuma-cp,2.4.4,2023/11/06,0,0,2,0,0,2
bitnami/thanos,0.32.5,2023/11/09,0,1,2,0,0,3
airbyte/destination-mssql-strict-encrypt,0.2.0,2023/07/26,37,142,244,32,1,456
lacework/test-latest-dockerhub-tag,2023-11-15_pre-release_149e6f82c8e39153cfdffbc7f1fadc593436a7f5_RA,2023/11/15,0,2,2,0,0,4
bitnami/opensearch-dashboards,2.11.0,2023/10/18,84,20,14,8,0,126
kasmweb/desktop,1.14.0,2023/09/14,189,396,0,0,0,585
pingidentity/pingdatasync,2310,2023/11/01,3,15,9,0,0,27
portainer/k2d,1.0.0,2023/10/31,0,1,1,0,0,2
balenalib/kitra710-alpine-golang,3.16-20230904,2023/09/09,2,0,3,2,0,7
kasmweb/remnux-focal-desktop,1.14.0,2023/09/14,520,1096,145,12,0,1773
balenalib/artik533s-debian-python,20220714,2022/07/22,124,70,74,18,0,286
balenalib/zynq-xz702-ubuntu-python,20220622,2022/06/23,87,112,13,0,0,212
rancher/mirrored-k8scsi-livenessprobe,v2.2.0,2020/12/18,0,5,8,0,5,18
onlyoffice/4testing-docspace-dotnet-runtime,v1.0.0,2023/09/04,995,174,228,15,0,1412
appdynamics/cluster-agent,23.9.0-107,2023/09/26,0,4,3,0,0,7
newrelic/nri-statsd-alpha,0.5.0,2020/04/23,3,17,21,1,0,42
airbyte/destination-langchain,0.1.1,2023/09/11,64,26,7,4,0,101
balenalib/raspberrypi3-alpine-node,18.14.1-20231106,2023/11/07,0,3,3,0,0,6
airbyte/source-appsflyer-singer,0.1.3,2021/07/06,615,347,335,49,9,1355
portainer/kubectl-shell,latest-v1.21.1-arm64,2021/11/14,7,51,48,6,0,112
appdynamics/servox,23.10.0,2023/10/06,96,77,74,28,1,276
airbyte/source-trello,1.0.2,2023/10/13,0,14,24,1,0,39
airbyte/source-braze,0.3.0,2023/11/04,0,13,24,1,0,38
rancher/os-modemmanager,v1.6.4-1,2018/12/12,76,50,93,26,12,257
kasmweb/ubuntu-focal-dind-rootless,1.14.0,2023/09/14,220,494,13,0,0,727
rancher/eks-operator,v2.0.1-rc1,2021/04/27,105,226,30,0,0,361
greenbone/vulnerability-tests,202311150559,2023/11/15,null
balenalib/orbitty-tx2-debian-python,20231106,2023/11/07,114,22,27,4,0,167
jetbrains/qodana,2022.2-eap,2022/10/26,75,156,12,2,0,245
airbyte/airbyte-base-java-image,2.0.3,2023/05/25,10,46,56,4,1,117
balenalib/odroid-c1-ubuntu-node,20220715,2022/07/19,88,103,12,0,0,203
datadog/lambda-extension,50,2023/11/02,0,0,1,0,0,1
mattermost/mattermost-elasticsearch-docker,7.17.3,2022/05/02,184,388,26,0,0,598
balenalib/hummingboard-ubuntu,20230904,2023/09/09,42,9,4,0,0,55
balena/i386-supervisor-node,1244-update-lock-weirdness,2020/03/31,721,608,598,76,9,2012
balenalib/artik533s-fedora,20220714,2022/07/23,null
airbyte/source-sap-fieldglass,0.1.0,2022/11/11,0,17,25,1,0,43
airbyte/integration-base-java,20230210,2023/02/10,28,110,188,13,1,340
docker/sso-sample-extension,0.0.2,2023/07/11,0,8,2,3,0,13
onlyoffice/4testing-ds-docservice-de,6.2.0-eu-r2,2021/03/04,536,493,32,3,0,1064
balenalib/intel-nuc-fedora-python,20231103,2023/11/04,null
balenalib/artik10-ubuntu-node,20220715,2022/08/02,88,82,12,0,0,182
rancher/rio-autoscaler,v0.1.6,2019/12/23,2,12,29,4,0,47
puppet/r10k,3.15.2,2022/10/05,1,27,22,4,0,54
balenalib/jetson-tx2-golang,20231106,2023/11/07,442,81,51,5,0,579
vmware/resource-checker-toolchain,0.2.1,2018/12/18,18,190,245,105,0,558
airbyte/normalization-oracle,0.4.3,2023/05/12,664,428,405,59,17,1573
jetbrains/qodana-python-community,2023.2,2023/09/06,142,59,66,11,0,278
docker/node-agent-k8s,1.1.2,2019/04/12,50,41,2,0,0,93
okteto/coder-python,dev,2020/04/25,1134,726,885,112,11,2868
grafana/cortex-blocksconvert,r111-453cbfce3,2020/11/03,2,18,47,4,0,71
balenalib/artik5-golang,20220714,2022/07/22,473,263,219,28,1,984
balenalib/rpi-openjdk,8-20190705,2019/07/06,155,187,175,34,12,563
balenalib/i386-nlp-ubuntu-python,20210225,2021/04/20,121,246,17,0,0,384
airbyte/source-google-adwords-singer,0.2.6,2021/07/07,143,97,110,34,7,391
okteto/openfaas,golang,2020/06/12,727,618,550,80,9,1984
onlyoffice/4testing-docspace-telegram-service,test-2022112110,2022/11/21,1010,307,327,19,0,1663
graphcore/popart-minimal,3.3.0,2023/07/03,137,174,23,0,0,334
grafana/metrics-enterprise,v2.10.4,2023/11/14,0,2,2,0,0,4
airbyte/destination-scylla,0.1.3,2022/08/09,76,76,62,19,0,233
pachyderm/pachd,2.8.0-rc.2,2023/11/13,0,6,4,0,0,10
rancher/change-nodetemplate-owner,319,2023/11/15,30,3,0,0,0,33
balenalib/ts4900-fedora-openjdk,30-20210825,2021/09/03,null
datadog/fips-proxy,0.6.1,2023/10/26,19,7,0,0,0,26
balenalib/asus-tinker-board-s-openjdk,20230911,2023/09/12,129,65,42,6,0,242
balenalib/armv5e-openjdk,20200221,2020/02/29,259,276,212,44,8,799
bitnami/blackbox-exporter,0.24.0,2023/11/08,74,16,8,2,0,100
balenalib/orbitty-tx2-fedora-node,20231106,2023/11/06,0,1,1,0,0,2
kong/kuma-dp,2.4.4,2023/11/06,7,4,5,0,0,16
newrelic/cluster-api-controller,79dda1d3,2019/07/01,0,0,0,0,6,6
kasmweb/qbittorrent,1.14.0,2023/09/14,201,393,0,0,0,594
rancher/hardened-cilium-iproute2,4c18d06f1d545ed6fde810c2b97935dc8938ddc8-build20210521,2021/05/21,536,476,29,3,0,1044
ambassador/ambassador-agent,1.0.21,2023/11/10,0,6,7,0,0,13
kong/kong-gateway-dev,20231113-2,2023/11/13,22,3,0,0,0,25
vmware/ovs-secure-toolchain-photon,1.0.0,2018/06/23,21,215,224,93,0,553
bitnami/nginx,1.25.3,2023/11/09,74,13,6,2,0,95
rancher/mirrored-elemental-operator,1.3.4,2023/09/12,null
rancher/heapster-influxdb-amd64,v1.3.3,2017/09/05,null
airbyte/source-hubspot-singer,0.2.0,2021/03/03,105,71,79,31,7,293
atlassian/pipelines-dvcstools,1.13,2016/11/17,1,59,35,18,0,113
datadog/agent,7.50.0-rc.2,2023/11/14,10,1,2,0,0,13
circleci/container-agent,3.0,2023/03/30,0,13,3,0,0,16
mattermost/rtcd-daily,v0.11.0,2023/06/22,0,2,1,0,0,3
amazon/aws-node-termination-handler,4a12725,2019/11/26,0,8,14,0,0,22
circleci/frontend,0.2.33217-7008444,2023/10/13,46,33,1,0,0,80
rancher/cluster-register,v0.1.0,2017/09/19,null
rancher/jettech-kube-webhook-certgen,v1.5.0,2020/10/29,0,13,16,2,6,37
rancher/opni-agent,0.12.1-rc1,0001/01/01,null
airbyte/np-src,dev,2021/05/21,0,6,27,4,0,37
cimg/gcp,2023.09.1,2023/09/07,302,354,51,0,0,707
docker/runc-arches,v1.0.0-rc5.x86_64,2018/08/07,null
objectscale/geo-receiver,0.71.3,2021/04/15,15,108,128,15,6,272
balenalib/up-board-debian-openjdk,20230712,2023/07/16,null
balenalib/fincm3-fedora-golang,20220523,2022/06/04,null
bitnami/elasticsearch-exporter,1.6.0,2023/11/08,74,15,7,2,0,98
rancher/harvester-load-balancer-webhook,v0.2.2,2023/08/29,1,6,8,0,1,16
balenalib/orangepi-plus2-alpine-python,20231106,2023/11/07,0,3,2,0,0,5
rancher/k8s-dns-kube-dns-amd64,1.15.0,2018/11/12,0,0,0,2,0,2
grafana/k6,0.47.0,2023/10/10,0,4,4,0,0,8
rancher/flannel-cni,v0.3.0-rancher9-linux-arm64,2023/08/29,null
appdynamics/appdynamics-cloud-k8s-monitoring,23.10.0-1780,2023/10/23,1,13,9,0,0,23
ambassador/aes-wafsvc,v4.0.0-preview.2.dev.1,2023/10/27,0,1,1,0,0,2
objectscale/influxdb-operator,0.52.0,2019/07/30,null
snyk/kubernetes-monitor,2.4.17,2023/11/07,0,7,2,0,0,9
astronomerinc/ap-node-exporter,1.6.1,2023/07/17,0,2,1,0,0,3
google/apigee-prometheus-adapter,v0.9.1,2021/10/15,0,4,12,1,0,17
rapidfort/airflow-worker,2.5.1,2023/04/09,42,48,30,9,0,129
amazon/aws-sam-cli-emulation-image-java8,20220125,2022/01/25,6,122,115,32,1,276
balenalib/imx6ul-var-dart-fedora-golang,20221210,2022/12/13,null
hashicorp/nomad,1.7.0-beta.1,2023/11/01,0,2,1,0,0,3
formio/mongotest,1.0.0,2020/07/16,4,27,53,7,0,91
balenalib/hummingboard-debian-openjdk,20230904,2023/09/09,129,65,42,6,0,242
qualys/redis-client-for-jira-integration,1.2.0,2023/09/29,0,2,2,0,0,4
rancher/os-alpineconsole,v1.5.8,2021/02/05,5,8,9,1,0,23
hashicorp/consul-k8s-control-plane,1.3,2023/11/07,0,6,2,0,0,8
atlassian/pipelines-agent-metric-sidecar,stg-stable,2019/11/12,114,136,137,41,8,436
balenalib/via-vab820-quad-debian-golang,20220714,2022/07/28,473,260,213,28,1,975
bellsoft/liberica-openjdk-alpine,21.0.1-12,2023/11/14,0,2,2,0,0,4
amazon/aws-secrets-manager-secret-adm-controller,v0.1.5,2021/02/24,23,190,219,34,1,467
intel/rpbs_mips,1.0,2023/03/23,812,1165,61,0,0,2038
kasmweb/fedora-38-desktop,1.14.0,2023/09/14,0,3,2,0,0,5
snyk/snyk-kubernetes-operator,discardable-59116385da844f3bc116c77c893f24e55d019d20,2020/02/17,130,317,58,2,0,507
mattermost/mattermost-apps-cloud-deployer,8951213,2023/03/20,4,35,23,3,0,65
balenalib/bananapi-m1-plus-alpine-node,18.14.1-20231106,2023/11/07,0,3,3,0,0,6
puppet/pdk,3.0.0.0,2023/07/04,37,37,3,0,0,77
balenalib/beaglebone-green-fedora,20221109,2022/12/04,null
datadog/cluster-agent-dev-arm64,7-27-0-snmp-batch-size-config,2021/04/09,8,26,20,2,0,56
docker/ucp-istio-node-agent-k8s,3.3.1,2020/05/09,472,1165,148,0,0,1785
intel/esp-git,v3.1.2,2023/07/25,null
airbyte/source-airtable,4.1.5,2023/10/19,64,22,6,1,0,93
vmware/event-service-toolchain-photon,1.0.4,2019/02/21,59,267,266,102,0,694
bitnami/parse,6.3.1,2023/10/24,79,32,8,4,0,123
airbyte/destination-oracle-strict-encrypt,0.2.0,2023/06/29,34,145,243,30,1,453
balenalib/nitrogen6x-fedora-python,20220622,2022/07/12,0,1,1,0,0,2
grafana/cortex-table-manager,w37-0193e7b7,2018/09/11,0,0,0,2,0,2
balenalib/armv7hf-openjdk,20230929,2023/10/02,122,65,37,6,0,230
balenalib/imx6ul-var-dart,20230911,2023/09/11,118,37,38,6,0,199
okteto/pipeline-runner,1.0.3,2023/06/26,155,39,25,10,3,232
balenalib/intel-nuc-debian-python,20231106,2023/11/06,114,22,27,4,0,167
kumahq/kuma-injector,0.5.0-rc2,2020/04/27,2,8,7,1,0,18
rancher/kubernetes-dashboard,v0.0.1,2017/05/03,null
balenalib/parallella-fedora-node,36-build-20230530,2023/06/29,0,1,1,0,0,2
okteto/django,okteto,2020/03/24,1463,1769,1413,181,37,4863
continuumio/miniconda2,4.7.12,2019/10/16,217,215,281,60,10,783
pachyderm/kafka_spout,1.11.2,2020/08/28,165,396,405,66,12,1044
balenalib/colibri-imx6dl-debian-golang,20220714,2022/07/28,473,260,213,28,1,975
pachyderm/kubeflow_demo_trigger,v1.0.0,2020/04/10,0,19,0,0,0,19
kumahq/kuma-tcp-echo,0.4.0,2020/02/28,2,8,9,1,0,20
rancher/cert-manager-acmesolver,v0.11.0-rio.1,2019/10/22,0,0,0,0,6,6
redislabs/ng-redis-raft,966152886c0a5744ad6406b064d53aac4f20f04d,2023/01/20,71,26,23,2,0,122
rapidfort/apache-official,2.4.58-alpine3.18,2023/10/19,0,2,2,0,0,4
airbyte/source-apple-search-ads,0.1.1,2023/07/11,0,15,25,1,0,41
datadog/libddwaf,toolchain,2023/08/11,357,140,71,9,0,577
onlyoffice/docs-docservice,7.5.1-1,2023/11/09,0,0,1,1,0,2
rancher/pre-pull-images,v0.2.2,2018/06/01,306,388,24,0,0,718
airbyte/source-twitter,0.1.2,2023/03/07,0,16,25,1,0,42
balenalib/artik10-debian-python,20220714,2022/07/22,124,70,74,18,0,286
balenalib/kitra710-debian-golang,20230904,2023/09/09,448,112,72,9,0,641
intel/trusted-attestation-controller,0.4.0,2022/11/08,11,30,25,0,0,66
balenalib/colibri-imx6dl-ubuntu-python,20220622,2022/06/23,87,112,13,0,0,212
balenalib/orangepi-plus2-ubuntu,20231026,2023/11/02,37,8,0,0,0,45
jetbrains/runtime,ubuntu1804_arm64v8_clang,2021/06/22,1051,1447,143,3,1,2645
grafana/grafana-enterprise-image-tags,10.3.0-63462-arm64,2023/11/15,0,2,2,0,0,4
objectscale/influxdb,0.33.0,2020/07/06,5,53,67,6,2,133
docker/ucp-s390x,3.1.0-beta3,2018/10/04,0,2,6,16,0,24
continuumio/nginx-ingress-ws,1.5.2,2019/07/31,145,164,114,42,8,473
astronomerinc/ap-prisma,1.34.8,2020/04/08,2,19,59,26,0,106
mongodb/mongodb-enterprise-server,7.0.3-ubuntu2204-20231115T085919Z,2023/11/15,142,137,0,0,0,279
balenalib/raspberrypi3-debian-openjdk,20230530,2023/07/04,143,73,44,6,0,266
rancher/kube-proxy,v1.18.8,2020/08/28,462,468,22,3,0,955
google/apigee-cert-manager-cainjector,v0.12.0,2019/11/28,0,0,0,0,6,6
pachyderm/sqs-spout,1.9.8,2019/11/13,552,1488,1164,245,14,3463
rancher/hardened-multus-cni,v3.6,2021/02/23,243,346,38,3,0,630
airbyte/source-harness,0.1.0,2023/10/23,0,13,24,1,0,38
balenalib/artik533s,20220714,2022/07/22,124,69,72,18,0,283
kasmweb/core-opensuse-15,1.14.0,2023/09/09,5,20,29,0,1,55
mirantis/ucp-istio-proxyv2,3.4.15,2023/05/11,471,1159,140,1,0,1771
mattermost/focalboard,7.11.4,2023/09/26,97,47,44,12,6,206
okteto/dev,go1.17,2021/09/23,221,490,33,0,0,744
hashicorp/nomad-pack,0.1,2023/11/01,null
bitnami/cert-manager-webhook,1.13.2,2023/11/08,74,13,6,2,0,95
grafana/docker-puppeteer,1.1.0,2022/07/28,240,209,153,29,6,637
rancher/dns,v0.17.4,2018/07/09,306,388,24,0,0,718
astronomerinc/ap-postgres-exporter,3.14.2-1,2021/10/06,0,13,37,1,0,51
amazon/aws-sam-cli-emulation-image-python2.7,20220125,2022/01/25,6,129,91,15,1,242
rancher/calico-pod2daemon-flexvol,v3.18.1,2021/03/10,null
rancher/hardened-cilium-compilers,4c18d06f1d545ed6fde810c2b97935dc8938ddc8-build20210521,2021/05/21,906,1006,96,3,0,2011
balenalib/i386-nlp-python,20210225,2021/04/18,195,122,139,43,9,508
airbyte/source-bing-ads,1.13.0,2023/11/14,64,22,6,1,0,93
solaceiotteam/async-apim-admin-portal,0.4.5,2022/10/19,113,121,74,16,0,324
rancher/thanosio-thanos,v0.15.0,2020/09/07,5,24,19,0,0,48
datadog/synthetics-private-location-worker,1.41.0,2023/11/02,39,30,0,0,0,69
pachyderm/lb-interview,1.0,2022/05/27,0,12,14,1,0,27
rancher/vm-tools,v0.2.0,2018/12/21,472,657,44,0,0,1173
rancher/crictl,v1.19.0,2020/08/31,260,420,36,3,0,719
okteto/frontend,80907703,2023/02/03,4,57,36,4,0,101
bitnami/airflow-exporter,0.20220314.0,2023/11/08,74,14,6,2,0,96
bitnami/osclass,8.1.2,2023/10/11,152,92,53,5,0,302
balenalib/bananapi-m1-plus-fedora-node,36-build-20230530,2023/06/29,0,1,1,0,0,2
datadog/agent-buildimages-deb_arm64,v20433308-6861270,2023/09/25,3,24,19,0,0,46
qualys/crs-instrumenter,2.5.2.0-9,2022/09/28,0,4,15,0,0,19
rancher/istio-1.5-migration,0.1.1,2020/07/09,10,24,52,6,0,92
kasmweb/core-cuda-bionic,1.10.0,2022/06/07,234,883,20,0,0,1137
astronomerinc/ap-postgresql,15.4.0-1,2023/10/10,96,20,9,2,0,127
okteto/devtools,0.1.0,2019/01/19,710,1042,73,0,0,1825
airbyte/source-google-webfonts,0.1.0,2022/10/27,0,17,25,1,0,43
continuumio/ae-conda-packages,v3,2019/02/04,95,115,208,72,12,502
bitnami/photon-base-buildpack,4-r6,2023/06/16,5,62,35,5,0,107
objectscale/csi-resizer,v1.4.0,2022/01/21,0,4,7,0,0,11
newrelic/nr-otel-collector,0.6.0-rc,2023/11/13,0,3,3,0,0,6
vmware/clair,v2.0.1-photon,2017/11/23,11,78,117,69,0,275
balenalib/asus-tinker-board-s-debian-openjdk,20230911,2023/09/12,129,65,42,6,0,242
redislabs/redisgraph,2.12.10,2023/09/27,1,2,1,0,0,4
docker/ucp-coredns,3.3.1,2019/04/07,null
newrelic/nri-prometheus,2.19,2023/11/02,0,2,1,0,0,3
bitnami/prestashop,8.1.2,2023/10/11,149,87,70,6,0,312
balenalib/ts4900,20220714,2022/07/20,124,69,72,18,0,283
astronomerinc/ap-kibana,8.9.2,2023/10/31,21,13,1,1,0,36
balenalib/artik533s-ubuntu-node,20220715,2022/08/02,88,82,12,0,0,182
grafana/synthetic-monitoring-agent,v0.0.3,2020/08/26,98,72,79,22,6,277
circleci/cci-demo-go-primary,0.0.2,2017/03/15,209,611,633,166,36,1655
objectscale/objectscale-oktool,0.1.0-146.7ccfc1e,2023/04/20,7,60,58,4,6,135
balenalib/artik533s-openjdk,20220714,2022/07/22,157,128,83,18,0,386
redhat/ubi8-minimal,8.8-1072,2023/09/13,60,26,4,0,0,90
couchbase/analytics-demo,5.0.0-671,2017/08/22,83,79,7,0,0,169
pachyderm/pachtf,2.2.8,2022/08/18,0,13,15,0,0,28
bitnami/haproxy,2.8.3,2023/11/09,74,19,10,4,0,107
rapidfort/grafana-ib,9.5.3,2023/07/04,22,30,8,0,0,60
kasmweb/maltego,1.14.0,2023/09/14,193,396,0,0,0,589
okteto/python-getting-started,1.0.1,2023/02/27,77,32,25,2,0,136
formio/formio-enterprise,8.4.0-rc.24,2023/11/13,0,5,0,2,0,7
airbyte/source-aha,0.3.1,2023/06/05,0,15,25,1,0,41
balenalib/armv5e-debian-python,20191011,2019/10/29,185,171,172,35,8,571
rancher/rio-build,48f64897,2018/08/02,881,1348,105,0,0,2334
appdynamics/python-agent-init,5686,2023/02/06,0,10,8,0,0,18
astronomerinc/ap-po-logical-backup,1.8.1,2022/07/18,78,204,5,0,0,287
objectscale/remote-access,2.0.51,2020/09/29,61,118,171,23,0,373
portainer/config-manager,2.19.1,2023/09/27,null
rancher/opni-manager,v0.4.0,2022/04/01,5,56,36,3,14,114
docker/highland_builder,3979.0.0-stable,2023/06/20,0,8,4,4,0,16
okteto/supervisor,1.0.0,2021/04/16,0,1,0,0,0,1
airbyte/destination-gcs,0.4.4,2023/07/15,34,138,241,30,1,444
mongodb/mongodb-atlas-kubernetes-operator,2.0.0,2023/11/15,3,3,0,0,0,6
balenalib/up-board-debian-golang,20230712,2023/07/16,null
amazon/aws-sam-cli-emulation-image-provided.al2,20220125,2022/01/25,13,76,65,19,1,174
airbyte/source-chartmogul,1.0.0,2023/11/09,0,13,24,1,0,38
percona/percona-mysql-router,8.0.34,2023/09/15,225,56,13,0,0,294
balena/i386-nlp-supervisor,v10.11.3,2020/04/02,0,6,8,3,0,17
docker/volumes-backup-extension,1.1.4,2023/06/12,0,18,6,0,0,24
balenalib/ts4900-python,20220604,2022/06/12,124,82,74,20,0,300
google/apigee-envoy,v1.22.2,2022/06/10,11,18,10,2,0,41
intel/telemetry-aware-scheduling,0.6.0,2023/07/12,0,2,1,0,0,3
airbyte/source-clickup-api,0.1.1,2023/03/21,0,16,25,1,0,42
kasmweb/deluge,1.14.0,2023/09/14,194,380,0,0,0,574
newrelic/cluster-api-controller-arm,mv1a,2019/04/17,0,0,0,0,6,6
percona/dcos-mongo-tools,0.2.1,2018/07/02,null
docker/dtr-postgres-s390x,2.5.0-beta3,2018/01/17,0,15,26,5,0,46
amazon/aws-sam-cli-emulation-image-nodejs10.x,20220125,2022/01/25,5,35,33,13,1,87
onlyoffice/documentserver,7.5.1.1,2023/11/05,123,91,1,1,0,216
bellsoft/buildpacks.alpaquita-run,musl,2023/04/04,null
bitnami/telegraf,1.28.4,2023/11/13,74,13,6,2,0,95
rancher/calico,v3.13.3,2020/08/26,468,517,88,4,0,1077
bitnami/os-shell,11,2023/11/09,84,15,13,4,0,116
airbyte/source-youtube-analytics,0.1.4,2023/05/26,0,15,25,1,0,41
pachyderm/etcd,v3.5.5,2022/09/15,71,40,56,9,0,176
bitnami/wavefront-prometheus-storage-adapter-archived,1.0.7,2023/06/17,74,27,17,2,0,120
bitnami/nats,2.10.5,2023/11/10,74,13,6,2,0,95
greenbone/gvmd-build,23.1,2023/11/14,492,117,74,10,0,693
airbyte/airbyte-webapp,0.30.8-alpha-cloud-stage,2021/10/03,6,29,52,9,0,96
qualys/jira-client-for-jira-integration,1.2.0,2023/10/13,0,6,4,0,0,10
vmware/photon-2.0-kube-controller-manager-amd64,v1.10.2-20180619,2018/06/19,15,81,98,70,0,264
intel/intel-optimized-tensorflow-serving-avx512,2.8.0,2022/03/29,61,40,2,0,0,103
airbyte/normalization-clickhouse,0.4.3,2023/05/12,467,221,191,16,0,895
balenalib/imx6ul-var-dart-node,20230911,2023/09/12,118,39,39,6,0,202
grafana/cortex,single-binary-676071aa3-WIP-2,2019/05/09,0,0,0,2,0,2
percona/percona-postgresql-operator,2.2.0,2023/06/09,35,37,9,0,0,81
balena/open-balena-registry,2.39.27,2023/11/12,344,88,60,5,2,499
balenalib/apalis-imx6q-golang,20220714,2022/07/28,473,260,213,28,1,975
lacework/code-security-pipe,1.2.8,2023/10/30,58,56,22,1,0,137
atlassian/dynamodb-elasticsearch-indexer,3.0.10,2021/05/18,237,163,186,54,10,650
objectscale/rsyslog,0.54.0,2020/11/10,6,64,67,5,3,145
airbyte/source-close-com,0.4.3,2023/11/10,64,8,2,1,0,75
mattermost/node-rotator,11c4803,2023/05/25,0,12,3,3,0,18
kong/konnect-migration,debug,2022/10/12,77,41,42,3,0,163
ngrok/ngrok,3,1970/01/01,97,36,46,13,6,198
rancher/mirrored-coreos-flannel,v0.15.1,2021/11/12,2,16,27,3,0,48
balenalib/ts4900-alpine-python,20220714,2022/07/19,7,38,35,10,0,90
rancher/os-hypervvmtools,v1.5.8,2021/02/05,100,38,50,16,6,210
airbyte/source-sentry,0.3.0,2023/09/19,0,15,24,1,0,40
google/apigee-asm-ingress,1.12.9-asm.3,2022/09/30,15,11,12,0,0,38
balenalib/artik5-debian-python,20220714,2022/07/22,124,70,74,18,0,286
airbyte/destination-tidb,0.1.4,2023/06/23,36,150,252,32,1,471
balenalib/generic-aarch64-debian-openjdk,20231106,2023/11/07,125,44,29,4,0,202
rapidfort/gitlab-ce,latest-rfstub,2022/09/19,59,189,177,3,0,428
rancher/hardened-node-feature-discovery,v0.14.1-build20230926,2023/09/26,0,12,20,0,0,32
docker/dtr-jobrunner-s390x,2.5.0-beta3,2018/01/17,3,56,103,50,0,212
balenalib/zynq-xz702-fedora,20220604,2022/06/12,null
intel/oact-rps,v2.19.1,2023/11/01,0,2,0,0,0,2
kong/deck,v1.29.2,2023/11/08,0,2,2,0,0,4
docker/reefer,0.0.5,2018/08/09,0,0,0,2,0,2
astronomerinc/ap-pgbouncer,1.20.1-1,2023/11/02,0,3,0,0,0,3
adobecoldfusion/apimanager,latest-2023,2023/05/17,40,92,98,40,0,270
balena/open-balena-registry-proxy,5.0.23,2023/10/18,112,28,20,1,0,161
appdynamics/ad-air-java-services,netviz5,2021/01/26,107,121,105,32,0,365
mathworks/matlab,r2023b,2023/10/27,194,202,8,0,0,404
balenalib/raspberrypi3-ubuntu,20231026,2023/11/02,37,8,0,0,0,45
airbyte/source-kyve,0.1.0,2023/06/14,0,13,17,0,0,30
google/apigee-deployment-controller,1.1.1,2020/02/05,0,0,0,0,6,6
mirantis/ucp-hyperkube,3.7.1,2023/09/26,35,58,46,0,0,139
balenalib/ts4900-ubuntu-node,20220715,2022/07/19,88,103,12,0,0,203
balenalib/kitra520-alpine-python,20220803,2022/08/04,7,38,35,10,0,90
balenalib/nitrogen6x-debian-golang,20220714,2022/07/28,473,260,213,28,1,975
balenalib/raspberry-pi2-ubuntu-node,20231026,2023/11/02,38,9,1,0,0,48
portainer/golang-builder,cross-platform-next,2018/05/20,200,462,503,111,15,1291
intel/esp-uos-firmware-lan,v3.1.2,2023/07/25,null
appdynamics/orchestration-client,23.8.0-721,2023/08/24,0,7,5,0,0,12
grafana/mimirtool,2.10.4,2023/11/13,0,2,2,0,0,4
rancher/os-volumenetshare,v1.5.8,2021/02/05,2,17,37,4,0,60
balenalib/orbitty-tx2-golang,20231106,2023/11/07,442,81,51,5,0,579
balenalib/odroid-xu4-alpine-node,18.14.1-20231106,2023/11/07,0,3,3,0,0,6
rancher/mirrored-cilium-cilium-envoy,v1.26.6-ff0d5d3f77d610040e93c7c7a430d61a0c0b90c1,2023/10/29,19,7,0,0,0,26
rapidfort/rabbitmq,3.12.6,2023/10/17,49,12,11,3,0,75
balenalib/odroid-c1-ubuntu,20220714,2022/08/02,87,81,11,0,0,179
bitnami/cainjector,1.13.2,2023/11/08,74,13,6,2,0,95
puppet/puppet-agent-alpine,7.15.0,2022/03/23,2,8,6,0,0,16
newrelic/newrelic-istio-adapter,2.0.3,2020/08/24,2,15,19,1,0,37
balenalib/orangepi-plus2-debian-python,20230911,2023/09/11,118,38,38,6,0,200
grafana/loki-bigtable-backup,master-9930f704,2019/08/02,4,22,11,2,0,39
bitnami/redhatubi-base-buildpack,9-r4,2023/06/21,310,205,33,0,0,548
lacework/lacework-cli,v1.38.0,2023/11/09,0,3,3,0,0,6
rapidfort/redis-official,7.2.3-bookworm,2023/11/04,23,3,1,0,0,27
newrelic/k8s-nri-cassandra,2.2.0.1,2019/09/09,102,67,25,0,0,194
grafana/mimir,2.10.4,2023/11/13,0,2,2,0,0,4
redislabs/rejson,99.99.98,2023/10/09,72,19,16,2,0,109
rancher/goharbor-harbor-core,v1.7.5,2019/04/01,14,63,88,37,0,202
mirantis/dtr-jobrunner,3.0.0-alpha.2,2021/09/22,7,65,90,18,0,180
mirantis/ucp-proxy,1.1.6,2017/01/18,0,42,21,8,0,71
rancher/calico-ctl,v3.19.2,2021/08/03,0,6,9,2,0,17
rancher/git-serve,v0.7.0,2020/01/02,238,443,21,0,0,702
rapidfort/kong,3.0.0-ubuntu,2023/02/09,null
balenalib/odroid-xu4-openjdk,20230911,2023/09/11,129,65,42,6,0,242
ambassador/telepresence-docker-desktop-extension,0.0.8-alpha.2,2022/04/13,0,12,21,0,0,33
greenbone/cert-bund-data,202311150421,2023/11/15,null
docker/desktop-kubeconfig-merge,v1.1,2020/04/15,0,6,10,0,0,16
pachyderm/pachd-amd64,97276071e371d5b1ea221437e99cfd87b5599ddf,2023/11/03,0,6,4,0,0,10
airbyte/source-zendesk-chat,0.2.1,2023/10/20,64,22,6,1,0,93
couchbase/centos-69-sdk-build,20180806,2018/08/07,1611,2022,256,7,0,3896
balenalib/i386-nlp-alpine,20191223,2021/04/17,2,0,0,1,0,3
rancher/kubernetes-agent,v0.7.0,2017/09/28,312,392,24,0,0,728
pachyderm/bench,9485135059f9153350ad33a5928fe0b966502b8e,2017/04/27,65,106,17,0,0,188
airbyte/source-linkedin-ads,0.6.4,2023/10/19,64,22,6,1,0,93
balenalib/stem-x86-32-debian-python,20230904,2023/09/09,118,38,38,6,0,200
hashicorp/consul-k8s-control-plane-fips,1.3,2023/11/07,32,23,5,0,0,60
rancher/mirrored-banzaicloud-fluentd,v1.14.6-alpine-5,2022/05/25,4,42,34,6,0,86
docker/vpnkit-tap-vsockd,328ace386c62036c2a045744eeff20e46312d20a,2018/09/04,0,0,0,2,0,2
rancher/mirrored-neuvector-manager,5.2.3,2023/11/10,0,2,0,0,0,2
balenalib/apalis-imx6q-fedora,20220604,2022/06/12,null
balenalib/intel-nuc-python,20231106,2023/11/06,114,22,27,4,0,167
grafana/cortextool,v0.2.4,2020/08/12,3,20,20,0,0,43
balenalib/via-vab820-quad-debian-node,18.6-20220714,2022/07/21,124,71,73,18,0,286
bitnami/jwt-cli,6.0.0,2023/10/09,74,13,6,2,0,95
mongodb/mongo-cxx-driver,3.9.0-redhat-ubi-9.3,2023/11/09,19,14,0,0,0,33
rancher/mirrored-longhornio-livenessprobe,v2.9.0,2022/12/28,0,3,3,0,0,6
rancher/fleet-agent,v0.9.0,2023/11/07,2,12,17,0,3,34
intel/smart-city_solution,2021.4.2,2021/12/14,277,822,39,0,0,1138
docker/tilt,v0.33.6,2023/09/29,111,33,25,6,0,175
mattermost/mattermost-preview,9.1.1,2023/11/01,108,19,12,1,0,140
intel/dlstreamer,2023.0.0-ubuntu22-gpu682-dpcpp,2023/10/02,257,379,19,0,0,655
balenalib/apalis-imx6q-alpine-node,20220714,2022/07/19,7,38,34,10,0,89
balenalib/orbitty-tx2-alpine,20231106,2023/11/06,0,2,2,0,0,4
astronomerinc/ap-db-bootstrapper,0.31.7,2023/11/08,0,4,0,0,0,4
rancher/hardened-sriov-network-resources-injector,v1,2021/02/23,240,336,38,3,0,617
lacework/ghactions,6.0,2023/06/14,2,23,12,5,0,42
balenalib/odroid-xu4-node,20230911,2023/09/11,118,39,39,6,0,202
vmware/lightwave-base,1.0.0,2020/03/13,28,117,137,48,0,330
hashicorp/vault,1.15.2,2023/11/06,0,3,2,0,0,5
appdynamics/appd-oc-otel-collector,22.1.0,2022/01/31,0,5,9,0,0,14
objectscale/csi-baremetal-pre-upgrade-crds,1.4.0-124.541af8d,2023/11/03,94,14,22,3,0,133
redislabs/redis-connect-postgres,0.8.3-112,2022/03/04,5,29,39,13,0,86
mattermost/mattermod-jobserver,0.18.0,2023/10/11,28,27,7,0,0,62
vmware/photon-2.0-calico-kube-policy-controller,v1.0.0-20180619,2018/06/19,15,72,90,57,0,234
nginx/nginx-ingress-operator,2.0.2,2023/11/02,62,34,9,0,0,105
kasmweb/firefox,1.14.0,2023/09/14,185,396,0,0,0,581
opensearchproject/opensearch-benchmark,1.1.0,2023/08/10,473,141,95,10,0,719
grafana/openvas,20200716,2020/07/15,1043,1168,175,10,0,2396
airbyte/db,0.50.34,2023/11/09,0,2,2,0,0,4
bitnami/consul,1.17.0,2023/11/08,155,60,26,3,0,244
balenalib/revpi-core-3-golang,20230530,2023/06/27,385,58,46,8,0,497
newrelic/newrelic-prometheus-configurator,1.10.0,2023/11/13,0,2,2,0,0,4
balenalib/spacely-tx2-fedora,20231106,2023/11/06,null
balenalib/bananapi-m1-plus-openjdk,20230904,2023/09/09,129,65,42,6,0,242
docker/engine-community-arches,18.09.0-ce-tp6.test.x86_64,2018/09/05,null
balenalib/generic-aarch64-node,20231106,2023/11/07,114,23,28,4,0,169
bitnami/gitea,1.20.5,2023/11/09,100,20,27,5,0,152
hashicorp/vault-csi-provider,1.4.1,2023/10/26,0,2,2,0,0,4
rapidfort/haproxy-official,2.9-dev8-bullseye,2023/11/01,20,4,0,0,0,24
airbyte/destination-duckdb,0.3.0,2023/10/24,64,22,6,1,0,93
rancher/mirrored-library-registry,2.8.1,2023/05/10,0,10,2,3,0,15
cockroachdb/charts-builder,20200702-210440,2020/07/03,223,226,227,82,8,766
ubuntu/loki,2.8.4-22.04,2023/10/05,22,27,14,0,0,63
balenalib/artik10-alpine-node,20220803,2022/08/04,7,38,34,10,0,89
airbyte/source-exchangeratesapi-singer-abprotocol,0.1.2,2020/10/20,112,81,85,31,7,316
rancher/mirrored-sigwindowstools-k8s-gmsa-webhook,v0.3.0,2021/11/01,0,4,6,0,0,10
rancher/system-agent-installer-rancher,v2.8.0-rc3,2023/10/26,0,7,3,0,0,10
airbyte/destination-yugabytedb,0.1.1,2023/03/17,34,148,245,30,1,458
bitnami/grafana-tempo-vulture,2.3.0,2023/11/08,74,13,6,2,0,95
airbyte/source-firebase-realtime-database,0.1.0,2022/12/15,3,18,28,1,0,50
rancher/server,v2.0.0-beta4,2018/04/25,9,26,2,0,0,37
balenalib/zynq-xz702-node,18.6-20220714,2022/07/21,124,71,73,18,0,286
rancher/goharbor-nginx-photon,v1.7.5,2019/04/01,14,67,85,37,0,203
circleci/docker-coreos-toolbox-ubuntu,0.1,2019/10/25,133,136,6,0,0,275
bellsoft/liberica-openjdk-debian,21.0.1-12,2023/11/14,105,18,18,4,0,145
amazon/aws-sam-cli-emulation-image-python3.8,20220125,2022/01/25,5,31,20,10,1,67
mattermost/inbucket,release-1.2.0,2017/12/27,0,5,0,0,0,5
intel/its-query-rest,master-ae213cd97d6931b1d44fc7689867cf5701e0f15d,2023/09/24,65,31,19,14,0,129
apachepinot/trino,396-SNAPSHOT-amd64,2022/09/15,135,270,157,37,0,599
rancher/os-framework,55951fe-amd64,2021/10/09,18,174,159,7,9,367
accurics/terrascan_atlantis,1.14.0,2022/04/01,11,145,210,27,0,393
amazon/aws-lambda-dotnet,7.2023.11.12.09,2023/10/25,0,1,2,1,0,4
bitnami/kubeapps-kubeops-archived,2.5.1,2022/10/04,1,5,8,0,0,14
vmware/admiral,v1.5.2,2019/03/11,36,104,156,60,0,356
balenalib/nitrogen6x-alpine,20220714,2022/07/19,7,37,33,10,0,87
balenalib/ts4900-fedora-golang,20220507,2022/05/12,null
balenalib/ts4900-debian-openjdk,20210602,2021/06/05,230,233,143,39,8,653
airbyte/worker,0.50.34,2023/11/09,12,53,61,4,1,131
google/apigee-kube-rbac-proxy,v0.13.0,2022/09/20,0,3,10,1,0,14
intel/power-node-agent,v2.3.1,2023/08/28,0,3,2,0,0,5
airbyte/source-persistiq,0.2.0,2023/10/20,0,13,24,1,0,38
balenalib/hummingboard-ubuntu-python,20230904,2023/09/09,42,10,4,0,0,56
cockroachdb/cockroach,v23.1.12,2023/11/13,62,18,0,0,0,80
mirantis/k8s-externalipcontroller,tets,2019/01/04,0,10,2,0,0,12
balenalib/orbitty-tx2-ubuntu-python,20231103,2023/11/06,37,9,0,0,0,46
bitnami/trivy,0.47.0,2023/11/09,74,13,6,2,0,95
rancher/mesos-slave,0.28.1,2016/05/24,235,326,17,0,0,578
atlassian/bamboo-agent-base,9.4.1,2023/11/07,68,81,2,3,0,154
pachyderm/pachctl,2.8.0-rc.2,2023/11/13,95,21,28,2,0,146
balenalib/bananapi-m1-plus-fedora-openjdk,30-20210825,2021/09/03,null
onlyoffice/docspace-wait-bin-share,1.1.4.1,2023/10/23,null
bitnami/openresty,1.21.4-3,2023/11/04,107,31,20,4,0,162
redhat/ubi9-init,9.3-5,2023/11/01,118,43,2,0,0,163
airbyte/source-reply-io,0.1.0,2022/11/10,0,17,25,1,0,43
bitnami/cassandra-exporter,2.3.8,2023/10/09,76,25,16,2,0,119
rancher/cert-manager-acmesolver-arm64,v0.7.2-rio.1,2019/05/15,0,0,0,2,0,2
balenalib/generic-armv7ahf-debian-node,20230904,2023/09/09,118,39,39,6,0,202
objectscale/ese-callback,2.71.3,2021/04/14,2,17,20,0,0,39
balenalib/orangepi-plus2-ubuntu-node,20231026,2023/11/02,38,9,1,0,0,48
balenalib/parallella-alpine-python,20230904,2023/09/09,2,3,5,2,0,12
balenalib/spacely-tx2-debian-node,20231106,2023/11/07,114,23,28,4,0,169
intel/intel-ethernet-operator-labeler,v1.0.0,2023/07/26,4,15,4,0,0,23
docker/ucp-compose,3.3.1,2020/06/26,4,6,2,0,0,12
airbyte/destination-sqlite,0.1.0,2022/08/09,0,18,25,1,0,44
astronomerinc/ap-grafana,10.2.0,2023/10/31,0,4,5,0,0,9
balenalib/beaglebone-black-alpine-golang,20231106,2023/11/07,0,2,2,0,0,4
airbyte/destination-jdbc,0.3.14,2022/06/17,80,103,142,61,0,386
balenalib/colibri-imx6dl-python,20220604,2022/06/12,124,82,74,20,0,300
lacework/lacework-docker-extension,0.1.18,2022/07/14,0,21,31,1,0,53
pachyderm/ci_code_bundle,23875,2021/06/03,6,0,0,0,0,6
onlyoffice/docspace-backup,1.1.4.1,2023/10/23,993,143,209,12,0,1357
kasmweb/teams,1.12.0,2022/12/01,356,1004,2,0,0,1362
ddosify/selfhosted_hammer,1.4.2,2023/07/18,0,14,9,1,0,24
balenalib/spacely-tx2-debian-python,20231106,2023/11/07,114,22,27,4,0,167
hashicorp/terraform-cloud-operator,2.0,2023/11/06,null
rancher/tekton-utils,v0.17-a3,2022/08/12,6,61,44,3,12,126
rancher/mirrored-k8scsi-csi-node-driver-registrar,v2.1.0,2020/12/18,0,5,9,0,5,19
balenalib/i386-ubuntu-openjdk,11-xenial-20230911,2023/09/11,null
objectscale/kube-metrics-adapter,3.7.0.0-1186.91aed4d8,2021/04/25,3,58,63,6,2,132
bitnami/python,3.12.0,2023/10/26,431,80,45,5,0,561
onlyoffice/mailserver,1.6.75,2020/08/04,2176,3488,150,8,0,5822
docker/cluster,v1.3.0,2020/04/20,10,38,36,2,0,86
bitnami/php-fpm,8.2.12,2023/11/15,151,82,50,5,0,288
bitnami/argo-workflow-controller,3.5.1,2023/11/08,0,1,0,0,0,1
atlassian/clientside-extensions,v0.4,2020/09/30,312,761,62,4,0,1139
balenalib/beaglebone-green-wifi-golang,20230911,2023/09/12,448,109,72,9,0,638
okteto/udemy,vote,2019/09/17,5,22,17,1,0,45
airbyte/source-gainsight-px,0.1.0,2023/07/13,0,15,25,1,0,41
redis/redis-stack,7.2.0-RC3,2023/07/10,27,16,2,0,0,45
intel/oact-rpc,v2.0.0,2021/09/15,74,65,4,0,0,143
rancher/goharbor-harbor-db,v1.7.5,2019/04/01,15,82,131,39,0,267
rancher/haproxy-cadvisor,v0.0.1,2016/06/11,0,27,24,10,0,61
rancher/cis-operator,v1.0.12,2023/06/08,0,5,3,0,1,9
grafana/grafana-ci-windows-test,0.1.0,2023/04/13,null
docker/ucp-auth-store-s390x,3.1.0-beta3,2018/10/04,0,0,4,8,0,12
amazon/aws-iot-greengrass,2.5.3-0-deprecated,2022/01/13,40,177,249,30,1,497
rancher/fluentd-helper,v0.1.2,2018/04/10,43,85,10,0,0,138
vmware/clair-photon,v2.0.1,2017/10/30,10,75,106,67,0,258
balenalib/beaglebone-green,20230911,2023/09/11,118,37,38,6,0,199
google/apigee-diagnostics-collector,1.8.1,2022/09/20,7,24,19,3,4,57
airbyte/source-younium,0.3.0,2023/10/25,65,24,6,1,0,96
kasmweb/core-centos-7,1.14.0,2023/09/09,1329,1307,58,0,0,2694
intel/oact-mpsrouter,v2.3.0,2023/09/20,null
grafana/devtools-github-event-aggregator,4160534dbc93f1bec6669c5a97edbbbf83cc3c52,2019/04/03,55,35,67,15,10,182
airbyte/airbyte-base-java-python-image,1.0,2023/06/22,19,68,75,9,0,171
portainer/compose-unpacker,latest-windows-amd64,2023/08/31,0,13,15,0,0,28
docker/dtr-notary-server-s390x,2.5.0-beta3,2018/01/17,0,16,41,34,0,91
intel/intel-gpu-initcontainer,0.28.0,2023/09/22,null
airbyte/integration-singer-stripe-source,0.1.2,2020/10/07,10,39,63,13,0,125
balenalib/aarch64-node,20231106,2023/11/07,107,23,22,4,0,156
grafana/netlify-cms-oauth-provider-go,51188a4,2019/06/21,4,14,9,3,0,30
airbyte/destination-milvus,0.0.9,2023/11/13,64,22,8,4,0,98
continuumio/ci-image,v27,2019/09/12,1213,1833,417,19,1,3483
vmware/nginx,1.11.5-patched,2017/04/07,55,157,175,66,22,475
bitnami/harbor-notary-server-archived,2.8.4,2023/09/15,83,178,227,2,0,490
balenalib/beaglebone-green-alpine-python,20231106,2023/11/07,0,3,2,0,0,5
bitnami/oauth2-proxy,7.5.1,2023/11/09,74,16,8,2,0,100
balenalib/i386-nlp-debian,20210225,2021/04/19,195,120,138,43,9,505
redislabs/cloud-api-build,1.0.0,2020/01/05,256,1614,39,8,0,1917
airbyte/source-asana,0.6.1,2023/11/13,64,8,2,1,0,75
google/apigee-prom-prometheus,v2.33.5,2022/03/08,4,26,18,0,0,48
mongodb/atlas,v1.31.0,2023/08/14,81,50,10,0,0,141
balenalib/orangepi-plus2-debian-golang,20230911,2023/09/11,448,109,72,9,0,638
accurics/siac-auth,1.3.14,2021/05/07,2,17,40,4,0,63
balenalib/artik530,20220714,2022/07/22,124,69,72,18,0,283
balenalib/asus-tinker-board-s-alpine-golang,20231106,2023/11/07,0,2,2,0,0,4
airbyte/keycloak-setup,0.50.34,2023/11/09,12,52,62,4,1,131
balenalib/beaglebone-green-golang,20230911,2023/09/11,448,109,72,9,0,638
mattermost/mattermost-app-chaosengine,150a153,2022/01/14,0,22,42,1,0,65
rancher/eks-controller,v0.1.0-rc14,2020/07/16,258,413,29,3,0,703
portainer/agent,2102,2018/07/31,null
rancher/mirrored-longhornio-csi-attacher,v4.2.0,2023/02/01,0,3,3,0,0,6
rapidfort/consul,1.16.2,2023/10/24,42,9,3,0,0,54
vmware/photon-2.0-nginx-ingress,v1.1.1-20180619,2018/06/19,15,78,98,58,0,249
bellsoft/buildpacks.maven,6.13.0,1980/01/01,null
rancher/secrets-bridge-v2,v0.3.2,2018/03/09,63,91,12,0,0,166
airbyte/source-intercom,0.3.1,2023/10/15,64,22,6,1,0,93
newrelic/test-oracle-db,11.2.0.2-xe,2020/08/31,4,131,30,3,0,168
balenalib/generic-aarch64-ubuntu,20231103,2023/11/06,37,8,0,0,0,45
bitnami/harbor-registry,2.9.1,2023/11/08,74,13,6,2,0,95
balenalib/artik5-alpine,20220803,2022/08/03,7,37,33,10,0,87
balenalib/aarch64-fedora-golang,20231106,2023/11/06,null
okteto/payroll,0.1,2019/06/06,47,99,149,50,10,355
sysdig/onprem_migration,events,2017/03/03,103,317,362,181,30,993
rancher/configmap-reload,v0.3.0-rancher4-windows-2004,2021/01/28,null
objectscale/blob-service,0.71.3,2021/04/15,16,142,194,36,3,391
bitnami/ghost,5.73.2,2023/11/15,91,57,37,8,0,193
hashicorp/vagrant-website,714860103532a0bc72678aafdc6e9769dede77c2ceeb76bcc8a6fa601e69e562,2020/10/08,11,86,117,24,0,238
accurics/cli-kubescan,1.0.41,2022/09/26,0,28,28,1,0,57
mirantis/dtr-content-cache,3.0.0-alpha.2,2021/09/22,1,10,36,3,0,50
rancher/mirrored-sonobuoy-sonobuoy,v0.57.0,2023/10/19,null
amazon/aws-secrets-manager-secret-sidecar,v0.1.4,2021/03/08,24,189,212,34,1,460
datadog/agent-buildimages-windows_20h2_x64,v3686353-1e75137,2021/01/12,8,49,134,12,0,203
balenalib/orangepi-plus2-fedora-openjdk,30-20210825,2021/09/03,null
hashicorp/consul-website,76497883ab408fa8fde43d9c554e73565874a46feb4549fc6ea97b2b20b204b7,2021/01/14,12,77,105,18,0,212
mirantis/ucp-auth,3.7.1,2023/09/07,3,2,8,2,0,15
bitnami/ubuntu-base-buildpack,22-r1,2022/09/07,306,566,74,0,0,946
airbyte/source-intercom-singer,0.2.3,2021/07/03,565,318,282,39,7,1211
rancher/opni-monitoring-ui-build,80424898df491ba46d6ace27167fd1d333577167,2023/04/26,null
balenalib/i386-alpine-node,16.19.1-20230911,2023/09/11,2,3,6,2,0,13
balenalib/beaglebone-black-ubuntu-python,20230911,2023/09/12,42,10,4,0,0,56
redislabs/redisearch,2.10.0,2023/09/11,72,21,16,2,0,111
rancher/hardened-cilium-bpftool,4c18d06f1d545ed6fde810c2b97935dc8938ddc8-build20210521,2021/05/21,76,70,3,0,0,149
balenalib/beaglebone-black-alpine-python,20231106,2023/11/07,0,3,2,0,0,5
airbyte/source-file,0.3.15,2023/10/19,143,20,16,3,0,182
docker/ucp-secureoverlay-mgr,3.3.1,2020/06/26,2,8,9,1,0,20
onlyoffice/4testing-docspace-clear-events,2.0.0.33,2023/11/15,993,142,206,12,0,1353
okteto/babel-maquetacion,0.1,2020/02/03,508,2250,1365,328,72,4523
rancher/k3s-upgrade,v1.28.3-k3s2-s390x,2023/11/08,0,14,4,0,0,18
rancher/banzaicloud-fluentd,v1.11.5-alpine-9,2021/01/19,12,46,107,15,0,180
docker/ucp-calico-node-s390x,3.1.0-beta3,2018/10/04,0,6,6,2,0,14
grafana/fluent-bit-plugin-loki,2.9.2,2023/10/25,28,30,21,2,0,81
okteto/remote-ssh,dev,2019/09/12,698,1020,73,0,0,1791
balena/amd64-supervisor,1299,2020/07/31,6,26,55,9,0,96
airbyte/source-primetric,0.1.0,2022/09/21,0,15,17,0,0,32
mattermost/perseus,v0.0.2,2023/01/12,0,0,1,0,0,1
balenalib/ts4900-debian,20220714,2022/07/20,124,69,72,18,0,283
balenalib/ts4900-ubuntu-openjdk,20210826,2021/09/04,136,435,10,0,0,581
kasmweb/ubuntu-jammy-dind-rootless,1.14.0,2023/09/14,270,417,44,0,0,731
balenalib/odroid-c1-alpine-node,20220714,2022/07/19,7,38,34,10,0,89
pachyderm/mnist_standalone,v1.0.0,2020/04/08,1485,1781,1422,184,37,4909
rancher/k8s-dns-node-cache,1.15.13,2020/05/09,82,41,46,17,2,188
mariadb/xpand-single,23.09.1,2023/09/18,550,515,32,3,0,1100
bitnami/grafana-mimir,2.10.3,2023/11/08,74,13,8,2,0,97
rancher/prom-node-exporter,v1.0.1,2020/06/16,0,5,10,0,0,15
hashicorp/packer-website,4620289a4b88df2b745e524720bb3a372978056f2f4ece0ec0bd790747fa42c1,2020/09/04,11,93,125,24,0,253
bitnami/keycloak,22.0.5,2023/10/24,89,22,17,4,0,132
balenalib/parallella-ubuntu-node,20230904,2023/09/09,43,10,5,0,0,58
airbyte/source-marketo-singer,0.2.3,2021/07/06,565,319,281,39,7,1211
balenalib/odroid-xu4-debian-node,20230911,2023/09/11,118,39,39,6,0,202
portainer/helper-reset-password,windowsltsc2022-amd64,2023/05/17,0,3,3,0,0,6
bitnami/node-exporter,1.7.0,2023/11/13,74,13,6,2,0,95
balenalib/spacely-tx2-ubuntu-golang,20231103,2023/11/06,139,131,0,0,0,270
mattermost/mattermost-build-server,5.6.0,2018/11/29,223,547,586,150,18,1524
mattermost/mm-mlh-hacktoberfest,0.0.1,2020/09/15,2,18,41,4,0,65
balenalib/qemux86-64-fedora-golang,20231103,2023/11/04,null
rapidfort/nats-official,2.9.22,2023/09/13,0,0,1,0,0,1
airbyte/source-ip2whois,0.1.0,2022/11/09,0,17,25,1,0,43
balenalib/colibri-imx6dl-debian-openjdk,20210602,2021/06/05,230,233,143,39,8,653
rancher/k3c-data,v0.0.1,2020/01/11,null
kasmweb/core-ubuntu-jammy,1.14.0,2023/09/09,154,226,12,0,0,392
grafana/cortex-configs,w37-0193e7b7,2018/09/11,0,0,0,2,0,2
cockroachdb/acceptance-gss-kdc,20230419-131103,2023/04/19,null
balenalib/parallella-ubuntu-openjdk,11-xenial-20230904,2023/09/09,null
balenalib/artik710-alpine-golang,3.16-20230904,2023/09/09,2,0,3,2,0,7
cimg/redis,7.2.3,2023/11/02,294,325,48,0,0,667
rancher/backup-restore-operator,v4.0.0,2023/10/30,0,3,2,1,0,6
bitnami/kubernetes-event-exporter,1.5.0,2023/11/08,74,14,7,2,0,97
mirantis/ucp-openstack-cinder-csi-plugin,3.5.3,2021/04/08,132,109,119,38,3,401
docker/dev-environments-ruby,5741e9ade3b31784a7a35d5a81f19d30e8f63c5e,2021/08/10,1112,727,857,89,26,2811
balenalib/artik5-alpine-openjdk,8-jre-20220803,2022/08/04,34,78,46,10,0,168
purestorage/ccm-service,3.2.13,2022/08/09,19,53,30,1,0,103
dynatrace/easytravel-mongodb,7.1,2018/05/11,0,2,2,3,0,7
continuumio/anaconda-pkg-build,2023.03.28,2023/03/28,571,569,39,3,0,1182
docker/ucp-kube-dns,3.2.7,2020/06/26,0,0,0,2,0,2
solaceiotteam/async-apim-server,0.4.1,2022/09/29,0,13,24,2,0,39
objectscale/decks-support-store,2.71.3,2021/04/14,6,71,66,3,6,152
balenalib/nitrogen6x-alpine-openjdk,8-3.14-20220112,2022/01/19,2,50,42,13,0,107
mirantis/ucp-cfssl,3.7.1,2023/09/26,2,2,6,2,0,12
balenalib/stem-x86-32-ubuntu-openjdk,11-xenial-20230904,2023/09/09,null
rancher/bad-ingress-scanner,319,2023/11/15,19,3,0,0,0,22
astronomerinc/ap-nats-streaming,0.25.5-1,2023/11/08,0,3,2,0,0,5
pachyderm/label-studio-ci-testing,92081111f606b30014cf163da9d26f19513dd987,2023/09/22,189,296,24,0,0,509
airbyte/source-db2,0.1.20,2023/06/20,30,127,201,15,1,374
docker/ucp-compose-s390x,3.1.0-beta3,2018/10/04,131,358,15,4,0,508
rancher/jetstack-cert-manager-controller,v0.8.1,2019/06/18,0,0,0,2,0,2
opensearchproject/opensearch-maps-server,1.0.0,2022/10/20,15,107,192,14,1,329
mariadb/maxscale,23.08.3,2023/11/07,null
okteto/python,3,2023/08/24,506,282,90,10,0,888
balenalib/orbitty-tx2-fedora-openjdk,8-20231106,2023/11/06,null
circleci/docker-gc,2.0.1254-7001717,2023/07/17,0,3,1,0,0,4
bellsoft/buildpacks.environment-variables,4.5.0,1980/01/01,null
intel/esp-uos-dyninit,v3.1.2,2023/08/16,2,2,4,2,0,10
balenalib/hummingboard-alpine-golang,20230904,2023/09/09,2,2,5,2,0,11
onlyoffice/4testing-ds-proxy,6.0.0,2020/10/21,613,682,43,3,0,1341
airbyte/source-chargify,0.4.0,2023/10/16,0,14,24,1,0,39
google/apigee-operators,1.8.1,2022/09/22,0,4,5,1,0,10
rancher/healthcheck,v0.3.8,2018/07/09,342,450,26,0,0,818
couchbase/sandbox,5.0.0-beta,2017/05/20,97,86,8,0,0,191
objectscale/space-reclaimer,0.71.3,2021/04/15,17,149,212,36,6,420
balenalib/artik5-alpine-golang,20220803,2022/08/04,8,39,38,12,0,97
pachyderm/datascience-notebook,fde4beb9ff1afb404f0e34828adc1f311f4bf2d7,2021/10/20,115,179,41,5,0,340
greenbone/greenbone-feed-sync,v23.10.0,2023/10/23,70,15,11,1,0,97
balenalib/nitrogen6x-debian-node,18.6-20220714,2022/07/21,124,71,73,18,0,286
opensearchproject/data-prepper,2.5.0,2023/10/11,69,79,12,1,0,161
balenalib/artik533s-fedora-golang,20220714,2022/07/23,null
onlyoffice/4testing-documentserver-ee-cl,6.4.2,2022/01/06,434,1323,66,0,0,1823
onlyoffice/docspace-doceditor,1.1.4.1,2023/10/23,982,150,214,12,0,1358
grafana/ci-build-windows,0.3.4,2022/04/19,8,26,22,2,0,58
balenalib/artik10-golang,20220714,2022/07/22,473,263,219,28,1,984
atlassian/docker-release-maker,test3,2022/03/09,7,54,65,16,0,142
grafana/jsonnet-build,1022b37,2020/03/18,0,0,0,2,0,2
percona/percona-server,8.0.34-26,2023/09/15,7,4,18,0,0,29
hashicorp/terraform-website,98965949466ebb9ac066eb14bf3118ca3230ec9e,2022/09/07,7,138,99,27,0,271
balenalib/artik710-fedora-node,20230712,2023/07/16,0,1,1,0,0,2
bitnami/kubeapps-tiller-proxy-archived,1.11.3,2020/10/21,9,28,18,1,0,56
mattermost/mm-te,97363046,2023/04/04,224,197,113,19,6,559
airbyte/destination-exasol,0.1.1,2023/02/22,34,148,245,30,1,458
bitnami/contour,1.26.1,2023/11/08,74,13,7,2,0,96
datadog/k8s-dns-exposer-controller,v0.0.1,2019/08/02,281,444,25,3,0,753
appdynamics/appdynamics-agent-config-client,23.10.0-1190,2023/10/27,0,2,2,0,0,4
tenable/terrascan_atlantis,1.18.3,2023/08/03,11,145,210,27,0,393
rancher/rancher,v2.8.0-rc3,2023/10/26,2,65,71,1,1,140
balenalib/orangepi-plus2-alpine-node,18.14.1-20231106,2023/11/07,0,3,3,0,0,6
airbyte/source-flexport,0.2.0,2023/08/23,0,15,24,1,0,40
okteto/outyet,0.0.5,2019/02/12,192,418,433,74,12,1129
nginx/docker-extension,0.0.3,2023/04/17,0,10,2,0,0,12
mariadb/columnstore,23.02.4,2023/08/03,3,22,41,0,0,66
vertica/verticadb-operator,1.11.2,2023/08/02,0,3,2,0,0,5
docker/ucp-kube-compose-api-s390x,3.1.0-beta3,2018/10/04,0,0,0,2,0,2
redislabs/fake-kubelet,arm-latest,2021/11/04,2,38,52,5,0,97
bitnami/deepspeed,0.12.3,2023/11/13,447,76,44,3,0,570
balenalib/armv7hf-debian-python,20230929,2023/10/02,111,38,33,6,0,188
launchdarkly/ld-find-code-refs,2.11.4,2023/10/16,0,2,2,0,0,4
balenalib/stem-x86-32-debian,20230904,2023/09/09,118,37,38,6,0,199
intel/esp-squid,v3.1.2,2023/07/25,null
bitnami/promtail,2.9.2,2023/11/09,74,15,7,2,0,98
onlyoffice/docs-docservice-de,7.5.1-1,2023/11/09,0,0,1,1,0,2
airbyte/source-quickbooks-singer,0.1.5,2022/02/17,0,22,51,8,0,81
balenalib/raspberry-pi2-alpine-golang,20231106,2023/11/07,0,2,2,0,0,4
balenalib/rpi-debian,20231106,2023/11/07,107,35,29,4,0,175
docker/ucp-etcd,3.3.1,2020/06/26,2,26,41,1,0,70
adobecoldfusion/apimanageraddons2021,2021.0.0,2021/09/16,106,171,8,3,0,288
balenalib/qemux86-64-openjdk,20231106,2023/11/06,125,44,29,4,0,202
balena/amd64-supervisor-node,1244-update-lock-weirdness,2020/03/31,721,610,602,76,9,2018
balenalib/generic-armv7ahf-golang,20230904,2023/09/09,448,109,72,9,0,638
mirantis/cnigenie,v1.0-124-ge4298f1,2018/05/28,null
airbyte/source-the-guardian-api,0.1.0,2022/11/09,0,17,25,1,0,43
mattermost/ops-tool,v0.0.3,2022/08/19,90,57,48,12,0,207
datadog/agent-dev-arm64,6.15.1,2019/11/26,101,63,79,20,6,269
balenalib/beaglebone-green-python,20230911,2023/09/11,118,38,38,6,0,200
rancher/cert-manager-webhook-arm64,v0.7.2-rio.1,2019/05/15,0,0,0,2,0,2
ubuntu/bind9,9.18-23.10_edge,2023/11/07,13,1,0,0,0,14
airbyte/source-faker,5.0.0,2023/08/09,0,15,24,1,0,40
mattermost/mattermost-cloud,9839667,2022/12/09,7,43,47,5,0,102
mattermost/calls-recorder,v0.5.3,2023/11/13,0,2,1,0,0,3
purestorage/pso-smartagent,v0.1.0,2020/12/02,10,24,48,6,0,88
balenalib/orangepi-plus2-openjdk,20230911,2023/09/11,129,65,42,6,0,242
google/apigee-istio-proxyv2,1.4.6,2020/02/22,650,1307,149,1,0,2107
intel/video-analytics-serving,0.7.0,2021/12/07,451,1396,66,0,0,1913
rancher/longhornio-csi-provisioner,v2.1.2,2021/04/13,0,5,13,0,4,22
bitnami/keycloak-gatekeeper-archived,10.0.0,2021/04/19,0,9,19,0,0,28
accurics/terrascan-action,1.4.1,2021/10/27,2,41,69,15,0,127
rancher/mirrored-openzipkin-zipkin,2.14.2,2019/06/15,5,42,83,31,6,167
objectscale/storageserver-manager,0.71.3,2021/04/15,14,96,114,14,6,244
couchbase/exporter,1.0.9,2023/01/27,0,1,0,0,0,1
bitnami/airflow,2.7.3,2023/11/06,224,87,46,4,0,361
kasmweb/forward-proxy,1.0.0,2023/08/08,2,0,6,2,0,10
redislabs/pcf-redis-enterprise-tester,100.0.999000971,2023/05/17,651,992,83,4,0,1730
rancher/os-debianconsole,v1.5.8,2021/02/05,60,70,226,12,8,376
balenalib/apalis-imx6q-fedora-golang,20220507,2022/05/12,null
airbyte/integration-singer-bigquery-destination,0.1.4,2020/10/07,18,64,85,16,0,183
solaceiotteam/apim-analytics-server,0.2.0,2022/06/02,2,29,30,5,0,66
rancher/external-lb,v0.3.7,2019/01/30,0,10,2,0,0,12
rancher/goharbor-clair-photon,v2.0.8-v1.7.5,2019/04/01,14,94,137,55,0,300
docker/ucp-auth-store,3.3.1,2020/06/26,2,8,7,1,0,18
rancher/webhookinator,v0.1.0,2019/05/15,4,14,6,2,0,26
balenalib/am571x-evm-openjdk,20210602,2021/06/05,230,233,143,39,8,653
jetbrains/upsource-psi,2017.1.1867,2017/04/05,106,392,509,228,30,1265
intel/inference-optimization,2023.2-py3.10,2023/09/20,156,172,22,1,0,351
puppet/puppet-agent,7.20.0,2022/12/02,30,26,2,0,0,58
balenalib/i386-nlp-openjdk,20210225,2021/04/19,242,241,157,48,10,698
balenalib/i386-ubuntu,20210705,2021/07/21,108,178,10,0,0,296
kong/blog,mockbin-traffic-mirror-v2,2022/11/11,2,17,23,4,0,46
balenalib/armv7hf-ubuntu-golang,20231026,2023/11/02,133,131,0,0,0,264
balenalib/armv7hf-ubuntu-node,20231026,2023/11/02,35,9,1,0,0,45
objectscale/objectscale-inventory,1.4.0-397.adb0726,2023/11/13,0,3,2,0,0,5
kasmweb/insomnia,1.14.0,2023/09/14,156,226,12,0,0,394
rancher/mirrored-longhornio-csi-resizer,v1.7.0,2022/12/28,0,3,3,0,0,6
rancher/mirrored-cloud-provider-vsphere-cpi-release-manager,v1.28.0,2023/08/25,0,2,4,0,0,6
balenalib/odroid-xu4-ubuntu-openjdk,11-xenial-20231026,2023/11/02,null
grafana/tanka,0.26,2023/08/08,1,11,9,1,0,22
airbyte/source-linnworks,0.1.5,2021/12/24,0,21,50,8,0,79
docker/for-desktop-kernel,41ab3c5d630f455776be4b7bbe57dcb796b5b0a2-amd64,2020/02/12,null
mirantis/kubeadm-dind-cluster,v1.12,2018/12/10,269,646,710,109,23,1757
balenalib/asus-tinker-board-s-alpine-openjdk,8-20231106,2023/11/07,0,2,2,0,0,4
balenalib/armv7hf-ubuntu,20231026,2023/11/02,34,8,0,0,0,42
onlyoffice/4testing-docspace-files,2.0.0.33,2023/11/15,993,142,206,12,0,1353
balenalib/apalis-imx6q-fedora-node,36-build-20220714,2022/07/22,0,1,1,0,0,2
balenalib/artik530-alpine-golang,20220803,2022/08/04,8,39,38,12,0,97
accurics/siac-comms,1.3.14,2021/05/07,2,10,32,4,0,48
balenalib/beaglebone-black-alpine-node,18.14.1-20231106,2023/11/07,0,3,3,0,0,6
docker/ucp-dsinfo,3.3.1,2020/06/26,4,6,2,0,0,12
okteto/telemetry,1.5.45,2020/03/03,3,18,42,4,0,67
bitnami/mlflow,2.8.0,2023/10/29,98,17,24,5,0,144
bitnami/bitnami-shell-archived,11,2023/07/15,86,28,23,6,0,143
okteto/golang-ci,2.3.3,2023/10/26,490,193,149,14,0,846
mattermost/bifrost,5204093,2023/08/30,0,7,1,0,0,8
intel/ai-workflows,1.0-vision-tlt-disease-prediction,2023/07/11,26,32,6,1,0,65
balenalib/qemux86-64-alpine-python,20231106,2023/11/07,0,3,2,0,0,5
okteto/custom-error-pages,0.2.0,2020/02/08,2,10,29,4,0,45
objectscale/objectstore-post-upgrade,0.78.0-59.f3aae99,2021/07/20,2,16,19,0,0,37
intel/qat-crypto-base,v.0.1.0,2023/01/06,null
vmware/nsx-container-plugin-operator,v4.1.2,2023/10/23,143,35,4,0,0,182
grafana/grafana-dev,10.3.0-146415,2023/11/15,0,2,2,0,0,4
grafana/devtools-github-archive-parser,4160534dbc93f1bec6669c5a97edbbbf83cc3c52,2019/03/31,55,35,67,15,10,182
airbyte/source-adjust,0.1.0,2022/09/21,0,17,25,1,0,43
couchbase/couchbase-training,1.6,2022/08/04,49,33,2,0,0,84
balenalib/stem-x86-32,20230904,2023/09/09,118,37,38,6,0,199
balenalib/orbitty-tx2-fedora-golang,20231106,2023/11/06,null
objectscale/dks-testapp,2.71.3,2021/04/14,4,54,69,3,3,133
mattermost/mattermost-build-docker,20201023_19.03.12,2020/10/23,14,54,150,16,0,234
cockroachdb/cockroach-premier,v1.1.4-early,2017/12/12,42,55,67,11,19,194
rancher/mirrored-paketobuildpacks-builder,0.2.443-full,1980/01/01,0,196,98,0,0,294
balenalib/odroid-c1-fedora-openjdk,30-20210825,2021/09/03,null
balenalib/artik10-debian-golang,20220714,2022/07/22,473,263,219,28,1,984
intel/pmem-csi-driver-test,v1.1.0,2022/12/19,92,35,44,3,3,177
pachyderm/object-detection,fix4,2017/09/07,581,968,203,17,0,1769
bitnami/kubectl,1.28.3,2023/11/08,94,14,21,3,0,132
pachyderm/grpc-proxy,0.4.10,2019/10/04,536,1452,1164,241,14,3407
airbyte/source-lever-hiring,0.2.0,2023/05/29,0,15,25,1,0,41
intel/intel-ethernet-operator-bundle,v1.0.0,2023/07/26,null
astronomerinc/ap-fluentd,1.16.2-2,2023/11/08,12,1,0,0,0,13
balenalib/i386-debian-python,20231106,2023/11/06,107,22,21,4,0,154
rancher/longhorn-engine,6482810,2019/03/20,138,262,18,0,0,418
balenalib/artik533s-alpine,20220803,2022/08/03,7,37,33,10,0,87
airbyte/source-coingecko-coins,0.1.0,2022/11/18,0,17,25,1,0,43
couchbase/qe-mobile-greenboard,cbl_dev,2020/12/09,3,43,46,11,0,103
balenalib/via-vab820-quad-debian-openjdk,20210602,2021/06/05,230,233,143,39,8,653
intel/intel-optimized-tensorflow-avx512,2.11.0,2023/01/19,66,63,10,0,0,139
datadog/dd-apm-demo,ruby-2.7,2021/01/07,1764,1468,1343,161,43,4779
appdynamics/java-agent,23.10.0.35234,2023/10/30,0,2,2,0,0,4
bitnami/mediawiki,1.40.1,2023/10/11,149,83,54,4,0,290
rancher/cert-manager-cainjector,v0.11.0-rio.1,2019/10/22,0,0,0,0,6,6
onlyoffice/4testing-docspace-wait-bin-share,2.0.0.33,2023/10/18,null
datadog/agent-buildimages-suse_x64,v20433308-6861270,2023/09/25,3,24,21,1,0,49
balenalib/beaglebone-green-ubuntu-openjdk,11-xenial-20230911,2023/09/12,null
balenalib/artik10-fedora-node,36-build-20220803,2022/08/04,0,1,1,0,0,2
portainer/portainer-k8s-beta,linux-arm,2020/06/18,5,20,20,0,0,45
circleci/cci-demo-rails,711886c622bcf505c20c7f4148f4e5108297eb74,2016/12/21,504,2530,1614,395,72,5115
kasmweb/chrome,1.14.0,2023/09/14,187,379,0,0,0,566
mirantis/ucp-csi-provisioner,3.5.3,2022/04/05,0,0,0,0,6,6
bitnami/metrics-server,0.6.4,2023/11/08,74,16,10,2,0,102
rapidfort/postgresql,16.0,2023/11/09,33,10,3,1,0,47
airbyte/source-zendesk-sell,0.2.0,2023/10/24,0,13,24,1,0,38
pachyderm/postgresql,13.3.0,2022/02/11,181,110,102,32,6,431
ambassador/telepresence-docker-desktop-runtime,0.0.8-alpha.2,2022/04/13,16,90,76,10,0,192
balenalib/qemux86-64-golang,20231103,2023/11/05,442,82,51,5,0,580
mathworks/polyspace-deps,R2023b-ubuntu22.04,2023/11/13,44,29,0,0,0,73
balenalib/beaglebone-black-debian,20230911,2023/09/11,118,37,38,6,0,199
intel/power-operator_ocp-4.13,v2.3.1,2023/08/29,29,32,8,0,0,69
bitnami/google-cloud-sdk,0.455.0,2023/11/15,77,17,9,2,0,105
balenalib/apalis-imx6q-ubuntu,20220714,2022/08/02,87,81,11,0,0,179
airbyte/source-public-apis,0.2.0,2023/08/29,0,15,24,1,0,40
onlyoffice/docspace-clear-events,1.1.4.1,2023/10/23,993,143,209,12,0,1357
intel/ai-tools,tlt-0.5.0,2023/07/06,26,32,5,1,0,64
mongodb/mongodb-atlas-search,preview-20231024T105931Z,2023/10/24,15,134,293,26,1,469
apachepinot/eks-nvme-ssd-provisioner,v1.0.1,2023/02/01,0,4,11,0,0,15
objectscale/objectscale-manager-pre-update-debug,0.61.0-7.da2bf03,2020/12/15,0,6,10,0,0,16
rancher/rio,v0.0.4-r6,2019/02/21,0,0,0,2,0,2
atlassian/pipelines-kubernetes-namespace-expiry,stg-stable,2019/11/07,114,130,130,38,8,420
balenalib/colibri-imx6dl-alpine-openjdk,8-3.14-20220112,2022/01/19,2,50,42,13,0,107
balenalib/fincm3,20230904,2023/09/09,118,37,38,6,0,199
bitnami/fluentd-exporter-archived,0.2.0,2022/06/19,94,64,55,18,0,231
airbyte/source-pardot,0.1.1,2022/12/15,0,16,25,1,0,42
bitnami/codeigniter,4.4.3,2023/10/27,154,85,52,5,0,296
jetbrains/upsource-proxy,2020.1.1992,2022/03/11,140,492,423,84,56,1195
balenalib/parallella-alpine,20230904,2023/09/09,2,2,5,2,0,11
mattermost/testwick,test2,2022/10/14,1,19,16,1,0,37
airbyte/source-rocket-chat,0.1.0,2022/11/13,0,17,25,1,0,43
grafana/grafana-oss,10.2.1,2023/11/14,0,2,3,0,0,5
vmware/photon-2.0-calico-node,v2.6.7-20180619,2018/06/19,17,87,106,59,0,269
vmware/dch-photon,18.06,2021/10/18,7,35,50,24,0,116
okteto/docker-desktop-extension,0.3.3,2022/11/09,79,83,83,6,0,251
greenbone/gsad,22.8,2023/11/14,94,17,15,2,0,128
kasmweb/kasm-guac,1.14.0,2023/08/19,130,230,19,1,0,380
couchbase/server,7.2.3,2023/11/09,21,5,0,0,0,26
docker/tilt-ctlptl,v0.8.22,2023/09/01,86,26,11,3,0,126
balenalib/bananapi-m1-plus-ubuntu-python,20231026,2023/11/02,37,9,0,0,0,46
docker/ucp-interlock-extension,3.3.1,2020/06/26,2,14,19,1,0,36
intel/intel-ethernet-operator-manager,v1.0.0,2023/07/26,4,16,5,0,0,25
bitnami/flink,1.18.0,2023/10/24,84,19,14,4,0,121
rancher/opni-payload-receiver-service,v0.5.4,2022/07/26,8,72,69,4,11,164
airbyte/source-ashby,0.1.0,2022/10/28,0,17,25,1,0,43
okteto/agent,1.0,2018/07/04,0,1,4,3,0,8
intel/intel-optimized-nginx,qatsw-src,2023/03/22,81,112,5,0,0,198
airbyte/source-azure-table,0.1.3,2022/10/18,0,17,25,1,0,43
appdynamics/dynamic-agent-ma,20.5.1.1,2020/06/01,795,138,382,30,6,1351
portainer/portainer-ce,2.19.2,2023/11/12,0,16,12,0,0,28
balenalib/orbitty-tx2-ubuntu,20231103,2023/11/06,37,8,0,0,0,45
balenalib/beaglebone-green-wifi-alpine-node,18.14.1-20231106,2023/11/07,0,3,3,0,0,6
objectscale/fedsvc,0.71.3,2021/04/14,9,102,121,20,3,255
airbyte/destination-redpanda,0.1.0,2022/11/14,29,131,212,15,1,388
balena/386-balena-multibuild-scripts,0.1.0,2019/10/01,4,14,9,1,0,28
docker/ucp-kube-gmsa-webhook,3.3.1,2019/07/17,null
bitnami/pushgateway,1.6.2,2023/11/09,74,15,7,2,0,98
balenalib/orbitty-tx2-debian-golang,20231106,2023/11/07,442,81,51,5,0,579
rancher/terraform-controller,v0.0.13-alpha1,2020/11/19,10,39,80,13,0,142
dynatrace/easytravel-headless-loadgen,2.0.0.3599,2023/08/04,204,119,92,13,0,428
balenalib/odroid-c1-fedora-python,20220622,2022/07/12,0,1,1,0,0,2
vmware/labs-service-bindings-manager,0.9.0,0001/01/01,null
jetbrains/datalore-postgres,2023.5.1,1970/01/01,112,41,35,2,0,190
balenalib/beaglebone-green-fedora-python,20220928,2022/10/04,0,1,1,0,0,2
objectscale/provision,0.71.3,2021/04/08,0,6,4,0,0,10
percona/percona-everest,v0.4.0,2023/11/01,0,2,0,0,0,2
puppet/kubetool,8.0.0,2023/07/13,1,26,41,1,0,69
adobecoldfusion/apimanager2023,2023.0.0,2023/05/17,40,92,98,40,0,270
onlyoffice/box-auth,1.0.1,2023/09/12,0,6,6,0,0,12
intel/sigopt-controller,2022-11-09a,2022/11/09,3,24,23,1,0,51
rancher/ecm-distro-tools,v0.23.0,2023/10/03,3,29,29,0,2,63
ddosify/selfhosted_frontend,2.4.1,2023/11/01,2,31,38,6,0,77
rancher/rke2-cloud-provider,v1.28.2-build20231016-s390x,2023/10/17,0,3,8,0,2,13
grafana/cortex-distributor,w37-0193e7b7,2018/09/11,0,0,0,2,0,2
airbyte/destination-vertica,0.1.0,2023/05/31,34,145,243,30,1,453
appdynamics/machine-agent-arm64,23.10.0,2023/10/30,94,30,4,1,0,129
balenalib/qemux86-64-ubuntu-golang,20230911,2023/09/11,147,146,23,0,0,316
grafana/cortex-lite,w37-0193e7b7,2018/09/11,0,0,0,2,0,2
rancher/haproxy-tomcat,v0.0.1,2016/06/17,0,27,24,10,0,61
rancher/mirrored-prom-alertmanager,v0.21.0,2020/06/17,0,12,26,0,0,38
balenalib/amd64-fedora-node,20231103,2023/11/04,0,1,1,0,0,2
docker/dtr-api-s390x,2.5.0-beta3,2018/01/17,3,56,103,50,0,212
balenalib/i386-alpine-golang,20230911,2023/09/11,2,2,5,2,0,11
bitnami/kiam,4.2.0,2023/11/08,78,18,18,2,0,116
launchdarkly/ld-relay,8.2.0,2023/10/24,0,3,3,0,0,6
mathworks/matlab-deep-learning,r2023b,2023/10/27,194,203,9,0,0,406
mirantis/phpldapadmin,v0.6.12-1,2018/04/10,67,219,256,125,35,702
rancher/drone-images,runner-amd64-2004,2020/07/13,3,15,18,0,0,36
okteto/movies-api,okteto,2020/04/15,512,1385,1102,223,12,3234
google/apigee-hybrid-cassandra-client,1.8.1,2022/07/07,9,30,41,4,4,88
docker/ucp-istio-proxyv2,3.3.1,2020/06/26,471,1159,140,1,0,1771
okteto/statuspage,dev,2020/03/31,514,1479,1225,247,12,3477
balena/armv7hf-supervisor-node,1244-update-lock-weirdness,2020/04/02,721,605,592,76,9,2003
okteto/helm-chart-manager,1.1.1,2020/01/08,13,42,65,9,0,129
rancher/systemd-node,v0.0.5-rc2,2023/06/08,6,26,29,0,2,63
airbyte/destination-e2e-test,0.3.0,2023/05/15,30,126,200,15,1,372
amazon/amazon-eks-pod-identity-webhook,4580826,2023/05/18,0,2,2,1,1,6
rancher/mirrored-kube-vip-kube-vip-iptables,v0.6.0,2023/05/15,0,13,10,0,0,23
objectscale/objectscale-license-usage,1.4.0-397.adb0726,2023/11/13,0,3,2,0,0,5
rancher/gke-operator,v2.0.1-rc2,2021/05/20,90,188,31,0,0,309
circleci/cci-demo-docker,0.1.68,2017/05/15,0,1,5,2,0,8
bitnami/mxnet,1.9.1,2023/10/11,606,188,82,9,0,885
okteto/clean,0.1.6,2021/02/16,0,1,0,0,0,1
redislabs/service-broker,968fa1a,2018/03/20,205,488,516,126,15,1350
airbyte/source-getlago,0.3.0,2023/10/17,0,14,24,1,0,39
dynatrace/dynatrace-codemodules,1.277.165.20231024-150054,2023/10/25,null
kasmweb/centos-7-desktop,1.14.0,2023/09/14,1355,1418,93,4,2,2872
objectscale/metering,0.71.3,2021/04/15,17,149,212,36,6,420
docker/ucp-auth-s390x,3.1.0-beta3,2018/10/04,0,2,6,16,0,24
airbyte/normalization-duckdb,0.4.3,2023/05/12,492,378,329,49,2,1250
balenalib/armv7hf-ubuntu-openjdk,11-xenial-20231026,2023/11/02,null
jetbrains/upsource-psi-agent,2020.1.1992,2022/03/11,79,148,241,95,0,563
airbyte/source-stripe-singer,0.2.1,2021/04/03,143,94,109,34,7,387
solaceiotteam/apim-demo-portal,0.1.20,2021/11/03,139,230,34,4,0,407
grafana/grafana-plugin-ci-e2e,1.9.7,2023/11/07,770,199,167,8,0,1144
circleci/clojure,tools-deps-1.11.1.1113-buster-node,2022/05/01,672,220,300,63,13,1268
rancher/mirrored-istio-proxyv2,1.19.0,2023/09/01,29,12,6,0,0,47
dynatrace/oneagent,1.129.145,2017/10/17,739,750,77,3,0,1569
appdynamics/ad-air-web-api,java,2021/01/15,106,103,91,32,0,332
greenbone/pheme,21.8.1,2023/11/14,106,38,41,6,0,191
objectscale/kahm-testapp,v2.74.0,2021/05/25,4,53,68,3,3,131
balenalib/up-board-alpine-node,20231106,2023/11/07,0,3,3,0,0,6
jetbrains/upsource-analyzer,2020.1.1992,2022/03/11,142,198,315,113,1,769
hashicorp/consul-api-gateway,0.5.5,2023/09/07,1,14,14,0,0,29
airbyte/source-postgres-strict-encrypt,3.1.13,2023/10/13,10,43,60,18,0,131
balenalib/jetson-tx2-python,20231106,2023/11/07,114,22,27,4,0,167
okteto/ruby,2,2023/08/24,774,452,305,21,0,1552
newrelic/synthetics-node-browser-runtime,2.0.35,2023/10/02,138,193,10,0,0,341
cimg/mariadb,11.2.1,2023/10/12,294,339,48,0,0,681
okteto/golang-middleware-template,0.1.1,2020/06/01,710,536,507,64,9,1826
google/apigee-connect-agent,1.8.1,2022/07/20,0,4,6,0,0,10
rancher/image-build-crictl,v1.17.0-amd64,2020/08/19,260,423,37,3,0,723
intel/oneapi-runtime,2023.2-devel-ubuntu22.04,2023/07/14,186,177,39,0,0,402
vmware/vke-imagetest,1.1,2019/01/26,854,1336,86,3,0,2279
balenalib/aarch64-debian-python,20231106,2023/11/07,107,22,21,4,0,154
cimg/azure,2023.09.1,2023/09/25,294,337,51,0,0,682
vmware/sources-for-knative-controller,v0.29.0,1970/01/01,0,4,7,0,0,11
docker/ucp-kube-dns-sidecar-s390x,3.1.0-beta3,2018/10/04,0,0,0,2,0,2
intel/image-recognition,tf-2.7.0-resnet101-int8-inference,2021/12/15,93,151,12,0,0,256
rancher/opa-gatekeeper,v3.1.0-rc.1,2020/08/14,0,8,14,0,6,28
docker/ucp-azure-ip-allocator-s390x,3.1.0-beta3,2018/10/04,0,0,6,16,0,22
balenalib/artik530-python,20220714,2022/07/22,124,70,74,18,0,286
solaceiotteam/solace-axway-agent,0.0.21,2022/05/10,0,12,9,1,0,22
objectscale/chunk-manager,0.71.3,2021/04/15,17,149,212,36,6,420
okteto/desk,0.1.6,2019/09/06,698,1020,73,0,0,1791
airbyte/source-amplitude,0.3.6,2023/10/24,64,22,6,1,0,93
balenalib/odroid-c1-fedora-golang,20220507,2022/05/12,null
airbyte/custom-transformation-prep,1.0,2023/05/12,492,378,329,49,2,1250
kasmweb/core-fedora-38,1.14.0,2023/09/09,null
bitnami/suitecrm,8.4.2,2023/11/14,151,104,56,7,0,318
rancher/hardened-sriov-network-operator,14bd335c17c1b4c6cb7d37c2972c05cc62cadeeb-build20211119,2021/11/19,240,326,29,3,0,598
balenalib/via-vab820-quad-fedora-node,36-build-20220714,2022/07/22,0,1,1,0,0,2
balenalib/zynq-xz702-fedora-openjdk,30-20210825,2021/09/03,null
airbyte/source-oracle-strict-encrypt,0.4.0,2023/06/29,30,127,201,15,1,374
pachyderm/splitcombine,0.0.2,2023/03/28,null
kasmweb/tracelabs,1.14.0,2023/09/14,4,73,81,16,0,174
balenalib/orangepi-plus2-fedora-golang,20221210,2022/12/13,null
circleci/logging-collector,3.0,2023/11/09,null
mattermost/webrtc,4.4,2017/11/30,458,713,56,1,0,1228
balenalib/odroid-xu4-fedora,20221210,2022/12/12,null
objectscale/decks-pre-update,2.78.0-221.79a9cc6,2021/07/20,2,16,19,0,0,37
intel/intel-ethernet-operator-flowconfig-daemon,v1.0.0,2023/07/19,4,16,5,0,0,25
rancher/directxman12-k8s-prometheus-adapter-amd64,v0.7.0,2020/04/17,null
intel/intel-optimized-ffmpeg,avx3-src,2023/08/31,156,164,21,0,0,341
lacework/azure-cfg-cli,v1.0,2018/12/03,881,1729,96,1,0,2707
kasmweb/doom,1.14.0,2023/09/14,187,380,0,0,0,567
amazon/aws-sam-cli-emulation-image-nodejs14.x,20220125,2022/01/25,5,33,27,13,1,79
docker/dtr-notary-server,2.8.1,2020/06/17,2,9,8,1,0,20
balenalib/intel-nuc-fedora-openjdk,8-20231103,2023/11/04,null
balenalib/artik533s-alpine-python,20220803,2022/08/04,7,38,35,10,0,90
balenalib/orbitty-tx2-node,20231106,2023/11/07,114,23,28,4,0,169
onlyoffice/docs-utils,7.5.1-1,2023/11/09,0,2,2,0,0,4
dynatrace/dynatrace-gcp-function,v1-latest,2023/02/02,103,49,42,3,3,200
balenalib/armv7hf,20230929,2023/10/02,111,37,33,6,0,187
bitnami/pymilvus,2.3.3,2023/11/10,77,15,7,2,0,101
balenalib/am571x-evm-ubuntu-golang,20220523,2022/06/03,222,535,46,0,0,803
intel/object-detection,tf-2.7.0-ssd-resnet34-int8-inference,2021/12/15,302,747,75,2,0,1126
cockroachdb/movr,21.1.1,2021/05/26,1443,1307,914,142,37,3843
balenalib/apalis-imx6q-openjdk,20210602,2021/06/05,230,233,143,39,8,653
balenalib/intel-nuc-ubuntu-python,20230911,2023/09/11,42,10,4,0,0,56
kasmweb/oracle-9-desktop,1.14.0,2023/09/14,18,8,865,0,0,891
rancher/os-dind,18.03.1,2018/12/12,0,23,0,2,0,25
hashicorp/http-echo,1.0,2023/10/10,null
bitnami/mariadb,11.1.3,2023/11/15,74,16,7,2,0,99
pachyderm/example-wordcount,2.0.3,2022/02/18,496,359,315,60,2,1232
circleci/vm-service-lite,1.0.117-440460b,2023/01/26,1,9,17,1,0,28
rancher/harvester-node-disk-manager,v0.5.2,2023/08/29,4,8,11,0,1,24
circleci/jruby,9.3.3.0,2022/02/22,299,383,360,66,2,1110
docker/desktop-kubernetes,v1.15.4,2019/09/23,null
vmware/photon-build,rpm-ostree-3.0,2019/08/27,26,156,178,64,0,424
docker/ucp-calico-node,3.3.1,2020/06/26,130,312,37,0,0,479
rancher/hardened-k8s-metrics-server,v0.3.7,2020/09/25,257,403,18,3,0,681
balenalib/odroid-c1-alpine-golang,20220714,2022/07/27,8,39,38,12,0,97
balenalib/hummingboard-alpine-node,18.14.1-20230904,2023/09/09,2,3,6,2,0,13
docker/cnab-app-base,v0.9.1-beta3,2020/04/24,2,10,29,4,0,45
airbyte/source-zapier-supported-storage,0.1.0,2022/11/07,0,17,25,1,0,43
docker/ucp-calico-kube-controllers,3.3.1,2020/05/28,null
airbyte/source-courier,0.1.0,2022/10/19,0,17,25,1,0,43
balenalib/imx6ul-var-dart-debian-golang,20230911,2023/09/12,448,109,72,9,0,638
lacework/lacework-inline-scanner,0.23.2,2023/11/10,0,10,10,0,0,20
rancher/os-base,3929481,2017/02/03,null
kumahq/kuma-cni,2.4.4,2023/11/06,7,2,1,0,0,10
jetbrains/datalore-sql-session,2023.3.1,1970/01/01,68,104,7,0,0,179
balena/i386-nlp-supervisor-node,1244-update-lock-weirdness,2020/03/31,122,188,178,22,2,512
astronomerinc/ap-commander,0.33.6,2023/11/09,0,16,0,0,0,16
bitnami/jsonnet,0.20.0,2023/10/10,72,12,6,2,0,92
airbyte/destination-firestore,0.1.1,2021/11/21,0,22,53,8,0,83
docker/for-desktop-qemu,39146321ff4b36f97116053ff277fc87eb664aee-arm64,2021/05/04,null
ubuntu/dotnet-runtime,7.0_beta,2023/11/01,null
balenalib/generic-armv7ahf-fedora,20221210,2022/12/12,null
okteto/deno,1.9,2021/04/19,94,34,49,16,6,199
airbyte/source-coin-api,0.1.1,2023/01/05,0,16,25,1,0,42
okteto/golang,2,2020/04/28,712,561,532,65,9,1879
rancher/swarm-agent,v0.1.3,2016/07/13,49,14,4,0,0,67
airbyte/source-paypal-transaction,2.2.0,2023/10/26,64,22,6,1,0,93
bitnami/percona-xtrabackup,8.0.34-29,2023/10/11,79,13,12,3,0,107
bellsoft/buildpacks.java,1.0.0,1980/01/01,0,4,2,0,0,6
kong/ubi-kumactl,2.4.4,2023/11/06,30,29,8,0,0,67
balenalib/i386-nlp-ubuntu,20210225,2021/03/11,121,246,16,0,0,383
graphcore/pytorch-early-access,3.3.0-EA.1-ubuntu-20.04-20230504,2023/05/04,188,294,35,0,0,517
snyk/snyk-operator-index,1.40.3-pre6,2021/01/22,5,24,55,4,0,88
cockroachdb/cockroach-operator-unstable,v1.0.0-alpha.2,1970/01/01,null
newrelic/synthetics-job-manager,release-310,2023/11/02,34,13,0,1,0,48
rancher/os-qemuguestagent,v2.8.1-2,2019/01/22,77,62,71,11,11,232
vmware/restreview-db,V1,2017/10/31,101,225,318,118,13,775
puppet/puppet-bolt,3.27.4,2023/10/06,26,13,2,0,0,41
balenalib/kitra520-ubuntu-python,20220715,2022/08/02,87,82,13,0,0,182
balenalib/aarch64-debian,20231106,2023/11/07,107,21,21,4,0,153
kong/gateway-operator,20231115,2023/11/15,null
rancher/mirrored-minio-minio,RELEASE.2023-07-07T07-13-57Z-s390x,2023/07/07,75,49,7,0,0,131
objectscale/atlas-operator,0.69.0,2021/02/23,0,4,12,0,0,16
rancher/mirrored-flannel-flannel,v0.23.0,2023/10/30,0,2,0,0,0,2
balenalib/artik10-debian,20220714,2022/07/22,124,69,72,18,0,283
airbyte/source-configcat,0.1.0,2022/11/10,0,17,25,1,0,43
rancher/nginx-ingress-controller-defaultbackend,1.4,2017/10/24,null
grafana/grafana-enterprise-dev,10.3.0-63461,2023/11/15,0,2,2,0,0,4
balenalib/parallella-alpine-openjdk,8-20230904,2023/09/09,8,10,6,2,0,26
rancher/hardened-sriov-network-webhook,14bd335c17c1b4c6cb7d37c2972c05cc62cadeeb-build20211119,2021/11/19,240,325,27,3,0,595
grafana/fake-data-gen,1167815,2022/06/28,2,38,27,7,0,74
balenalib/raspberrypi3-debian-golang,20230530,2023/06/27,385,58,46,8,0,497
pingidentity/pingdirectoryproxy,2310,2023/11/01,3,13,7,0,0,23
mirantis/python-operations-api,comment-auth,2018/10/31,60,62,104,29,11,266
ambassador/telepresence-docker-runtime,1.0.19,2023/11/14,0,2,2,0,0,4
airbyte/source-search-metrics,0.1.1,2021/12/22,0,21,50,8,0,79
balenalib/kitra710-debian-openjdk,20230502,2023/05/06,143,81,48,6,0,278
rancher/grafana-grafana-image-renderer,2.0.0,2020/05/16,5,249,347,39,2,642
okteto/bin,1.24-rc1,2020/08/24,0,7,15,0,0,22
rancher/pipeline-kube-apply,v0.2.0,2018/07/23,0,2,1,0,0,3
objectscale/crunchy-upgrade,ubi8-5.1.2-0,2022/07/05,240,179,42,0,0,461
pingidentity/pingfederate,2310,2023/11/01,3,43,44,4,0,94
balenalib/aarch64-debian-node,20231106,2023/11/07,107,23,22,4,0,156
vmware/photon-2.0-kube-scheduler-amd64,v1.10.2-20180619,2018/06/19,15,81,98,70,0,264
kumahq/kuma-demo,latest-arm64,2022/05/26,0,13,10,1,0,24
kasmweb/ubuntu-focal-desktop-vpn,x86_64-develop,2023/11/01,241,425,0,0,0,666
pachyderm/split-loadtest-pipeline,20191119.0802,2019/11/19,null
balenalib/stem-x86-32-ubuntu-golang,1.20.1-xenial-20230904,2023/09/09,null
airbyte/source-open-exchange-rates,0.2.0,2023/10/23,0,13,24,1,0,38
cockroachdb/interop-demo,1.1,2017/04/24,null
tenable/tcs,2.7.0,2023/10/25,163,60,30,2,0,255
bitnami/gitlab-runner-helper,16.5.0,2023/11/08,109,20,28,5,0,162
kumahq/kumactl,2.4.4,2023/11/06,7,2,2,0,0,11
balenalib/beaglebone-black,20230911,2023/09/11,118,37,38,6,0,199
onlyoffice/4testing-docs-example,99.99.99.2945,2022/05/15,1405,1069,730,73,35,3312
kasmweb/minetest,1.14.0,2023/09/14,189,381,0,0,0,570
datadog/agent-dev-amd64,6.15.1,2019/11/27,101,63,79,20,6,269
bitnami/wavefront-hpa-adapter-archived,0.9.10,2023/05/21,0,3,5,0,0,8
okteto/example-react-api,devops,2019/02/27,405,1134,814,210,50,2613
appdynamics/appdynamics-smartagent,23.10.0-1190,2023/10/27,0,5,4,0,0,9
balenalib/i386-nlp-debian-golang,1.11.13-20200529,2021/04/12,661,402,358,53,9,1483
balenalib/nitrogen6x-fedora-golang,20220507,2022/05/12,null
ubuntu/zookeeper,3.1-22.04_edge,2023/07/06,33,38,11,5,0,87
balenalib/odroid-xu4-debian,20230911,2023/09/11,118,37,38,6,0,199
astronomerinc/ap-auth-sidecar,1.25.2-2,2023/11/07,0,2,0,0,0,2
rancher/longhornio-csi-node-driver-registrar,v2.5.0,2022/02/03,0,4,6,0,0,10
bitnami/wavefront-kubernetes-collector,1.13.0,2023/05/21,0,2,4,0,0,6
airbyte/source-gcs,0.3.1,2023/11/13,128,39,11,2,0,180
bitnami/vault-csi-provider,1.4.1,2023/11/09,84,15,13,4,0,116
grafana/promtail,2.9.2,2023/10/25,78,14,11,2,0,105
balenalib/beaglebone-green-wifi-openjdk,20230911,2023/09/12,129,65,42,6,0,242
balenalib/artik530-debian-python,20220714,2022/07/22,124,70,74,18,0,286
docker/desktop-vpnkit-controller,v2.0,2021/05/05,0,11,16,1,0,28
rancher/istio-sidecar_injector,1.5.9,2020/08/07,405,1084,142,0,0,1631
nginxinc/nginmesh_proxy_debug,0.7.1,2018/07/24,103,144,347,68,18,680
jetbrains/youtrack,2023.2.20316,2023/11/02,83,59,41,13,0,196
airbyte/source-mailjet-sms,0.1.0,2022/10/28,0,17,25,1,0,43
rancher/etcd,v3.4.13,2020/08/26,257,419,50,3,0,729
balenalib/rpi-alpine-node,18.14.1-20231026,2023/11/01,0,3,3,0,0,6
vmware/vsphere-block-csi-driver,v1.0.0,2019/08/16,14,63,70,30,0,177
okteto/grafana,0.1.3,2018/10/31,77,85,155,42,12,371
intel/gpu-extender,0.5.4,2023/08/14,0,1,1,0,0,2
objectscale/pgpool,4.2.2-debian-10-r38,2021/03/29,139,96,108,27,6,376
rancher/runc,v1.0.0-rc10,2020/08/11,257,403,18,3,0,681
pachyderm/gpt-2-example,v7,2020/06/19,707,1019,163,7,0,1896
vmware/dind-sshuttle-ci,dev,2018/06/12,3,61,26,30,0,120
kasmweb/brave,1.14.0,2023/09/14,187,379,0,0,0,566
vmware/lightwave-photon-testware,2.0.5,2018/12/20,64,389,487,144,0,1084
rancher/pod-setup,v0.1.0,2017/09/22,null
bitnami/kubeapps-chartsvc-archived,1.10.0,2020/04/01,null
vmware/veba-event-router,76088920,2020/10/20,74,60,12,0,0,146
balenalib/stem-x86-32-ubuntu-node,10.23.1-20210201,2021/07/27,106,185,26,3,0,320
intel/oneapi-vtune,2023.2-devel-ubuntu22.04,2023/07/14,186,177,39,0,0,402
balenalib/spacely-tx2-openjdk,20231106,2023/11/07,125,44,29,4,0,202
airbyte/source-bigquery,0.3.0,2023/06/29,30,126,200,15,1,372
pachyderm/ide-user,2.0.0-b6,2021/11/01,115,180,43,5,0,343
qualys/qcs-sensor,1.29.0-0,2023/09/29,0,24,11,0,0,35
mattermost/chaos-mesh,v0.0.5,2021/10/20,1,20,43,2,0,66
balenalib/orbitty-tx2-alpine-python,20231106,2023/11/06,0,3,2,0,0,5
balenalib/aarch64-alpine-golang,20231106,2023/11/06,0,2,2,0,0,4
cockroachdb/cockroach-operator,v2.12.0,2023/10/23,75,37,12,0,0,124
rancher/cluster-proportional-autoscaler,1.8.1,2020/06/11,0,0,0,0,6,6
pachyderm/dash,1.9.0,2019/06/11,69,66,106,39,9,289
objectscale/fluent-bit,0.33.0,2018/11/10,59,57,77,17,5,215
balenalib/apalis-imx6q-fedora-openjdk,30-20210825,2021/09/03,null
couchbase/centos-72-java-sdk,20170613,2017/07/06,706,888,133,14,0,1741
bitnami/dataplatform-emitter-archived,1.0.1,2022/05/04,4,21,16,0,0,41
balenalib/aarch64-alpine-node,20231106,2023/11/06,0,3,3,0,0,6
balenalib/colibri-imx6dl-ubuntu-golang,20220523,2022/06/03,222,535,46,0,0,803
circleci/ruby,3.0.3,2021/12/18,846,1027,786,101,3,2763
objectscale/csi-provisioner,v3.1.0,2022/01/12,0,4,9,0,0,13
rancher/longhornio-longhorn-manager,v1.3.1,2022/08/11,9,75,72,3,12,171
balenalib/raspberry-pi2-alpine-openjdk,8-20231106,2023/11/07,0,2,2,0,0,4
balenalib/beaglebone-green-alpine-node,18.14.1-20231106,2023/11/07,0,3,3,0,0,6
adobecoldfusion/coldfusionaddons2018,2018.0.1,2022/12/02,315,632,192,84,0,1223
onlyoffice/telegram_bugzilla_notifications,v0.3.0-244-g6a39b37,2023/11/09,0,3,2,0,0,5
rapidfort/ghost,5.52,2023/06/20,55,48,25,7,0,135
airbyte/source-onesignal,1.1.0,2023/08/31,0,15,24,1,0,40
balenalib/bananapi-m1-plus-debian-openjdk,20230904,2023/09/09,129,65,42,6,0,242
bitnami/apisix-ingress-controller,1.7.0,2023/11/08,74,16,9,2,0,101
intel/smart-city_grafana,2021.4.2,2021/12/14,5,31,66,9,0,111
balenalib/odroid-xu4-alpine-python,20231106,2023/11/07,0,3,2,0,0,5
balenalib/beaglebone-green-wifi-debian-openjdk,20230911,2023/09/12,129,65,42,6,0,242
pachyderm/worker,2.8.0-rc.2,2023/11/13,1,7,8,0,0,16
rapidfort/yugabyte,2.17.3.0-b152,2023/05/04,0,7,18,1,0,26
balenalib/rpi-debian-openjdk,8-20190705,2019/07/06,155,187,175,34,12,563
rancher/nginx,1.14.2,2019/03/26,43,55,81,31,7,217
objectscale/kahm-pre-update,2.78.0-167.d216af1,2021/07/20,2,16,19,0,0,37
grafana/kubernetes-diff-logger,0.0.5,2021/06/28,0,13,40,4,0,57
bitnami/harbor-adapter-trivy,2.9.1,2023/11/10,74,14,6,2,0,96
vmware/photon,1.0-20180621,2018/06/21,8,55,68,40,0,171
vmware/notary-server-photon,v0.5.1-v1.5.2,2018/07/18,8,54,72,36,0,170
balenalib/raspberrypi3-fedora-openjdk,8-20221031,2022/11/04,null
balenalib/orbitty-tx2-fedora-python,20231106,2023/11/06,null
bitnami/contour-operator-archived,1.24.0,2023/05/15,0,2,3,0,0,5
rancher/external-dns,v0.7.12,2018/08/09,0,7,0,0,0,7
balenalib/artik533s-ubuntu-python,20220715,2022/08/02,87,82,13,0,0,182
grafana/cortex-jsonnet-build-image,3527936,2021/06/22,3,28,59,17,0,107
airbyte/source-microsoft-teams,0.2.5,2021/12/16,3,22,52,8,0,85
portainer/portainer-updater,latest-windows-amd64,2023/03/26,0,11,7,0,0,18
balena/balena-mdns-publisher,1.27.35,2023/11/13,347,102,57,6,2,514
grafana/tempo-query,2.3.0,2023/10/30,0,2,4,0,0,6
ubuntu/mimir,2.6.0-22.04,2023/10/05,22,22,14,0,0,58
astronomerinc/ap-dogstatsd,9,2023/04/03,0,0,0,1,0,1
intel/intel-sgx-initcontainer,0.28.0,2023/09/22,null
pachyderm/retail-allocation,viz-fix2,2018/02/12,0,26,19,10,0,55
balenalib/generic-aarch64-ubuntu-openjdk,11-xenial-20231103,2023/11/06,null
redislabs/olm-bundle,100.0.7-1207,2023/02/26,null
mattermost/mattermost-operator,9981920,2020/12/03,0,5,11,1,5,22
bitnami/tomcat,10.1.16,2023/11/15,75,16,7,2,0,100
onlyoffice/4testing-docs-converter-de,7.5.1-1-saas,2023/11/08,null
okteto/php-getting-started,1.0.1,2023/02/27,434,167,112,7,0,720
onlyoffice/confluence-cloud,1.0.1,2023/05/23,1,17,5,1,0,24
balenalib/artik710-debian-golang,20230904,2023/09/09,448,112,72,9,0,641
vmware/rsyslog-photon,8.15.0-6,2017/10/23,10,81,101,57,0,249
intel/intel-optimized-pytorch,1.12.100,2022/10/19,48,59,8,1,0,116
rancher/rancher.github.io,2018-05-01,2018/04/17,69,67,109,41,9,295
continuumio/miniconda3,23.9.0-0,2023/10/23,123,41,56,7,0,227
redislabs/redis-di-cli,v0.117.0,2023/11/02,62,19,0,0,0,81
continuumio/anaconda,2019.10,2019/10/15,219,250,326,72,10,877
balenalib/raspberry-pi2,20230911,2023/09/11,118,37,38,6,0,199
balenalib/hummingboard-fedora-python,20221109,2022/11/16,0,1,0,0,0,1
balenalib/colibri-imx6dl-fedora-node,36-build-20220714,2022/07/22,0,1,1,0,0,2
dynatrace/easytravel-backend,7.1,2018/05/11,3,19,11,22,0,55
docker/ucp-kube-compose,3.3.1,2019/11/07,4,14,9,1,0,28
cockroachdb/locality-checker,0.1,2020/04/30,6,37,86,9,0,138
kasmweb/core-remnux-bionic,1.12.0,2022/12/01,260,1054,149,26,0,1489
balenalib/colibri-imx6dl-debian,20220714,2022/07/20,124,69,72,18,0,283
airbyte/destination-xata,0.1.1,2023/06/21,0,15,25,1,0,41
balenalib/raspberry-pi2-fedora-python,20221109,2022/12/02,0,1,0,0,0,1
rancher/kine,v0.10.3,2023/09/08,0,5,7,0,0,12
adobecoldfusion/coldfusionaddons2021,2021.0.3,2022/12/02,314,633,193,84,0,1224
newrelic/k8s-events-forwarder,1.48.1,2023/11/02,0,4,0,0,0,4
airbyte/destination-dev-null,0.3.0,2023/05/16,30,126,200,15,1,372
intel/language-modeling,tf-2.7.0-bert-large-fp32-training,2021/12/15,330,798,73,0,0,1201
intel/edge_video_analytics_microservice,0.7.2,2022/07/19,310,826,46,0,0,1182
bitnami/supabase-realtime,2.25.29,2023/11/14,74,13,6,2,0,95
balenalib/artik533s-golang,20220714,2022/07/22,473,263,219,28,1,984
objectscale/ciq-upload,webdav,2020/08/03,0,9,15,0,0,24
balenalib/kitra710-python,20230829,2023/09/02,118,38,38,6,0,200
mirantis/ucp-coredns,3.7.1,2023/08/09,0,3,2,0,0,5
apachepinot/pinot-base-runtime,21-openjdk,2023/10/15,189,55,53,1,0,298
docker/dtr-etcd,v2.2.4,2016/01/13,null
kasmweb/inkscape,1.14.0,2023/09/14,192,411,0,0,0,603
astronomerinc/ap-base,3.18.4-1,2023/11/02,0,3,0,0,0,3
hashicorp/vault-benchmark,0.2,2023/08/21,0,4,4,0,0,8
balenalib/jetson-tx2-debian-node,20231106,2023/11/07,114,23,28,4,0,169
airbyte/destination-mssql,0.2.0,2023/07/27,37,142,244,32,1,456
purestorage/k8s,v6.2.3,2022/07/22,0,22,35,0,0,57
portainer/helper-templates,linux-arm64,2020/08/26,null
balenalib/orangepi-plus2-golang,20230911,2023/09/11,448,109,72,9,0,638
vmware/lightwave-toolchain-photon,2.0.4,2018/08/14,49,267,243,76,0,635
balenalib/i386-openjdk,20231106,2023/11/06,118,44,23,4,0,189
bitnami/grafana-tempo-query,2.3.0,2023/11/08,74,15,10,2,0,101
docker/dtr-nginx,2.8.1,2020/06/17,2,10,9,1,0,22
airbyte/source-emailoctopus,0.1.0,2022/11/09,0,17,25,1,0,43
objectscale/transitionsvc,3.8.1.0-25.f6d9f2a,2022/12/12,12,64,51,3,3,133
rancher/pstauffer-curl,v1.0.3,2018/07/11,0,0,6,18,0,24
bitnami/wavefront-kubernetes-collector-archived,1.13.0,2023/05/21,0,2,4,0,0,6
vertica/vertica-logger,1.0.0,2021/12/15,0,12,14,1,0,27
adobecoldfusion/apimanageraddons2023,2023.0.0,2023/05/17,37,25,8,3,0,73
airbyte/destination-keen,0.2.4,2022/08/04,76,79,64,19,0,238
balenalib/hummingboard-alpine-openjdk,8-20230904,2023/09/09,8,10,6,2,0,26
circleci/golang,1.17.5,2021/12/18,542,442,388,69,2,1443
airbyte/source-oracle,0.4.0,2023/06/29,30,127,201,15,1,374
airbyte/source-todoist,0.1.0,2023/03/23,0,14,17,0,0,31
datadog/docker-dd-agent-build-rpm-x64,20180821,2018/07/27,0,3,10,3,0,16
balenalib/armv7hf-alpine-node,18.14.1-20231106,2023/11/07,0,3,3,0,0,6
bitnami/apache,2.4.58,2023/10/19,79,16,9,2,0,106
onlyoffice/docspace-zoom-router,1.0.0,2023/09/21,83,41,13,3,0,140
rancher/scheduler,v0.8.6,2019/01/22,306,388,24,0,0,718
balenalib/bananapi-m1-plus-python,20230904,2023/09/09,118,38,38,6,0,200
balenalib/raspberry-pi2-ubuntu,20231026,2023/11/02,37,8,0,0,0,45
docker/logs-explorer-extension,0.2.5,2023/10/30,0,2,2,0,0,4
mattermost/actions-runner,2.310.2-0,2023/10/18,159,200,29,0,0,388
intel/crypto-perf,0.28.0,2023/09/22,null
mirantis/salt,saltstack-ubuntu-xenial-salt-2018.3,2018/05/11,453,660,43,0,0,1156
grafana/agentctl,v0.37.4,2023/11/06,14,5,1,0,0,20
cockroachdb/cockroach-unstable-arm64v8,v2.0.0,2018/04/05,42,53,66,11,16,188
airbyte/source-salesforce,20211201-1,2021/12/02,0,21,50,8,0,79
rancher/k3k,v0.0.0-alpha7,2023/07/03,0,12,6,3,0,21
astronomerinc/ap-pgbouncer-krb,1.17.0-9,2023/06/12,0,6,0,0,0,6
balenalib/imx6ul-var-dart-alpine-golang,20231106,2023/11/07,0,2,2,0,0,4
balenalib/colibri-imx6dl-fedora-golang,20220507,2022/05/12,null
atlassian/artifactory-sidekick,staging-linux-arm64v8,0001/01/01,0,0,2,0,0,2
mongodb/mongodb-atlas-kubernetes-operator-prerelease,1.9.1-rc0,2023/10/19,3,3,0,0,0,6
astronomerinc/ap-po-pgbouncer,22.0,2022/07/18,0,0,0,1,0,1
mirantis/ucp-compose,3.7.1,2023/09/26,32,31,11,0,0,74
bitnami/notation,1.0.1,2023/11/09,74,13,6,2,0,95
balenalib/beaglebone-green-debian-openjdk,20230911,2023/09/11,129,65,42,6,0,242
balenalib/generic-armv7ahf-debian-golang,20230904,2023/09/09,448,109,72,9,0,638
onlyoffice/docs-example-de,6.2.2.17,2021/04/27,536,493,32,3,0,1064
objectscale/qualification-tool,1.4.0-110.4493033,2023/11/06,1,14,14,1,0,30
datadog/dd-lib-java-init,v1.23.0,2023/11/09,0,2,2,0,0,4
docker/dtr-postgres,2.8.1,2020/06/17,5,30,39,4,0,78
mattermost/mattermost-cloud-database-factory,9079426,2022/07/27,1,17,24,3,0,45
amazon/aws-codebuild-local,aarch64,2023/02/10,20,117,160,11,1,309
onlyoffice/trello-server,1.0.7,2023/11/15,0,2,2,0,0,4
docker/oscalkit,0.2.0,2019/02/07,0,0,0,2,0,2
airbyte/destination-cassandra,0.1.4,2022/08/26,76,76,64,19,0,235
puppet/pipelines,527601,2019/03/25,78,100,99,29,0,306
onlyoffice/4testing-docspace-bin-share,2.0.0.33,2023/11/15,null
balenalib/orbitty-tx2-ubuntu-node,20231103,2023/11/06,38,9,1,0,0,48
mirantis/dtr-postgres,2.9.14,2023/09/28,0,11,8,0,0,19
newrelic/infrastructure-k8s-unprivileged,1.8.0-beta,2019/04/12,0,0,0,2,0,2
pachyderm/kubeflow_worker,fix7,2018/03/07,0,2,2,2,0,6
balenalib/up-board-debian,20210825,2021/09/03,176,102,94,24,6,402
bitnami/logstash-exporter-archived,7.3.0,2022/05/16,130,77,75,23,6,311
balenalib/spacely-tx2-debian-golang,20231106,2023/11/07,442,81,51,5,0,579
rapidfort/cassandra-official,4.0.11,2023/11/14,2,8,6,0,0,16
docker/scout-sbom-indexer,974152c,2023/09/27,0,3,2,0,0,5
bitnami/kapacitor,1.7.1,2023/11/08,74,15,8,2,0,99
balenalib/am571x-evm-python,20220604,2022/06/12,124,82,74,20,0,300
balenalib/generic-armv7ahf-alpine-python,20230904,2023/09/09,2,3,5,2,0,12
objectscale/targetcfg,3.9.0.0-139102.b4b5064355c,2023/05/03,2,14,9,0,0,25
balenalib/kitra520-ubuntu-node,20220715,2022/08/02,88,82,12,0,0,182
nginx/nginx-prometheus-exporter,0.11,2022/09/07,null
bitnami/wildfly,30.0.0,2023/11/09,74,18,6,2,0,100
airbyte/source-unleash,0.1.0,2023/03/08,0,16,25,1,0,42
nginxinc/nginx-s3-gateway,unprivileged-oss-20231102,2023/11/02,81,21,5,1,0,108
datadog/agent-buildimages-windows_1809_x64,v3686353-1e75137,2021/01/12,8,47,132,12,0,199
balenalib/revpi-core-3-fedora,20221031,2022/11/04,null
rancher/drone-docker-image-digests,v0.0.13,2022/01/05,4,16,46,4,0,70
onlyoffice/4testing-docspace-api-system,2.0.0.33,2023/11/15,993,142,206,12,0,1353
ddosify/ddosify,v1.0.5,2023/07/17,0,14,9,1,0,24
snyk/driftctl,v0.40.0,2023/11/06,0,2,6,0,0,8
balenalib/jetson-tx1-alpine,20230530,2023/06/06,2,10,6,2,0,20
airbyte/source-wrike,0.2.0,2023/10/24,0,13,24,1,0,38
rancher/externalip-webhook,v1.0.1,2021/12/17,0,6,9,0,0,15
intel/user-oob-server-app-for-azure,v0.7,2022/09/06,185,450,43,0,0,678
pachyderm/example-group,2.1.0,2022/02/10,828,951,729,95,3,2606
kumahq/kuma-init,2.4.4,2023/11/06,22,8,3,0,0,33
kasmweb/core-nvidia-focal,develop-rolling,2022/05/13,497,1632,3,0,0,2132
bitnami/influxdb,2.7.4,2023/11/08,84,16,14,4,0,118
balenalib/imx6ul-var-dart-debian-python,20230911,2023/09/12,118,38,38,6,0,200
balenalib/am571x-evm-node,18.6-20220714,2022/07/21,124,71,73,18,0,286
docker/vpnkit-expose-port,07953236583a8938ef2681984c2b1441ac0a1656,2020/07/27,null
mirantis/ucp-calico-kube-controllers,3.7.1,2023/09/26,0,6,5,0,0,11
okteto/weaver,0.1.10,2023/01/17,0,5,13,0,0,18
okteto/kubelet-configurator,0.0.1,2021/03/03,130,85,84,31,7,337
kasmweb/core-kali-rolling,1.14.0,2023/09/09,null
primekey/signserver-ce,6.0.0.1,2023/11/13,8,67,36,6,0,117
puppet/lumogon,0.6.0,2018/05/23,null
vmware/vsan-prometheus-setup,v20210717,2021/07/17,14,95,108,45,0,262
ddosify/curlubuntutestapp,23.10,2023/10/12,18,7,4,0,0,29
balenalib/raspberry-pi2-ubuntu-python,20231026,2023/11/02,37,9,0,0,0,46
bitnami/joomla,5.0.0,2023/10/23,149,82,50,4,0,285
intel/rpbs_pipeline_application_web_service,1.0,2023/08/21,5,6,12,3,0,26
google/apigee-synchronizer,1.8.0-preview.2,2022/02/18,9,28,27,3,4,71
bitnami/elasticsearch,8.11.1,2023/11/13,170,70,34,5,0,279
grafana/grafana-enterprise,10.2.1,2023/11/14,0,2,3,0,0,5
kasmweb/vivaldi,1.14.0,2023/09/14,187,379,0,0,0,566
balenalib/spacely-tx2-ubuntu,20231103,2023/11/06,37,8,0,0,0,45
ngrok/ngrok-docker-extension,0.1.5,2023/03/21,0,19,7,0,0,26
mirantis/ucp-csi-snapshotter,3.5.3,2022/04/05,0,0,0,0,6,6
kong/ubi-kuma-cp,2.4.4,2023/11/06,30,29,8,0,0,67
rancher/mirrored-istio-citadel,1.5.9,2020/08/07,406,1087,142,0,0,1635
redislabs/redisai,1.2.5,2021/10/28,222,283,30,0,0,535
newrelic/k8s-nri-jmx,2.4.3,2020/01/22,93,42,17,0,0,152
rapidfort/wordpress,6.3.1,2023/10/17,100,63,36,3,0,202
balenalib/orbitty-tx2-alpine-golang,20231106,2023/11/06,0,2,2,0,0,4
balenalib/artik10-openjdk,20220714,2022/07/22,157,128,83,18,0,386
pachyderm/mnist_pipeline,v1.0.4,2022/01/14,831,990,738,95,3,2657
bitnami/nginx-ingress-controller,1.9.4,2023/11/09,86,20,19,4,0,129
vmware/powerclicore,13.1,2023/05/05,181,293,33,0,0,507
mirantis/ucp-gatekeeper,3.7.1,2023/04/14,0,3,3,0,0,6
ubuntu/chiselled-jre,8-22.04_31,2023/06/19,null
astronomerinc/ap-pgbouncer-exporter,0.15.0-3,2023/11/02,0,3,0,0,0,3
appdynamics/appdynamics-cloud-db-collector,23.6.0-780,2023/06/26,0,3,9,0,0,12
rancher/mirrored-cilium-certgen,v0.1.9,2023/08/02,0,1,1,0,0,2
airbyte/source-pinterest,0.7.1,2023/11/01,64,22,6,1,0,93
purestorage/docker-plugin,v3.10,0001/01/01,null
airbyte/source-plausible,0.1.0,2022/11/17,0,17,25,1,0,43
docker/cruise-user-shell,17.06,2018/01/25,233,404,18,0,0,655
balenalib/zynq-xz702-debian-golang,20220714,2022/07/28,473,260,213,28,1,975
rancher/gitjob,v0.1.108,2023/11/13,null
bitnami/metallb-controller,0.13.12,2023/11/08,74,13,6,2,0,95
ngrok/ngrok-ingress-controller,0.2.0,2022/12/27,0,2,3,0,0,5
intel/intel-gpu-plugin,0.28.0,2023/09/22,null
balenalib/asus-tinker-board-alpine-node,18.14.1-20231106,2023/11/07,0,3,3,0,0,6
airbyte/source-kyriba,0.1.0,2022/07/13,0,21,51,8,0,80
balenalib/nitrogen6x-golang,20220714,2022/07/28,473,260,213,28,1,975
balenalib/up-board,20210825,2021/09/03,176,102,94,24,6,402
rancher/mirrored-calico-typha,v3.26.3,2023/10/06,0,2,2,0,0,4
airbyte/octavia-cli,0.50.7,2023/07/11,151,84,61,10,0,306
rancher/mirrored-kiali-kiali,v1.76.0,2023/10/30,36,6,4,0,0,46
docker/ucp-cfssl,3.3.1,2020/06/26,2,8,9,1,0,20
balenalib/intel-nuc-ubuntu-golang,20230911,2023/09/11,147,146,23,0,0,316
mirantis/ucp-kube-dns,3.2.15,2021/06/29,0,0,0,2,0,2
kumahq/kuma-prometheus-sd,1.8.8,2023/07/28,0,13,10,0,0,23
onlyoffice/4testing-docspace-migration-runner,2.0.0.33,2023/11/15,73,12,11,2,0,98
balenalib/rpi,20231106,2023/11/07,107,35,29,4,0,175
docker/ucp-secureoverlay-agent,3.3.1,2020/06/26,2,8,9,1,0,20
airbyte/source-marketo,1.2.2,2023/10/15,64,22,6,1,0,93
balenalib/up-board-fedora-python,20231103,2023/11/04,null
docker/ucp-kube-dns-dnsmasq-nanny-s390x,3.1.0-beta3,2018/10/04,null
mirantis/ucp-istio-node-agent-k8s,3.4.15,2020/06/17,472,1165,148,0,0,1785
onlyoffice/box-builder,1.0.1,2023/09/12,0,6,6,0,0,12
circleci/mongo,5.0.6,2022/02/22,106,174,7,0,0,287
amazon/aws-glue-streaming-libs,glue_streaming_libs_4.0.0_image_01,2023/09/21,52,216,379,99,0,746
snyk/code-agent,1.20.9,2023/10/27,0,0,2,1,0,3
pingidentity/pingtoolkit,2310,2023/11/01,0,7,8,0,0,15
portainer/gosec,v2.6.1-5-g1a0acdf,2021/02/01,6,23,56,15,0,100
datadog/serverless-buildpack,beta8,1980/01/01,0,3,4,0,0,7
google/apigee-stackdriver-logging-agent,1.8.9-2,2021/11/01,1,11,26,2,4,44
bitnami/kubeapps-apprepository-controller,2.9.0,2023/11/08,0,3,2,0,0,5
rancher/metadata,v1.0.7,2017/09/26,306,388,24,0,0,718
airbyte/source-snowflake,0.2.2,2023/10/24,10,43,60,18,0,131
rapidfort/curl,7.88.1,2023/06/02,0,8,6,0,0,14
vertica/kafka-scheduler,23.4.0,2023/11/08,null
hashicorp/envoy-fips,v1.26.4,2023/08/21,7,2,1,0,0,10
ddosify/alaz,v0.2.2,2023/10/30,0,4,3,0,0,7
rapidfort/wordpress-ib,6.2.2,2023/09/28,57,57,3,0,0,117
balenalib/beaglebone-green-wifi-ubuntu-python,20230911,2023/09/11,42,10,4,0,0,56
circleci/rust,1.57.0,2021/12/18,846,1025,783,101,3,2758
balenalib/bananapi-m1-plus-fedora-python,20221109,2022/11/16,0,1,0,0,0,1
balenalib/beaglebone-green-wifi-ubuntu-golang,20230911,2023/09/11,141,146,23,0,0,310
rancher/opni-opensearch-fetcher,v0.5.4,2022/07/26,8,72,69,4,11,164
balenalib/artik533s-alpine-golang,20220803,2022/08/04,8,39,38,12,0,97
solace/solace-pubsub-connector-ibmmq,1.1.1,2023/11/08,71,37,0,1,0,109
mattermost/playbooks-circleci,v2022-12-23,2022/12/23,489,1287,51,0,0,1827
balenalib/i386,20231106,2023/11/06,107,21,21,4,0,153
grafana/k6-grpcbin,v0.3.1,2023/08/23,0,4,6,0,0,10
couchbase/admission-controller,2.5.0,2023/08/14,0,2,1,0,0,3
balenalib/zynq-xz702-debian,20220714,2022/07/20,124,69,72,18,0,283
rancher/migration-agent,v0.1.0-rc8,2021/08/30,0,10,32,1,0,43
airbyte/source-dv-360,0.1.0,2022/09/27,0,21,51,8,0,80
balenalib/orbitty-tx2-ubuntu-golang,20231103,2023/11/06,139,131,0,0,0,270
grafana/drone,write-access-approve,2023/10/25,3,11,14,1,0,29
balenalib/via-vab820-quad-ubuntu,20220714,2022/08/02,87,81,11,0,0,179
okteto/cloud-proxy,0.2,2018/10/16,0,1,3,0,0,4
newrelic/k8s-nri-rabbitmq,2.2.1,2020/01/29,2,11,29,4,0,46
rancher/terraform-operator-executor,v0.0.5,2019/03/26,8,14,31,7,0,60
nginx/nginx-ingress,3.3.2,2023/11/01,81,21,6,1,0,109
hashicorp/consul-aws,0.1.2,2020/04/07,6,21,53,6,0,86
bellsoft/liberica-openjre-alpine,21.0.1-12,2023/11/14,0,2,2,0,0,4
intel/oact-mps,v2.12.5,2023/11/01,0,2,0,0,0,2
airbyte/normalization-redshift,0.4.3,2023/05/12,492,378,329,49,2,1250
kong/koko,v0.1.0,2022/09/27,0,13,16,0,0,29
balenalib/ts4900-alpine,20220714,2022/07/19,7,37,33,10,0,87
intel/mcss_covid19_grafana,2021.4.2,2021/12/16,5,31,66,9,0,111
puppet/iac_release,2.3.0-pre7,2021/09/16,1421,1334,948,145,37,3885
rancher/os2,v0.1.0-alpha13,2021/12/01,15,68,50,1,0,134
docker/ucp-swarm,3.3.1,2020/06/26,2,8,9,1,0,20
rancher/kubectl,v1.28.3,2023/10/23,null
mirantis/ucp-kube-ingress-controller,3.7.1,2023/09/08,2,4,7,2,0,15
balenalib/revpi-core-3-debian-node,20230530,2023/07/02,118,39,39,6,0,202
adobecoldfusion/apimanageraddons2018,2018.0.0,2021/09/16,106,171,8,3,0,288
bitnami/fluxcd-image-reflector-controller,0.30.0,2023/11/08,74,15,7,2,0,98
balenalib/zynq-xz702,20220714,2022/07/20,124,69,72,18,0,283
balenalib/hummingboard-python,20230904,2023/09/09,118,38,38,6,0,200
balenalib/raspberrypi3-ubuntu-python,20231026,2023/11/02,37,9,0,0,0,46
bitnami/spring-cloud-skipper-shell,2.11.1,2023/10/13,74,13,8,4,0,99
rancher/log-aggregator,v0.1.8,2021/08/04,56,26,0,0,0,82
mirantis/k8s-appcontroller,v0.4,2017/01/10,0,12,22,5,0,39
kong/kuma-init,2.4.4,2023/11/06,22,8,4,0,0,34
astronomerinc/ap-astro-ui,0.33.6,2023/11/14,null
onlyoffice/docspace-studio,1.1.4.1,2023/10/23,993,143,209,12,0,1357
balenalib/i386-ubuntu-python,20210826,2021/09/21,105,168,8,0,0,281
airbyte/source-facebook-pages,0.3.0,2023/06/26,0,15,25,1,0,41
kumahq/install-cni,0.0.10,2022/05/19,6,19,21,0,0,46
balenalib/beaglebone-black-debian-golang,20230911,2023/09/12,448,109,72,9,0,638
balenalib/parallella-ubuntu-golang,20230904,2023/09/09,141,146,23,0,0,310
balenalib/parallella-python,20230904,2023/09/09,118,38,38,6,0,200
airbyte/source-gutendex,0.1.0,2022/10/20,0,17,25,1,0,43
airbyte/source-hubspot,1.7.0,2023/11/01,64,22,6,1,0,93
docker/ucp-controller-s390x,3.1.0-beta3,2018/10/04,0,2,6,16,0,24
airbyte/source-aircall,0.2.0,2023/07/27,0,15,24,1,0,40
newrelic/newrelic-k8s-operator,0.5.0,2023/11/13,0,3,2,0,0,5
bitnami/argo-workflow-cli,3.5.1,2023/11/08,null
mirantis/rethinkdb,2.4.3-mirantis-44-5296d3f,2023/05/10,4,14,13,2,0,33
intel/esp-uos-kernel,v3.1.2,2023/07/25,null
balenalib/colibri-imx6dl,20220714,2022/07/20,124,69,72,18,0,283
balenalib/intel-nuc-debian-node,20231106,2023/11/06,114,23,28,4,0,169
vmware/lightwave-sts,1.3.1,2017/10/26,34,188,244,119,0,585
grafana/loki,2.9.2,2023/10/25,0,3,3,0,0,6
airbyte/destination-local-json,0.2.11,2022/07/12,76,76,62,19,0,233
objectscale/pravega-operator,0.5.7-309-5fc87406,2023/07/20,2,14,18,0,0,34
intel/intel-ethernet-operator-daemon,v1.0.0,2023/07/26,32,37,7,0,0,76
sysdig/agent-kmodule,12.17.1,2023/10/24,150,37,0,0,0,187
rancher/rio-website,build,2018/08/09,55,31,59,15,9,169
airbyte/source-google-sheets,0.3.11,2023/10/15,64,22,6,1,0,93
docker/transfused,8599be9b5485e04530a593e23095a4726f67970b,2017/07/04,null
appdynamics/dotnet-agent,20.6.0-micro,2020/07/20,0,4,3,2,0,9
rancher/mirrored-flannelcni-flannel-cni-plugin,v1.2.0,2022/12/05,null
solace/pubsubplus-prometheus-exporter,1.0.1,2023/11/10,15,13,0,0,0,28
grafana/metaconvert,2.10.4,2023/11/13,0,2,2,0,0,4
airbyte/source-zenefits,0.2.0,2023/10/31,0,13,24,1,0,38
airbyte/destination-mariadb-columnstore,0.1.7,2022/09/09,80,97,103,34,0,314
intel/esp-core,v3.1.4,2023/08/23,null
intel/intel-qat-initcontainer,0.28.0,2023/09/22,null
airbyte/source-azure-blob-storage,0.2.3,2023/11/13,128,39,11,2,0,180
rancher/secrets-flexvol,855c1d5,2016/09/15,97,122,23,0,0,242
rancher/mirrored-istio-sidecar_injector,1.5.9,2020/08/07,405,1084,142,0,0,1631
kasmweb/core-alpine-318,1.14.0,2023/09/09,2,12,14,2,0,30
grafana/fluent-plugin-loki,2.9.2-amd64,2023/10/25,202,306,248,34,6,796
percona/percona-backup-mongodb,2.3.0,2023/11/02,71,26,3,0,0,100
docker/demo,v1.2.2,2018/10/02,0,0,0,2,0,2
onlyoffice/4testing-appserver-backup-background,test-2022081607,2022/08/16,1014,332,356,24,1,1727
balenalib/asus-tinker-board-alpine,20231106,2023/11/07,0,2,2,0,0,4
rapidfort/mongodb,7.0.2,2023/10/20,34,6,9,2,0,51
objectscale/postgres-operator-upgrade,ubi8-5.1.2-0,2022/07/05,67,86,16,0,0,169
balenalib/jetson-tx1-fedora-openjdk,8-20230530,2023/06/08,null
greenbone/openvas-smb-build,v22.5.4,2023/10/17,246,58,28,2,0,334
circleci/buildpack-deps,21.04,2021/02/20,38,488,26,0,0,552
kong/kumactl,2.4.4,2023/11/06,7,2,3,0,0,12
intel/envoy,1.19.0-intel.0,2023/11/13,17,3,0,0,0,20
rancher/hardened-etcd,v3.5.9-k3s1-build20231009-s390x,2023/10/10,2,8,12,0,2,24
datadog/dd-lib-ruby-init,v1.16.2,2023/11/10,0,2,2,0,0,4
airbyte/postgres-singer-source-abprotocol,0.1.0,2020/10/20,594,408,393,42,11,1448
bellsoft/buildpacks.alpaquita-base,musl,2023/04/04,null
docker/ucp-hrm-s390x,2.2.22,2019/10/07,2,11,9,1,0,23
bitnami/natscli,0.1.1,2023/11/09,74,14,10,2,0,100
rancher/cluster-proportional-autoscaler-amd64,1.3.0,2018/10/01,null
kasmweb/core-parrotos-5,1.14.0,2023/09/09,null
balenalib/raspberrypi3-debian,20230911,2023/09/11,118,37,38,6,0,199
docker/scout-cli,8832496,2023/09/05,0,5,4,0,0,9
balenalib/ts4900-ubuntu,20220714,2022/08/02,87,81,11,0,0,179
airbyte/destination-bigquery-denormalized,2.0.0,2023/07/15,34,137,240,30,1,442
balenalib/artik710-alpine-openjdk,8-20230904,2023/09/09,8,10,6,2,0,26
okteto/gitlab,0.1,2020/03/19,15,61,73,9,0,158
airbyte/source-declarative-manifest,0.53.6,2023/11/14,0,3,3,0,0,6
vmware/lightwave-toolchain-photon2,1.0.4,2019/10/09,57,330,393,123,0,903
bitnami/user-broker-archived,0.3.1,2022/01/16,130,84,87,23,6,330
rancher/mirrored-longhornio-csi-node-driver-registrar,v2.7.0,2022/12/28,0,3,3,0,0,6
balenalib/amd64-debian,20231106,2023/11/06,107,21,21,4,0,153
balenalib/amd64-alpine,20231106,2023/11/07,0,2,2,0,0,4
atlassian/crucible,4.8.13,2023/10/27,160,190,26,6,0,382
balenalib/beaglebone-green-ubuntu-node,20230911,2023/09/12,43,10,5,0,0,58
rancher/k8s-dns-dnsmasq-nanny,1.15.10,2020/03/05,16,17,19,8,1,61
balenalib/artik5-debian-openjdk,20220714,2022/07/22,157,128,83,18,0,386
balenalib/apalis-imx6q-alpine-openjdk,8-3.14-20220112,2022/01/19,2,50,42,13,0,107
rancher/hardened-runc,v1.0.0-rc92,2020/09/24,257,405,18,3,0,683
rancher/harvester-network-webhook,v0.3.5,2023/08/29,1,6,8,0,1,16
airbyte/source-mysql-strict-encrypt,3.1.5,2023/11/01,8,38,58,18,0,122
redislabs/k8s-controller,7.2.4-7,2023/09/19,61,32,4,0,0,97
objectscale/csi-baremetal-halmgr,0.69.0,2021/03/07,7,80,98,5,2,192
balenalib/asus-tinker-board-s-node,20230911,2023/09/12,118,39,39,6,0,202
airbyte/source-greenhouse,0.4.3,2023/09/27,64,24,6,1,0,95
bitnami/metallb-speaker,0.13.12,2023/11/08,74,13,6,2,0,95
rancher/thanos,v0.10.1,2020/01/24,2,13,16,0,0,31
balenalib/orangepi-plus2-fedora-python,20221109,2022/11/16,0,1,0,0,0,1
docker/pipeline_unpacker,0.2.0-alpha,2017/04/04,0,1,5,2,0,8
continuumio/anaconda3,2023.09-0,2023/09/29,125,64,74,10,0,273
onlyoffice/4testing-appserver-doceditor,test-2022081607,2022/08/16,975,362,498,45,7,1887
appdynamics/ad-nite-nodejs-services,2019-03-13-1552509464,2019/03/13,88,105,206,45,12,456
intel/tadk-waf,v23.03.0,2023/05/25,84,109,41,0,0,234
rancher/longhorn-orc,1135b84,2017/04/12,251,343,20,0,0,614
objectscale/manager-pre-update,0.60.0,2020/12/12,0,6,10,0,0,16
pingidentity/pingdataconsole,2310,2023/11/01,1,6,4,3,0,14
balenalib/artik710-fedora-openjdk,8-20230530,2023/06/08,null
rancher/mirrored-jaegertracing-all-in-one,1.49.0,2023/09/07,0,2,4,0,0,6
nginxinc/mra-fakes3,1.2.1,2018/01/16,0,9,24,7,0,40
airbyte/source-coinmarketcap,0.1.1,2022/11/01,0,17,25,1,0,43
bitnami/elasticsearch-curator-archived,5.8.4,2022/07/03,111,73,63,16,0,263
rapidfort/couchdb-official,3.2.3,2023/11/01,22,5,1,1,0,29
bitnami/concourse,7.11.0,2023/11/09,91,21,18,4,0,134
kong/kuma-prometheus-sd,1.9.8,2023/07/28,0,13,13,0,0,26
pachyderm/nvidia_driver_install,1870632b4853800ea8f4b0756c2033cab93e60f3,2017/05/10,0,1,5,2,0,8
atlassian/escalator,v1.13.2,2023/07/13,0,6,2,0,0,8
balenalib/rpi-python,20231106,2023/11/07,107,36,29,4,0,176
docker/for-desktop-kernel-grpcfuse,05437be5d71eb91706b1073d42b9a24851c6f6ff,2021/11/15,null
okteto/falco-renovator,0.5,2021/06/17,199,163,233,51,14,660
balenalib/beaglebone-black-debian-node,20230911,2023/09/12,118,39,39,6,0,202
rancher/storage-ebs,v0.9.8,2019/10/02,192,249,16,2,0,459
balenalib/am571x-evm,20220714,2022/07/20,124,69,72,18,0,283
grafana/doc-validator,7770886,1970/01/01,0,5,8,0,0,13
objectscale/objectscale-service-tools,2.71.3,2021/04/14,18,131,156,6,7,318
docker/dtr-garant-s390x,2.5.0-beta3,2018/01/17,0,16,41,34,0,91
airbyte/tool-link-checker,0.1.0,2020/11/03,3,19,45,8,0,75
couchbase/operator-backup,6.6.0-102,2021/02/09,13,11,7,0,0,31
newrelic/k8s-metadata-injection,1.22.0,2023/11/13,0,2,2,0,0,4
objectscale/objectscale-insideiq,1.4.0-397.adb0726,2023/11/13,0,3,2,0,0,5
redhat/ubi9-micro,9.3-6,2023/11/01,3,1,0,0,0,4
datadog/ci,v2.23.1,2023/11/10,0,2,2,0,0,4
purestorage/realtime-metrics,1.0.21,2023/11/13,null
balenalib/generic-armv7ahf-alpine-golang,20230904,2023/09/09,2,2,5,2,0,11
balenalib/orangepi-plus2-python,20230911,2023/09/11,118,38,38,6,0,200
onlyoffice/docspace-urlshortener,test,2022/09/08,971,361,502,46,7,1887
rancher/mirrored-k8scsi-csi-provisioner,v2.1.0,2020/12/18,0,5,13,0,5,23
ubuntu/grafana,10.0.3-22.04,2023/10/05,22,11,5,0,0,38
balenalib/jetson-tx2-fedora-openjdk,8-20231106,2023/11/06,null
airbyte/destination-chroma,0.0.5,2023/10/27,64,8,5,4,0,81
google/dart-hello,2.16-beta,2021/12/13,190,105,121,39,9,464
grafana/drone-git,2023-01-12-windows-amd64,2019/08/06,0,5,4,2,0,11
airbyte/source-plaid,0.4.0,2023/08/17,0,15,24,1,0,40
airbyte/config,0.39.0-alpha,2022/05/11,0,6,8,1,0,15
rancher/longhornio-longhorn-share-manager,v1_20220808-s390x,2022/08/08,7,59,31,3,11,111
rancher/shell,v0.1.22,2023/10/20,0,16,12,0,2,30
rancher/coredns-coredns,1.8.3,2021/02/24,1,6,11,0,0,18
graphcore/pytorch,3.3.0,2023/07/03,146,189,27,0,0,362
datadog/cluster-agent-dev,1.0.1,2018/11/14,null
balenalib/beaglebone-black-alpine,20231106,2023/11/07,0,2,2,0,0,4
balenalib/kitra710-fedora-node,20230712,2023/07/16,0,1,1,0,0,2
airbyte/source-openweather,0.2.0,2023/08/31,0,15,24,1,0,40
balenalib/raspberry-pi2-debian-python,20230911,2023/09/12,118,38,38,6,0,200
pachyderm/imap_spout,1.11,2020/09/03,1475,1445,1072,153,37,4182
bitnami/acmesolver,1.13.2,2023/11/08,74,13,6,2,0,95
vmware/vke-mutentca-plugin-toolchain-photon2,1.0.2,2018/12/13,62,354,459,153,0,1028
balenalib/stem-x86-32-alpine-golang,20221109,2022/11/17,6,30,33,11,0,80
mirantis/ucp-rethinkdb-exporter,3.7.1,2023/09/26,2,1,6,2,0,11
balenalib/artik710,20230904,2023/09/09,118,37,38,6,0,199
balenalib/artik10-fedora-openjdk,8-20220224,2022/03/05,null
couchbase/service-broker,1.2.1,2022/04/09,0,3,5,0,0,8
balenalib/kitra710-alpine,20230904,2023/09/09,2,2,5,2,0,11
bellsoft/buildpacks.builder,musl,1980/01/01,2,28,14,0,0,44
rancher/system-agent-installer-rke2,v1.28.3-rke2r2-windows-1809-amd64,2023/11/08,null
rancher/heapster-amd64,v1.6.0-beta.1,2018/08/06,null
rancher/mirrored-prom-node-exporter,v1.0.1,2020/06/16,0,5,10,0,0,15
rancher/openpolicyagent-gatekeeper,v3.3.0,2021/01/28,0,7,14,0,4,25
docker/dockerfile-copy,v0.1.9,2018/10/31,null
okteto/docker-proxy,0.1.1,2019/08/27,2,27,10,5,0,44
airbyte/source-rss,0.1.0,2022/11/10,0,15,17,0,0,32
balenalib/generic-armv7ahf-openjdk,20230904,2023/09/09,129,65,42,6,0,242
rancher/coreos-prometheus-config-reloader,v0.43.0,2020/10/27,0,1,1,0,0,2
datadog/dev-dd-agent,5202rc1,2017/12/05,50,127,106,41,20,344
sysdig/agent-kmodule-thin,12.17.1,2023/10/24,150,37,0,0,0,187
rancher/os-xfce,v0.8.2,2017/02/23,47,67,7,0,0,121
newrelic/k8s-nri-nagios,2.6.0,2020/01/20,null
balenalib/rpi-node,16.19.1-20231106,2023/11/07,107,37,30,4,0,178
rancher/goharbor-harbor-registryctl,v1.7.5,2019/04/01,14,63,88,37,0,202
grafana/agent-build-image,0.30.3,2023/10/16,818,254,198,13,0,1283
atlassian/pipelines-awscli,1.29.35,2023/08/28,1,2,2,1,0,6
hashicorp/boundary-enterprise,0.14.2-ent,2023/10/31,0,3,0,0,0,3
docker/ucp-calico-cni-s390x,3.1.0-beta3,2018/10/04,null
rancher/library-nginx,1.19.2-alpine-s390x,2020/08/14,10,32,60,7,0,109
jetbrains/teamcity-minimal-agent,2023.05.4,2023/09/19,37,68,84,9,0,198
objectscale/logging-injector,3.9.0.0-1588.729cf194,2023/04/25,4,33,27,0,0,64
rancher/cert-manager-controller,v0.11.0-rio.1,2019/10/22,0,0,0,0,6,6
rancher/harvester-support-bundle-utils,master-head,2021/05/28,4,25,39,8,0,76
rapidfort/fluentd,1.16.2,2023/10/17,30,7,2,1,0,40
bitnami/owncloud-archived,10.11.0,2022/12/22,153,202,95,10,0,460
airbyte/source-gnews,0.1.3,2023/01/17,0,16,25,1,0,42
airbyte/source-serpstat,0.1.0,2023/08/22,0,15,24,1,0,40
circleci/redis,7.0-rc1,2022/02/22,73,31,36,15,0,155
intel/intel-extension-for-pytorch,2.1.0-pip-mulitnode,2023/10/23,122,144,4,0,0,270
airbyte/destination-kafka,0.1.10,2022/08/04,76,79,64,19,0,238
pachyderm/seldon-pachyderm-rsi-trainer,0.1.2,2021/02/10,104,69,77,31,7,288
bitnami/ejbca,8.0.20230531,2023/09/23,79,64,55,14,0,212
purestorage/ccm-go,1.2.0,2023/11/14,0,3,2,0,0,5
balenalib/i386-debian,20231106,2023/11/06,107,21,21,4,0,153
kasmweb/unityhub,1.14.0,2023/09/14,189,380,3,0,0,572
balenalib/i386-nlp-golang,1.11.13-20200529,2021/04/12,661,402,358,53,9,1483
bitnami/fluxcd-notification-controller,1.1.0,2023/11/08,74,16,8,2,0,100
airbyte/source-insightly,0.2.0,2023/11/14,0,13,24,1,0,38
kasmweb/ubuntu-bionic-dind,develop-rolling,2022/03/18,272,877,21,0,0,1170
pachyderm/example-spout101,2.0.2,2023/02/17,802,598,348,25,0,1773
vmware/restreview-appserver,V2,2017/12/31,221,865,632,149,57,1924
airbyte/source-sonar-cloud,0.1.1,2023/02/27,0,16,25,1,0,42
balenalib/artik10-alpine-openjdk,8-jre-20220803,2022/08/04,34,78,46,10,0,168
rancher/minio-minio,RELEASE.2020-07-13T18-09-56Z,2020/07/13,11,35,74,8,0,128
grafana/snyk_exporter,v1.12,2023/02/06,0,1,1,0,0,2
balenalib/i386-debian-golang,20231106,2023/11/06,441,80,51,5,0,577
newrelic/es-operator,dev,2019/04/03,4,14,8,2,0,28
mirantis/ucp-secureoverlay-agent,3.7.1,2023/09/26,2,2,6,2,0,12
rancher/os-console,3929481,2017/02/09,null
intel/ctk_loadkey,v2.4,2023/10/15,37,14,0,0,0,51
objectscale/crunchy-pgadmin4,ubi8-4.30-2,2022/07/05,258,246,50,0,0,554
bitnami/java,21.37.0,2023/10/01,191,94,52,7,0,344
bitnami/multus-cni,4.0.2,2023/11/08,74,22,12,2,0,110
kasmweb/core-alpine-317,1.14.0,2023/09/09,6,57,35,11,0,109
rancher/confd-base,v0.1.0,2015/09/15,null
continuumio/anaconda2,2019.10,2019/10/15,219,250,326,72,10,877
google/apigee-mint-task-scheduler,1.10.0,2023/05/09,5,17,12,0,4,38
balenalib/colibri-imx6dl-ubuntu-node,20220715,2022/07/19,88,103,12,0,0,203
lacework/perf-test,lw-jmeter-docker,2022/11/18,446,870,93,3,0,1412
balenalib/beaglebone-black-ubuntu-golang,20230530,2023/07/02,173,176,39,0,0,388
balenalib/i386-nlp-ubuntu-node,6.17.1-20190503,2021/04/10,109,240,49,2,0,400
objectscale/crunchy-pgbouncer,ubi8-1.16-4,2022/07/05,235,174,40,0,0,449
intel/oneapi-dlfdkit,2023.1.0-devel-ubuntu22.04,2023/04/03,228,280,48,0,0,556
airbyte/source-clickhouse,0.1.17,2023/03/22,30,130,203,15,1,379
docker/ucp-metrics,3.3.1,2020/06/26,2,8,9,1,0,20
balenalib/asus-tinker-board-fedora-openjdk,30-20210825,2021/09/03,null
balenalib/via-vab820-quad-alpine-openjdk,8-3.14-20220112,2022/01/19,2,50,42,13,0,107
onlyoffice/4testing-docs-docservice,lt,2020/11/26,536,493,32,3,0,1064
rancher/istio-coredns-plugin,0.2-istio-1.1,2019/03/06,331,452,37,0,0,820
grafana/enterprise-metrics,v2.10.4,2023/11/14,0,2,2,0,0,4
rancher/mirrored-sig-storage-csi-provisioner,v3.6.2,2023/11/09,null
appdynamics/infraagent-cnao,23.10.0-4872-ecs-amd64,2023/10/20,0,3,1,0,0,4
balenalib/apalis-imx6q-fedora-python,20220622,2022/07/12,0,1,1,0,0,2
rancher/mirrored-sig-storage-livenessprobe,v2.11.0,2023/09/13,0,2,2,0,0,4
rancher/kubernetes-auth,v0.0.8,2017/08/17,312,392,24,0,0,728
mirantis/ucp-blackbox-exporter,3.7.1,2023/09/26,2,3,5,2,0,12
google/drone-firebase,0.1,2016/07/01,26,170,155,42,0,393
balena/balena-base-ui,10.0.1,2023/09/11,396,214,127,13,8,758
grafana/enterprise-logs-boringcrypto,v1.8.4,2023/10/18,0,4,3,0,0,7
docker/ucp-etcd-s390x,3.1.0-beta3,2018/10/04,0,2,6,16,0,24
hashicorp/counting-service,0.0.2,2018/11/14,0,0,0,2,0,2
pachyderm/pachctl-amd64,97276071e371d5b1ea221437e99cfd87b5599ddf,2023/11/03,95,21,28,2,0,146
rapidfort/consul-ib,1.14.9,2023/08/27,26,18,5,0,0,49
bitnami/jmx-exporter,0.20.0,2023/11/10,72,12,6,2,0,92
amazon/amazon-lightsail,hello-world,2020/11/19,29,364,307,59,1,760
balenalib/qemux86-64-ubuntu-openjdk,11-xenial-20230911,2023/09/11,null
bitnami/minio,2023.11.11,2023/11/11,84,15,13,4,0,116
pachyderm/tf_job_s3_gateway_minio,1.9.2,2019/07/31,462,741,176,18,0,1397
solace/solace-pubsub-connector-gcppubsub,1.1.0,2023/09/27,71,50,6,1,0,128
balenalib/i386-ubuntu-node,12.16.3-20200518,2020/05/29,162,255,34,3,0,454
balenalib/beaglebone-green-ubuntu-golang,20230911,2023/09/12,141,146,23,0,0,310
grafana/automatic-aliases,7770886,1970/01/01,0,2,2,0,0,4
ubuntu/memcached,1.6-23.10_edge,2023/11/07,12,3,0,0,0,15
rancher/istio-proxyv2,1.8.3,2021/02/05,302,918,127,2,0,1349
kasmweb/slack,1.10.0,2021/11/16,308,898,21,0,0,1227
balenalib/stem-x86-32-alpine-openjdk,8-20230712,2023/08/01,10,16,7,2,0,35
airbyte/destination-snowflake-bulk,3.2.3-dev.cc832795bb,2023/11/14,10,43,60,18,0,131
kasmweb/super-tux-kart,1.14.0,2023/09/14,187,379,0,0,0,566
pachyderm/config-pod,0.6,2022/02/10,0,6,10,0,0,16
onlyoffice/ffvideo,6.0,2023/04/13,37,11,0,0,0,48
intel/intel-dlb-plugin,0.28.0,2023/09/22,null
objectscale/objectscale-telemetry,vinod,2020/08/12,0,7,11,0,0,18
airbyte/source-pivotal-tracker,0.1.1,2023/10/25,0,13,24,1,0,38
airbyte/source-webflow,0.1.2,2022/07/14,0,18,25,1,0,44
appdynamics/appdynamics-cloud-otel-collector,23.10.0-1163,2023/10/19,0,2,2,0,0,4
hashicorp/consul-dataplane-fips,1.3,2023/11/06,29,22,5,0,0,56
balenalib/raspberrypi3-ubuntu-golang,20231026,2023/11/02,133,131,0,0,0,264
bitnami/harbor-notary-signer,2.8.4,2023/09/15,83,178,227,2,0,490
intel/reconfigurable-ri-viewer,4.0,2022/12/21,56,55,96,23,10,240
rancher/mirrored-calico-node,v3.26.3,2023/10/06,31,6,3,0,0,40
objectscale/csi-baremetal-node,0.69.0,2021/03/07,99,178,30,0,0,307
balenalib/hummingboard-debian,20230904,2023/09/09,118,37,38,6,0,199
appdynamics/machine-agent,23.10.0,2023/10/30,128,32,4,1,0,165
docker/dev-environments-javascript,639923ad2c5ce6f29a24ca8d11c8f38f9206c462,2021/06/21,1099,732,872,89,26,2818
balenalib/armv7hf-python,20230929,2023/10/02,111,38,33,6,0,188
airbyte/source-zuora,0.1.3,2021/10/22,0,21,50,8,0,79
balena/open-balena-base,16.0.13,2023/11/02,336,88,56,5,2,487
airbyte/source-google-drive,0.0.2,2023/11/14,128,39,11,2,0,180
cimg/python,3.12.0,2023/10/07,291,331,48,0,0,670
airbyte/destination-azure-blob-storage,0.2.1,2023/09/21,12,63,69,20,0,164
airbyte/cloud-workers,no-check-3,2023/11/15,12,54,66,4,1,137
graphcore/tensorflow-minimal,2-intel-3.3.0-ubuntu-20.04-20230703,2023/07/03,141,279,50,1,0,471
intel/intelligent_traffic_management_cloud_connector_dev,2.0,2022/12/06,61,88,13,0,0,162
balenalib/via-vab820-quad-openjdk,20210602,2021/06/05,230,233,143,39,8,653
intel/intel-fpga-initcontainer,0.28.0,2023/09/22,null
balenalib/apalis-imx6q-debian-openjdk,20210602,2021/06/05,230,233,143,39,8,653
kong/cloudtrail-integration,1.0.0,2023/02/06,4,85,68,1,1,159
kasmweb/ubuntu-focal-dind,1.14.0,2023/09/14,220,489,2,0,0,711
redislabs/operator,804_c4987427,2019/06/05,null
bitnami/redis,7.2.3,2023/11/09,75,14,6,2,0,97
vmware/photon-controller-ui,1.0.0,2016/11/08,80,215,219,104,23,641
purestorage/telemetry-envoy,1.1.10,2023/11/14,0,2,1,0,0,3
rancher/agent-instance,v0.8.3,2016/06/14,419,519,58,1,0,997
okteto/godev,1,2021/07/05,698,450,418,63,9,1638
airbyte/temporal-auto-setup,1.13.0,2021/10/20,4,54,162,5,0,225
docker/engine-community,18.09.9,2019/09/04,null
rancher/mirrored-prometheus-node-exporter,v1.3.1,2021/12/05,0,4,8,0,0,12
apachepinot/pinot,1.0.0,2023/10/15,6,36,102,27,0,171
balenalib/qemux86-64-fedora-node,20231103,2023/11/04,0,1,1,0,0,2
balenalib/ts4900-fedora,20220604,2022/06/12,null
rancher/hello-world,v0.1.2,2018/06/29,0,4,8,22,0,34
kasmweb/alpine-318-desktop,1.14.0,2023/09/14,8,49,75,10,0,142
balena/aarch64-supervisor,1299,2020/07/31,6,26,55,9,0,96
balenalib/armv7hf-alpine,20231106,2023/11/07,0,2,2,0,0,4
airbyte/destination-teradata,0.1.3,2023/09/25,12,55,68,20,0,155
rancher/opni-kibana-dashboard,v0.1.3,2021/09/14,0,2,25,4,0,31
lacework/k8scollector,6.10.0,2023/11/10,60,17,0,0,0,77
bitnami/couchdb,3.3.2,2023/10/11,84,15,13,4,0,116
airbyte/source-zendesk-support,20211125-1,2021/11/25,0,21,50,8,0,79
astronomerinc/ap-statsd-exporter,0.24.0,2023/09/25,0,2,1,0,0,3
balenalib/up-board-ubuntu,20230911,2023/09/11,42,9,4,0,0,55
airbyte/source-recreation,0.1.0,2022/11/17,0,17,25,1,0,43
mirantis/terratrain,tt-54,2023/05/30,64,123,145,6,0,338
airbyte/source-mongodb,0.3.3,2021/07/20,0,14,46,5,0,65
airbyte/destination-weaviate,0.2.9,2023/11/13,64,22,8,4,0,98
airbyte/source-redshift,0.4.0,2023/06/29,30,128,212,18,1,389
greenbone/gsa,22.9,2023/11/14,94,17,15,2,0,128
continuumio/conda_builder_linux,5.11-5.2-1-4,2016/12/02,0,4,7,4,0,15
solaceiotteam/apim-connector-server,0.10.1,2023/05/09,774,457,305,24,0,1560
redhat/ubi8-micro,8.8-7,2023/09/13,21,11,3,0,0,35
datadog/cluster-agent,7.50.0-rc.2,2023/11/14,11,1,1,0,0,13
graphcore/tensorflow-paperspace,3.3.0,2023/07/03,221,437,51,1,0,710
balenalib/aarch64-python,20231106,2023/11/07,107,22,21,4,0,154
rancher/rancher-runtime,v2.7.1,2023/01/24,12,72,82,3,0,169
airbyte/airbyte-postgres-destination-abprotocol,0.1.0,2020/10/20,101,76,79,24,6,286
balenalib/asus-tinker-board-ubuntu,20231026,2023/11/02,37,8,0,0,0,45
pachyderm/mnist_klflow_example,1.9.3,2019/08/27,757,1086,170,9,0,2022
objectscale/statefuldaemonset-operator,3.9.0.0-1588.729cf194,2023/04/25,4,33,30,0,0,67
airbyte/init,0.50.34,2023/11/09,null
balenalib/artik710-ubuntu-golang,20230904,2023/09/09,147,146,23,0,0,316
pachyderm/script_to_pipeline,v0.1.0,2022/04/13,828,951,729,95,3,2606
rancher/k3c,v0.3.0-alpha.0,2021/01/22,3,12,15,0,0,30
grafana/grafana,9799770991,2023/03/02,0,11,9,0,0,20
vmware/restreview-ui,V2,2018/01/08,57,179,187,66,22,511
rancher/hardened-crictl,v1.19.0,2020/09/25,260,420,36,3,0,719
rancher/rancher-ecr-credentials-windows,v3.0.0,2018/03/08,null
kong/kuma-cni,2.4.4,2023/11/06,7,2,3,0,0,12
rancher/mirrored-amazon-aws-cli,2.9.14,2023/01/11,16,61,122,7,1,207
kasmweb/vlc,1.14.0,2023/09/14,217,482,0,0,0,699
airbyte/source-whisky-hunter,0.1.0,2022/10/21,0,17,25,1,0,43
kasmweb/core-ubuntu-focal,1.14.0,2023/09/09,187,379,0,0,0,566
grafana/test-exporter,log-span-e1ab5495e-WIP5,2019/06/28,0,0,0,2,0,2
grafana/drone-runner-docker,1.0.0,2021/04/08,3,13,14,0,0,30
bitnami/jenkins-exporter-archived,0.20171225.0,2022/03/30,135,82,79,24,6,326
mattermost/mm-te-test,9729641,2023/04/18,224,195,113,19,6,557
grafana/build-container,1.7.7,2023/09/18,947,259,197,17,5,1425
balenalib/stem-x86-32-debian-golang,20230904,2023/09/09,448,111,72,9,0,640
opensearchproject/opensearch-dashboards,2.11.0,2023/11/09,0,2,0,2,0,4
rancher/harvester-upgrade,v1.2.1,2023/10/26,0,11,12,0,0,23
balenalib/zynq-xz702-alpine,20220714,2022/07/19,7,37,33,10,0,87
datadog/dogstatsd-socat-proxy,beta,2017/07/03,0,19,15,6,0,40
grafana/openshift-cloud-log-forwarder-bundle,v1.0.2,2022/03/08,null
airbyte/source-railz,0.1.1,2023/02/23,0,16,25,1,0,42
balenalib/armv7hf-node,20230929,2023/10/02,111,39,34,6,0,190
datadog/dd-trace-java-docker-build,17,2023/02/06,430,713,69,0,0,1212
docker/labs-debug-tools-kubeservice,dev,2023/09/14,13,41,22,4,0,80
mattermost/ops-tool-daily,v0.0.10,2022/06/27,3,17,5,0,0,25
astronomerinc/ap-keda-metrics-apiserver,2.3.0,2021/06/30,0,5,12,1,4,22
cockroachdb/ccloud-builder,20220523-223313,2022/05/23,403,937,66,0,0,1406
balenalib/parallella-ubuntu-python,20230904,2023/09/09,42,10,4,0,0,56
nginxinc/ngx-rust-tool,1.26.0,2018/05/14,391,548,37,0,0,976
intel/language-translation,tf-2.7.0-transformer-mlperf-fp32-training,2021/12/15,330,798,73,0,0,1201
kong/jenkins,1.2.31,2023/06/05,135,47,53,10,0,245
balenalib/kitra520-openjdk,20220714,2022/07/22,157,128,83,18,0,386
balenalib/generic-aarch64-fedora-golang,20231106,2023/11/06,null
bitnami/rmq-messaging-topology-operator,1.12.1,2023/11/09,null
airbyte/source-iterable,0.1.30,2023/07/20,151,84,61,10,0,306
rapidfort/prometheus,2.47.1,2023/10/17,18,12,6,0,0,36
pachyderm/pachctl-arm64,97276071e371d5b1ea221437e99cfd87b5599ddf,2023/11/03,95,21,28,2,0,146
grafana/grafana-oss-dev,10.3.0-146415,2023/11/15,0,2,2,0,0,4
balenalib/stem-x86-32-alpine-python,20230712,2023/07/25,2,7,6,2,0,17
bitnami/gradle,8.4.0,2023/10/11,84,17,15,4,0,120
solaceiotteam/platform-api-server,0.0.12,2021/04/12,226,404,426,91,8,1155
bitnami/debian-base-buildpack,stretch-r4,2022/01/11,108,101,147,20,3,379
balena/balena-rethinkdb,0.0.3,2019/01/22,139,286,204,38,15,682
airbyte/destination-pubsub,0.2.0,2022/12/02,29,130,212,15,1,387
pachyderm/python-evaluate,sigmoid,2018/02/19,0,26,19,10,0,55
bitnami/cert-manager,1.13.2,2023/11/08,74,13,7,2,0,96
bitnami/airflow-worker,2.7.3,2023/11/10,224,87,46,4,0,361
pachyderm/cert-manager-controller,v0.15.1,2020/05/27,0,0,0,0,6,6
balenalib/beaglebone-black-ubuntu,20231026,2023/11/02,37,8,0,0,0,45
intel/intel-extension-for-tensorflow,2.13.0.0-xpu,2023/07/31,46,20,5,0,0,71
rancher/rancher-webhook,v0.4.0,2023/10/23,0,1,6,0,0,7
bitnami/rclone,1.64.2,2023/11/09,74,14,7,2,0,97
datadog/dd-trace-php,7.4-buster-debug-asan,2019/08/26,1097,790,930,154,14,2985
amazon/aws-sam-cli-emulation-image-java8.al2,20220125,2022/01/25,5,28,19,10,1,63
rapidfort/traefik-ib,v2.10.5,2023/10/25,83,42,1,0,0,126
airbyte/normalization-mssql,0.4.3,2023/05/12,521,391,334,53,2,1301
pingidentity/pingdirectory,2310,2023/11/01,3,13,7,0,0,23
bitnami/harbor-portal,2.9.1,2023/11/08,74,13,6,2,0,95
newrelic/k8s-webhook,0.0.3,2019/09/09,6,20,12,1,0,39
airbyte/source-mailgun,0.2.1,2023/10/31,0,13,24,1,0,38
balenalib/intel-nuc-alpine-node,20231106,2023/11/07,0,3,3,0,0,6
vmware/chartmuseum-photon,dev,2018/08/10,8,70,104,51,0,233
onlyoffice/docspace-telegram-service,test,2022/09/08,1014,332,356,22,1,1725
mattermost/pillar,test,2021/03/02,2,19,39,5,0,65
intel/its-search-image-by-image,master-ae213cd97d6931b1d44fc7689867cf5701e0f15d,2023/09/23,70,30,16,5,0,121
balenalib/bananapi-m1-plus-alpine,20231106,2023/11/07,0,2,2,0,0,4
rancher/mirrored-appscode-kubed,v0.13.2,2023/01/11,0,5,10,1,0,16
cockroachdb/bazel,20231114-194628,2023/11/14,168,177,5,0,0,350
balenalib/armv7hf-alpine-openjdk,8-20231106,2023/11/07,0,2,2,0,0,4
balenalib/beaglebone-green-wifi-python,20230911,2023/09/12,118,38,38,6,0,200
balenalib/artik10-debian-node,20220714,2022/07/20,124,71,73,18,0,286
snyk/snyk-pipe,1.0.0,2023/09/15,482,303,106,16,0,907
kong/ubi-kuma-dp,2.4.4,2023/11/06,30,31,10,0,0,71
airbyte/destination-pulsar,0.1.3,2022/08/05,77,90,71,19,0,257
airbyte/source-exchange-rates,1.3.0,2023/08/25,0,15,24,1,0,40
continuumio/concourse-rsync-resource,master,2023/07/13,0,8,2,0,0,10
hashicorp/consul-enterprise,1.10.4,2021/11/11,3,29,45,3,0,80
ubuntu/dotnet-aspnet,7.0_beta,2023/11/01,null
docker/labs-debug-tools-service,0.0.44,2023/11/14,13,38,20,4,0,75
bitnami/symfony,6.3.8,2023/11/10,151,84,50,4,0,289
newrelic/cli,v0.76.3,2023/11/15,0,2,3,0,0,5
grafana/plugin-build-report-service,0.0.6,2022/03/23,2,24,49,6,0,81
rancher/coreos-flannel,v0.12.0,2020/03/13,5,15,16,3,0,39
rancher/pipeline-tools,v0.1.16,2021/06/28,6,31,72,19,0,128
couchbase/server-sandbox,7.2.3,2023/11/10,21,5,0,0,0,26
intel/intel-dsa-plugin,0.28.0,2023/09/22,null
netdata/package-builders,ubuntu23.10-v1,2023/11/15,86,83,4,0,0,173
redhat/ubi9,9.3-1361,2023/11/01,118,43,2,0,0,163
airbyte/source-shopify-oauth,0.1.0,2023/07/20,0,15,25,1,0,41
rancher/cert-manager-webhook,v0.11.0-rio.1,2019/10/22,0,0,0,0,6,6
intel/intel-xpumanager-sidecar,0.28.0,2023/09/22,null
bitnami/clickhouse,23.10.3,2023/11/11,75,16,7,2,0,100
mattermost/notice-file-generator,v0.0.5,2023/04/12,0,2,4,0,0,6
rancher/alertmanager-helper,v0.0.2,2018/02/13,43,94,10,0,0,147
airbyte/normalization-snowflake,0.4.3,2023/05/12,492,378,329,49,2,1250
rapidfort/elasticsearch,8.10.3,2023/10/17,34,13,4,2,0,53
onlyoffice/docs-example,7.5.1-1,2023/11/09,1072,326,203,7,0,1608
rancher/longhornio-csi-attacher,v3.4.0,2021/12/21,0,4,7,0,0,11
jetbrains/correttowrapper,17.0.5,2023/01/06,29,77,128,8,1,243
rancher/prometheus-federator,v0.3.4,2023/07/13,0,6,3,0,1,10
airbyte/source-tplcentral,0.1.1,2022/11/29,0,17,25,1,0,43
greenbone/data-objects,202311150504,2023/11/15,null
airbyte/source-typeform,1.1.2,2023/10/27,64,22,6,1,0,93
google/apigee-fluent-bit,1.9.9,2022/09/28,28,30,21,2,0,81
lacework/lacework-proxy-scanner,0.23.2,2023/11/10,0,4,9,0,0,13
redislabs/redis-connect-gemfire,0.5.0-139,2022/01/22,3,29,32,12,0,76
datadog/dogstatsd-dev,7.46.0-devel.git.33.79ca82b.pipeline.15281127,2023/04/26,0,10,2,0,0,12
intel/generative-ai,tf-flex-gpu-stable-diffusion-inference,2023/08/31,46,20,7,0,0,73
pachyderm/pachd-arm64,97276071e371d5b1ea221437e99cfd87b5599ddf,2023/11/03,0,6,4,0,0,10
balenalib/orangepi-plus2-alpine-golang,20231106,2023/11/07,0,2,2,0,0,4
intel/intelligent_traffic_management_dashboard,2.0,2022/11/15,62,89,15,0,0,166
intel/intelligent_traffic_management_rule_engine,2.0,2022/11/09,61,84,12,0,0,157
grafana/cortex-grafanacloud,v0.6.0,2020/07/23,6,36,51,4,0,97
airbyte/destination-cumulio,0.1.0,2023/04/20,827,933,698,81,1,2540
jetbrains/qodana-dotnet,2023.2,2023/09/06,159,87,125,18,0,389
pachyderm/estimate-pi-spark,0.3,2018/07/20,122,447,590,257,39,1455
balenalib/artik530-ubuntu-openjdk,20210826,2021/09/21,136,435,10,0,0,581
rancher/longhorn-test,version-test.2-2.1-1.1-1,2018/06/18,58,97,13,0,0,168
airbyte/source-looker,0.2.8,2023/01/06,0,16,25,1,0,42
vmware/postgresql-photon,v1.5.2,2018/07/18,11,70,117,36,0,234
rapidfort/postgresql-official,15.2,2023/03/01,46,25,16,1,0,88
airbyte/source-mixpanel-singer,0.2.4,2021/07/06,565,318,282,39,7,1211
balenalib/odroid-c1-alpine-openjdk,8-3.14-20220112,2022/01/19,2,50,42,13,0,107
balena/open-balena-haproxy,4.3.1,2023/06/28,2,12,6,5,0,25
balenalib/qemux86-64-alpine,20231106,2023/11/07,0,2,2,0,0,4
rancher/k3os,v0.19.5-rc.1,2021/01/05,null
grafana/docker-slack-message,9834170,2023/09/03,0,2,2,0,0,4
kong/release-script,1.28.0,2023/11/14,0,2,2,0,0,4
balenalib/colibri-imx6dl-debian-node,18.6-20220714,2022/07/21,124,71,73,18,0,286
airbyte/source-qualaroo,0.3.0,2023/10/25,0,13,24,1,0,38
kasmweb/redirector,1.0.0,2019/06/02,135,190,2,0,0,327
formio/uswds-viewer,5.3.4,2023/11/08,206,176,1,0,0,383
docker/proxyv2,1.1.2,2019/04/12,446,623,51,0,0,1120
datadog/envoy-apm-experimental,1962f1461148b4c1a6a072740b877708deeb2051,2018/10/01,54,72,12,0,0,138
grafana/alertmanager-webhook-logger,0.3,2021/07/16,0,2,1,0,0,3
grafana/agent-crow,v0.22.0,2022/01/20,94,36,52,13,6,201
rancher/coreos-flannel-cni,v0.3.0,2017/09/12,null
bitnami/prometheus-operator,0.69.1,2023/11/09,74,13,6,2,0,95
nginx/unit,1.29.1-ruby3.1,2023/02/28,779,591,343,23,0,1736
objectscale/objectscale-manager-pre-update,0.71.3,2021/04/07,2,17,20,0,0,39
rapidfort/airflow-ib,2.6.3,2023/09/20,0,1,0,0,0,1
intel/rpbs_pipeline_management_service,1.1,2023/08/30,819,1165,63,0,0,2047
vmware/tern,testimage,2020/02/08,null
balenalib/artik530-alpine-openjdk,8-jre-20220803,2022/08/04,34,78,46,10,0,168
kong/pulp-resource-manager,1.1.38,2022/08/24,4,11,9,4,0,28
bitnami/harbor-jobservice,2.9.1,2023/11/08,84,16,14,4,0,118
atlassian/jira-performance-tests,4748205,2021/05/13,167,336,29,0,0,532
rancher/plugins-docker,18.09,2020/04/16,0,9,0,2,0,11
rancher/longhorn-ui,5528110,2017/04/13,180,740,697,228,56,1901
greenbone/gvm-libs-build,v23.3.0,2023/03/30,502,202,150,13,0,867
rancher/metadata-windows,v0.10.0,2017/12/11,null
balenalib/bananapi-m1-plus-debian-python,20230904,2023/09/09,118,38,38,6,0,200
greenbone/gsad-build,22.8,2023/11/14,482,113,76,9,0,680
rancher/os-zfs,v1.5.8,2021/02/05,1504,1921,1458,206,37,5126
rancher/istio-install-cni,1.8.3,2021/02/05,301,934,154,0,0,1389
airbyte/source-senseforce,0.1.1,2023/03/02,0,16,25,1,0,42
balenalib/jetson-tx2-fedora-python,20231106,2023/11/06,null
balenalib/artik5-alpine-python,20220803,2022/08/04,7,38,35,10,0,90
airbyte/source-stripe,4.5.3,2023/11/14,64,22,6,1,0,93
airbyte/gitx,90f68c3,2023/02/20,3,22,18,1,0,44
bitnami/jenkins,2.414.3,2023/11/02,113,19,32,7,0,171
mirantis/ucp-node-feature-discovery,3.7.1,2023/09/26,32,42,22,0,0,96
balenalib/beaglebone-green-openjdk,20230911,2023/09/11,129,65,42,6,0,242
bitnami/cosign,2.2.1,2023/11/08,74,13,6,2,0,95
appdynamics/ad-air-mysql-db,java,2021/01/15,139,75,103,27,6,350
airbyte/normalization-mysql,0.4.3,2023/05/12,492,378,329,49,2,1250
grafana/rollout-operator,v0.9.0,2023/11/14,0,2,2,0,0,4
rancher/pause-amd64,3.1,2017/12/20,null
intel/intel-optimized-tensorflow,2.9.1,2023/01/06,66,63,10,0,0,139
balenalib/imx6ul-var-dart-alpine-python,20231106,2023/11/07,0,3,2,0,0,5
ambassador/aes-eg-ext,v4.0.0-preview.2.dev.1,2023/10/27,0,1,1,0,0,2
rancher/calico-kube-controllers,v3.18.1,2021/03/10,0,8,16,0,0,24
rancher/os-udev,v0.7.1,2016/11/11,null
balenalib/raspberry-pi2-fedora,20221031,2022/11/04,null
atlassian/ssh-ubuntu,0.2.2,2019/09/16,265,386,39,0,0,690
bitnami/argo-workflow-exec,3.5.1,2023/11/08,74,13,7,2,0,96
grafana/docs-base,20231115,2023/11/15,0,14,4,3,0,21
balenalib/odroid-xu4-debian-python,20230911,2023/09/11,118,38,38,6,0,200
balenalib/intel-nuc-debian,20231106,2023/11/06,114,21,27,4,0,166
appdynamics/machine-agent-netviz,23.5.0,2023/06/30,58,151,4,0,0,213
balenalib/via-vab820-quad-fedora-openjdk,30-20210825,2021/09/03,null
balenalib/amd64-fedora,20231103,2023/11/04,null
rancher/mirrored-longhornio-csi-snapshotter,v6.2.1,2023/01/04,0,3,3,0,0,6
rapidfort/haproxy24-ib,v2.4.24,2023/10/25,83,37,0,0,0,120
dynatrace/easytravel-pluginservice,2.0.0.3599,2023/08/04,31,15,45,12,0,103
intel/intel-fpga-plugin,0.28.0,2023/09/22,null
onlyoffice/4testing-docs-proxy-de,7.5.1-1-saas,2023/11/08,0,0,1,1,0,2
google/dart-runtime-base,2.16-beta,2021/12/13,190,105,121,39,9,464
astronomerinc/ap-init,3.18.4-2,2023/11/06,0,3,0,0,0,3
rancher/os-autoformat,v0.7.1,2016/11/11,null
rancher/pipeline-docker-publish,v0.2.0,2018/07/23,0,8,3,3,0,14
rancher/cli,v2.0.4,2018/08/10,0,8,0,2,0,10
bitnami/harbor-adapter-clair-archived,2.5.1,2022/06/20,97,68,58,18,0,241
bitnami/airflow-scheduler,2.7.3,2023/11/10,215,86,38,3,0,342
vmware/photon-2.0-kube-apiserver-amd64,v1.10.2-20180619,2018/06/19,15,81,98,70,0,264
mirantis/ucp-alertmanager,3.7.1,2023/09/26,2,2,4,2,0,10
mattermost/mattermost-build-redux,20210125_node-11.3-1,2018/12/08,609,1686,1396,322,16,4029
newrelic/k8s-nri-mysql,1.4.0,2019/11/25,null
balenalib/kitra520-ubuntu-openjdk,20210826,2021/09/21,136,435,10,0,0,581
balenalib/zynq-xz702-ubuntu-golang,20220523,2022/06/03,222,535,46,0,0,803
grafana/alpine,3.15.4,2022/04/05,0,12,8,1,0,21
objectscale/csi-attacher,v1.0.1,2018/12/05,0,0,0,2,0,2
dynatrace/easytravel-nginx,7.1,2018/05/11,62,136,141,48,23,410
grafana/grafana-ci-deploy,1.3.3,2022/07/20,17,52,36,3,0,108
onlyoffice/documentserver-integration,4.4.3.7,2017/08/11,323,467,31,1,0,822
grafana/query-tee,2.10.4,2023/11/13,0,2,2,0,0,4
airbyte/source-okta,0.1.16,2023/07/07,151,84,61,10,0,306
airbyte/source-amazon-seller-partner,1.6.2,2023/11/14,64,22,6,1,0,93
objectscale/csi-node-driver-registrar,v2.5.0,2022/02/03,0,4,6,0,0,10
rancher/mirrored-prometheus-alertmanager,v0.25.0,2022/12/22,0,4,4,0,0,8
airbyte/source-smartsheets,1.1.1,2023/06/07,77,26,20,2,0,125
airbyte/source-hellobaton,0.2.0,2023/08/24,0,15,24,1,0,40
appdynamics/db-agent,23.9.0-3436,2023/09/29,0,2,3,0,0,5
bitnami/gotrue,1.0.1,2023/11/08,74,18,17,2,0,111
bitnami/matomo,4.15.1,2023/10/11,156,84,55,5,0,300
kasmweb/oracle-7-desktop,1.14.0,2023/09/14,0,14,34,0,0,48
kasmweb/core-almalinux-9,1.14.0,2023/09/09,0,11,830,0,0,841
bitnami/jax,0.4.20,2023/11/03,77,15,7,2,0,101
balenalib/artik5-alpine-node,20220803,2022/08/04,7,38,34,10,0,89
balenalib/asus-tinker-board-alpine-python,20231106,2023/11/07,0,3,2,0,0,5
balenalib/raspberrypi3-alpine-python,20231106,2023/11/07,0,3,2,0,0,5
rancher/hardened-build-base,v1.21.3b1,2023/10/13,0,7,4,0,0,11
grafana/cortex-query-frontend,w37-0193e7b7,2018/09/11,0,0,0,2,0,2
redislabs/rcp-kubectl,4719504c7e53b421448a2f2e329a9c19,2020/04/02,181,336,45,1,0,563
objectscale/crunchy-postgres,ubi8-14.4-0,2023/08/30,252,96,16,0,0,364
appdynamics/machine-agent-analytics-arm64,23.10.0,2023/10/30,94,30,4,1,0,129
datadog/agent-buildimages-circleci-runner_test_only,v23305348-a2473651,2023/11/14,124,162,2,0,0,288
balenalib/via-vab820-quad-ubuntu-python,20220622,2022/06/23,87,112,13,0,0,212
rancher/mirrored-openpolicyagent-gatekeeper-crds,v3.13.0,2023/08/08,0,2,2,0,0,4
balenalib/orbitty-tx2-alpine-node,20231106,2023/11/06,0,3,3,0,0,6
newrelic/amazon-k8s-cni,246b3c71,2019/05/25,38,347,270,34,1,690
airbyte/source-snapchat-marketing,0.3.0,2023/06/13,0,16,25,1,0,42
rapidfort/vault,1.12.0,2023/02/15,0,6,7,0,0,13
balenalib/aarch64-debian-golang,20231106,2023/11/07,441,81,51,5,0,578
balenalib/artik710-fedora-python,20230712,2023/07/16,0,1,0,0,0,1
onlyoffice/4testing-docspace-webhooks-service,test-2022112110,2022/11/21,1010,307,327,19,0,1663
docker/github-actions,v1.1.0,2020/04/22,2,10,31,4,0,47
airbyte/source-firebolt,1.0.0,2023/08/23,1,15,24,1,0,41
grafana/grafana-enterprise-arm32v7-linux,7.0.6,2020/07/09,4,30,54,9,0,97
balenalib/stem-x86-32-ubuntu-python,20210826,2021/09/22,105,174,8,0,0,287
balenalib/intel-nuc,20231106,2023/11/06,114,21,27,4,0,166
docker/telemetry-tgz,1.0.0.linux-x86_64-test,2017/08/01,null
pachyderm/seldon-pachyderm-rsi-server,0.1.2,2021/02/10,105,78,85,32,7,307
rancher/k3d-proxy,5.3,2022/02/03,8,55,78,9,0,150
onlyoffice/docs-proxy-ee,7.5.1-1,2023/11/09,0,0,1,1,0,2
rancher/mirrored-cilium-hubble-relay,v1.14.4,2023/11/13,null
dynatrace/easytravel-angular-frontend,2.0.0.3599,2023/08/04,31,28,57,17,0,133
rancher/10-openvmtools,v0.8.0-rc9,2017/02/09,3,28,2,0,0,33
dynatrace/dynatrace-gcp-monitor,v1-latest,2023/09/21,65,26,6,1,0,98
balenalib/artik5-fedora,20220714,2022/07/23,null
intel/flexran_vdu,v22.07,2022/12/07,147,283,55,0,0,485
okteto/hello-world,1.0.0,2020/03/26,2,10,29,4,0,45
balenalib/nitrogen6x-debian,20220714,2022/07/20,124,69,72,18,0,283
bitnami/kong,3.4.2,2023/10/12,160,57,38,3,0,258
google/apigee-istio-citadel,1.4.6,2020/02/22,651,1308,152,0,0,2111
balenalib/zynq-xz702-alpine-python,20220714,2022/07/19,7,38,35,10,0,90
rancher/harvester-node-manager,v0.1.8,2023/08/29,4,8,11,0,1,24
airbyte/source-file-secure,0.3.13,2023/10/13,65,25,6,2,0,98
onlyoffice/documentserver-ee-ucs,7.5.1.1,2023/11/08,116,106,3,1,0,226
balenalib/amd64-alpine-node,20231106,2023/11/07,0,3,3,0,0,6
balenalib/spacely-tx2-fedora-node,20231106,2023/11/06,0,1,1,0,0,2
portainer/volume-browser,develop,2018/07/16,null
balenalib/kitra710-alpine-openjdk,8-20230904,2023/09/09,8,10,6,2,0,26
cockroachdb/bazel-fips,20230815-175543,2023/08/15,152,205,19,0,0,376
kong/nightly-ingress-controller,2023-11-15,2023/11/15,null
balenalib/generic-aarch64-ubuntu-node,20231103,2023/11/06,38,9,1,0,0,48
onlyoffice/4testing-docspace-proxy-runtime,v1.0.0,2023/09/04,153,261,19,0,0,433
pachyderm/rrt-modeling,sort,2018/02/20,0,26,19,10,0,55
bitnami/cluster-autoscaler,1.28.0,2023/11/08,74,15,13,2,0,104
airbyte/source-pokeapi,0.2.0,2023/10/11,0,14,24,1,0,39
onlyoffice/docspace-api,1.1.4.1,2023/10/23,993,143,209,12,0,1357
rancher/k8s-codegen,1.11,2018/11/27,310,494,31,0,0,835
bitnami/jenkins-agent,0.3192.0,2023/10/27,84,15,13,4,0,116
rancher/opdom,v0.1.0,2022/12/07,4,55,29,0,10,98
airbyte/source-cockroachdb-strict-encrypt,0.1.22,2023/03/22,30,129,203,15,1,378
okteto/crontab,0.0.6,2020/10/10,2,10,32,4,0,48
newrelic/k8s-nri-consul,2.0.3,2019/10/25,null
airbyte/source-coda,1.2.0,2023/08/25,0,15,24,1,0,40
airbyte/integration-singer-exchangeratesapi_io-source,0.1.3,2020/10/07,2,26,48,11,0,87
cockroachdb/cockroach-django-builder,20211210,2021/12/10,347,965,65,0,0,1377
vmware/vke-infra-toolchain,1.0.1,2018/09/21,17,136,210,102,0,465
balenalib/aarch64-fedora,20231106,2023/11/06,null
okteto/rails,6,2020/07/22,1361,1133,1066,120,19,3699
docker/ucp-dsinfo-s390x,3.1.0-beta3,2018/10/04,131,358,15,4,0,508
docker/kube-compose-controller,v0.5.0,2022/02/14,0,6,14,1,0,21
docker/kube-compose-installer,v0.5.0,2022/02/14,0,6,14,1,0,21
atlassian/bitbucket-mesh,2.2.0,2023/11/11,62,65,2,0,0,129
bitnami/harbor-registryctl,2.9.1,2023/11/08,74,14,7,2,0,97
docker/ucp-auth,3.3.1,2020/06/26,2,8,9,1,0,20
rancher/mirrored-cluster-proportional-autoscaler,1.8.6,2022/07/27,0,3,5,1,0,9
rancher/os-vboxtools,v5.2.26-5,2019/08/13,34,21,36,6,7,104
balenalib/apalis-imx6q-ubuntu-node,20220715,2022/07/19,88,103,12,0,0,203
balenalib/amd64-ubuntu-python,20230929,2023/10/07,39,10,4,0,0,53
bitnami/mongodb-sharded,7.0.3,2023/11/10,84,15,13,4,0,116
balenalib/artik530-ubuntu-python,20220715,2022/08/02,87,82,13,0,0,182
rancher/support-bundle-kit,v0.0.29,2023/10/30,0,2,5,0,0,7
hashicorp/envconsul,0.13.2,2023/05/22,0,12,3,3,0,18
rancher/mirrored-bci-micro,15.4.14.3,2022/09/26,0,5,2,0,2,9
docker/getting-started,vscode,2020/07/08,6,22,48,6,0,82
airbyte/source-retently,0.2.0,2023/08/08,0,15,24,1,0,40
ubuntu/prometheus,2.46.0-22.04,2023/10/05,22,18,6,0,0,46
rancher/os-openvmtools,10.3.10-2,2019/05/10,47,46,44,7,7,151
balenalib/odroid-xu4-ubuntu-python,20231026,2023/11/02,37,9,0,0,0,46
nginxinc/amplify-agent,1.8.1,2023/02/02,116,123,76,6,0,321
mattermost/backup-restore-tool,8005000,2023/03/28,0,20,11,0,0,31
puppet/tlser,1.3.2,2021/06/30,0,3,7,0,0,10
objectscale/objectscale-portal,1.4.0-337.edaba629,2023/11/14,null
bitnami/harbor-notary-signer-archived,2.8.4,2023/09/15,83,178,227,2,0,490
onlyoffice/4testing-ds-example-de,6.2.0-eu-r2,2021/03/04,536,493,32,3,0,1064
balenalib/fincm3-node,20230530,2023/07/02,118,39,39,6,0,202
balenalib/artik530-debian-node,20220714,2022/07/20,124,71,73,18,0,286
jetbrains/qodana-php,2023.2,2023/09/06,493,162,135,16,0,806
airbyte/source-prestashop,1.0.0,2023/06/27,151,84,61,10,0,306
balenalib/odroid-c1-debian,20220714,2022/07/20,124,69,72,18,0,283
datadog/chaos-controller,8.3.0,2023/10/26,11,5,1,0,0,17
mirantis/ucp-controller,3.7.1,2023/09/26,4,5,8,2,0,19
balenalib/asus-tinker-board-fedora-golang,20221210,2022/12/13,null
docker/ucp-hyperkube-s390x,3.1.0-beta3,2018/10/04,173,435,12,0,0,620
kasmweb/rockylinux-8-desktop,1.14.0,2023/09/14,0,17,812,0,0,829
mirantis/mysql,5.6,2018/09/19,39,51,49,11,15,165
balenalib/apalis-imx6q-node,18.6-20220714,2022/07/21,124,71,73,18,0,286
mirantis/ucp-agent,3.7.1,2023/09/26,4,5,8,2,0,19
docker/dtr-rethink,2.8.1,2020/06/17,3,10,15,1,0,29
rapidfort/telegraf,1.28.2,2023/10/17,18,5,4,0,0,27
balenalib/am571x-evm-debian,20220714,2022/07/20,124,69,72,18,0,283
mirantis/dtr-api,3.0.0-alpha.2,2021/09/22,5,32,53,5,0,95
airbyte/source-xero,0.2.3,2023/06/19,0,13,17,0,0,30
vmware/photon-2.0-pause-amd64,v1.10.2-20180619,2018/06/19,null
balenalib/i386-ubuntu-golang,1.20.1-xenial-20230911,2023/09/11,null
balenalib/spacely-tx2-alpine-openjdk,8-20231106,2023/11/06,6,8,2,0,0,16
balenalib/qemux86-64-alpine-golang,20231106,2023/11/07,0,2,2,0,0,4
rapidfort/mariadb-official,10.10.5,2023/06/09,1,4,1,0,0,6
kasmweb/almalinux-9-desktop,1.14.0,2023/09/14,0,14,860,0,0,874
grafana/beyla,1.0.0,2023/11/14,55,7,2,1,0,65
vmware/photon-2.0-kubernetes-dashboard-amd64,v1.8.3-20180619,2018/06/19,null
intel/power-operator,v2.3.1,2023/08/28,0,3,2,0,0,5
balenalib/odroid-c1-fedora,20220604,2022/06/12,null
grafana/grafana-dev-arm64v8-linux,master-91219227-4f9f-465a-8ea0-70670344aaaa-ubuntu,2020/05/15,130,273,40,4,0,447
redislabs/ng-ci-runner,626671509cd9430c7dac72b85cd223f2,2022/08/15,520,321,287,30,1,1159
rancher/hardened-ib-sriov-cni,v1.0.0,2021/03/02,240,329,20,3,0,592
bitnami/percona-mysql,8.0.34-26,2023/10/11,164,60,32,3,0,259
rancher/etc-host-updater,v0.0.3,2017/07/21,306,388,24,0,0,718
airbyte/source-us-census,0.1.2,2021/12/28,104,60,71,27,7,269
atlassian/crowd,5.2.0,2023/11/04,34,45,65,41,0,185
balenalib/beaglebone-green-wifi-debian-python,20230911,2023/09/12,118,38,38,6,0,200
balenalib/bananapi-m1-plus-ubuntu-openjdk,11-xenial-20231026,2023/11/02,null
rancher/mirrored-coreos-kube-state-metrics,v1.9.7,2020/06/03,0,8,14,0,6,28
astronomerinc/ap-registry,3.18.4-1,2023/11/06,0,3,0,0,0,3
portainer/greengrass-components-examples,sub,2022/08/12,15,100,190,14,1,320
balenalib/kitra710-fedora-python,20230712,2023/07/16,0,1,0,0,0,1
couchbase/fluent-bit,1.2.6,2023/06/05,76,19,18,2,0,115
amazon/aws-sam-cli-emulation-image-java11,20220125,2022/01/25,5,28,19,10,1,63
kasmweb/core-oracle-7,1.14.0,2023/09/09,0,11,6,0,0,17
ubuntu/traefik,2.10.4-22.04,2023/10/05,22,16,3,0,0,41
rapidfort/mariadb-ib,10.5.20,2023/11/08,79,160,8,0,0,247
circleci/shutdown-hook-poller,0.1,2020/11/16,103,81,77,24,6,291
docker/ucp-interlock-extension-s390x,3.1.0-beta3,2018/10/04,0,2,6,16,0,24
kasmweb/kali-rolling-desktop,1.14.0,2023/09/14,null
amazon/cloudwatch-agent,1.300031.1b317,2023/11/10,0,9,12,0,0,21
grafana/drone-autoscaler,1.7.5-grafana9,2021/11/19,4,16,19,0,0,39
formio/pdf-libs,5.0.2-rc.1,2023/04/17,0,6,0,0,0,6
balenalib/spacely-tx2-debian-openjdk,20231106,2023/11/07,125,44,29,4,0,202
rancher/coredns,v1.6.9,2020/09/12,259,415,32,3,0,709
balenalib/odroid-xu4-debian-openjdk,20230911,2023/09/11,129,65,42,6,0,242
intel/cri-resmgr-webhook,v0.8.4,2023/08/25,0,2,1,0,0,3
balenalib/qemux86-64,20231106,2023/11/06,114,21,27,4,0,166
cockroachdb/activerecord_test_container,20210914,2021/09/14,961,1048,952,183,26,3170
balenalib/spacely-tx2-alpine-node,20231106,2023/11/06,0,3,3,0,0,6
pachyderm/kube-event-tail,v0.0.7,2022/10/27,0,5,8,0,4,17
objectscale/decks,2.71.3,2021/04/14,2,18,21,0,0,41
rancher/terraform-operator,v0.0.5,2019/03/26,6,14,27,5,0,52
rancher/kubernetes,v1.18.4,2020/08/11,258,403,18,3,0,682
onlyoffice/4testing-ds-spellchecker,6.0.0,2020/10/21,555,569,32,3,0,1159
grafana/logcli,2.9.2-arm64,2023/10/25,0,3,3,0,0,6
objectscale/cmf-switch,0.71.3,2021/04/14,2,19,22,0,0,43
airbyte/source-recharge,1.1.2,2023/11/03,64,22,6,1,0,93
rancher/hyperkube,v1.27.7-rancher1-linux-arm64,2023/11/10,39,42,22,0,0,103
okteto/terminal,0.4,2021/03/11,19,76,81,13,0,189
intel/intel-qat-plugin,0.28.0,2023/09/22,null
objectscale/crunchy-postgres-exporter,ubi8-5.1.2-0,2022/07/05,77,114,12,0,0,203
greenbone/boreas-build,v22.5.0,2023/05/02,493,166,130,14,0,803
bitnami/grafana-operator,5.4.2,2023/11/08,74,13,6,2,0,95
grafana/agent-boringcrypto,v0.37.4,2023/11/06,14,5,1,0,0,20
rancher/mirrored-coredns-coredns,1.10.1,2023/02/06,0,3,3,0,0,6
balenalib/ts4900-fedora-python,20220622,2022/07/12,0,1,1,0,0,2
continuumio/sourceclear,v2,2018/11/02,203,471,13,0,0,687
hashicorp/nomad-driver-podman,0.2.0,2020/12/18,6,25,49,7,0,87
circleci/k8s-release-agent,0.1.206,2023/11/10,0,3,4,0,0,7
balenalib/bananapi-m1-plus-ubuntu-golang,20231026,2023/11/02,133,131,0,0,0,264
bitnami/jupyter-base-notebook,4.0.2,2023/11/15,83,23,13,3,0,122
lacework/code-security-gitlab,690c3699,2023/09/26,2,11,3,2,0,18
continuumio/planet-gpu,5.1.2-1907,2018/06/06,394,1967,1688,229,30,4308
airbyte/source-files-abstract,0.1.0,2022/04/11,104,61,72,28,7,272
balenalib/kitra520,20220714,2022/07/22,124,69,72,18,0,283
rancher/harvester-os,29221228,2022/12/28,11,82,63,2,0,158
airbyte/source-kustomer-singer,0.1.2,2021/12/25,0,21,51,8,0,80
jetbrains/upsource-file-clustering,2020.1.1992,2022/03/11,79,148,241,95,0,563
rancher/mirrored-directxman12-k8s-prometheus-adapter,v0.8.4,2021/03/31,null
bitnami/kube-state-metrics,2.10.1,2023/11/09,74,13,6,2,0,95
balenalib/artik10-node,20220714,2022/07/20,124,71,73,18,0,286
greenbone/notus-data,community,2023/11/15,null
onlyoffice/4testing-docspace-backup-background,2.0.0.33,2023/11/15,993,142,206,12,0,1353
atlassian/confluence-server,8.6.1,2023/11/04,25,23,7,2,0,57
rancher/jaegertracing-all-in-one,1.20.0,2020/09/29,0,7,12,0,0,19
docker/dtr-garant,2.8.1,2020/06/17,2,9,8,1,0,20
objectscale/vnest,3.9.0.0-139102.b4b5064355c,2023/05/03,11,45,40,2,0,98
datadog/agent-buildimages-rpm_x64,v20433308-6861270,2023/09/25,1626,2016,192,6,0,3840
onlyoffice/4testing-appserver-migration-runner,test-2022081607,2022/08/16,73,84,121,7,0,285
balenalib/parallella-alpine-golang,20230904,2023/09/09,2,2,5,2,0,11
balenalib/orbitty-tx2-python,20231106,2023/11/07,114,22,27,4,0,167
redislabs/rebloom,2.6.8,2023/10/23,72,14,11,2,0,99
bitnami/fluent-bit,2.2.0,2023/11/08,74,13,6,2,0,95
balenalib/artik10-ubuntu-python,20220715,2022/08/02,87,82,13,0,0,182
grafana/query-frontend,r56-04edcb97f-WIP,2019/07/11,0,0,0,2,0,2
onlyoffice/4testing-appserver-webhooks-service,test-2022081607,2022/08/16,1014,332,356,24,1,1727
intel/openfl,1.5.1,2023/10/24,30,14,0,0,0,44
balenalib/intel-nuc-alpine-openjdk,8-20231106,2023/11/07,0,2,2,0,0,4
balenalib/intel-nuc-fedora-node,20231103,2023/11/04,0,1,1,0,0,2
rancher/local-path-provisioner,v0.0.24,2023/03/23,0,17,6,0,0,23
graphcore/ipu-operator-vipu-proxy,1.2.0,2023/05/30,31,14,2,0,0,47
rapidfort/redis-cluster,7.2.1,2023/10/17,28,5,1,0,0,34
datadog/agent-buildimages-circleci-runner,v22941763-c6364642,2023/11/07,126,162,2,0,0,290
pachyderm/jupyterhub-pachyderm-hub,1.1.0,2020/04/16,657,996,87,2,0,1742
balenalib/beaglebone-green-ubuntu-python,20230911,2023/09/12,42,10,4,0,0,56
netdata/builder,v2,2023/11/15,247,66,37,2,0,352
mattermost/oncall-notifier,v0.1.0,2020/10/27,2,19,41,4,0,66
balenalib/qemux86-64-fedora-openjdk,8-20231103,2023/11/04,null
circleci/openjdk,11.0.8,2020/10/05,938,827,850,135,19,2769
airbyte/source-woocommerce,0.2.3,2023/06/02,0,15,25,1,0,41
bitnami/solr,9.4.0,2023/10/17,89,24,29,6,0,148
balenalib/fincm3-ubuntu,20230904,2023/09/09,42,9,4,0,0,55
airbyte/destination-qdrant,0.0.7,2023/11/13,64,8,3,4,0,79
rancher/coreos-kube-state-metrics,v1.9.7,2020/06/03,0,8,14,0,6,28
kumahq/kuma-net-ebpf,0.8.10,2022/12/14,null
rancher/mirrored-prometheus-adapter-prometheus-adapter,v0.10.0,2022/08/12,0,3,8,0,0,11
grafana/plugin-validator-cli,v1,2021/04/27,0,7,31,4,0,42
balenalib/spacely-tx2-alpine-golang,20231106,2023/11/06,0,2,2,0,0,4
rancher/os-headers,v0.7.1,2016/10/19,null
datadog/docker-filter,1.2.1,2019/01/04,2,6,7,8,0,23
rancher/rke-cert-deployer,v0.1.1,2018/01/15,0,10,5,0,0,15
grafana/tns-db,842bd3b,2021/10/31,2,14,13,0,0,29
balenalib/odroid-c1-ubuntu-python,20220622,2022/06/23,87,112,13,0,0,212
rancher/goharbor-notary-server-photon,v0.6.1-v1.7.5,2019/04/01,14,63,88,37,0,202
balenalib/beaglebone-black-golang,20230911,2023/09/12,448,109,72,9,0,638
redislabs/redis-connect-oracle,0.6.2-3,2022/01/22,4,27,38,13,0,82
rancher/prometheus,v2.5.0,2018/11/06,null
pachyderm/notebooks-user-transformers,3ed85e7bffe50b2fb5293ab74d5c5c7f06946b26,2023/08/04,220,613,61,2,0,896
balenalib/i386-nlp,20210225,2021/04/19,195,120,138,43,9,505
circleci/circle-admin-cli,0.1,2020/01/13,2,38,73,6,0,119
dynatrace/dynatrace-synthetic-vuc-worker,1.277.53.20231106-153656,2023/10/10,21,11,3,0,0,35
rancher/k3s,v1.28.3-k3s2-s390x,2023/11/08,0,7,7,0,0,14
balenalib/revpi-core-3-debian,20230911,2023/09/11,118,37,38,6,0,199
intel/intelligent_traffic_management_analytics,2.0,2022/11/15,102,212,15,0,0,329
bitnami/supabase-storage,0.43.11,2023/11/09,77,17,7,4,0,105
airbyte/source-smartengage,0.1.0,2022/11/13,0,17,25,1,0,43
balenalib/bananapi-m1-plus-alpine-python,20231106,2023/11/07,0,3,2,0,0,5
rancher/istio-mixer,1.7.6,2020/12/08,1,9,15,1,4,30
newrelic/newrelic-pixie-integration,2.1.4,2023/06/22,0,11,4,3,0,18
rancher/harvester,v1.2.1,2023/10/26,0,1,4,0,0,5
grafana/containerized-systemd,debian-10,2022/06/27,121,62,55,12,6,256
balenalib/aarch64-ubuntu,20231103,2023/11/06,34,8,0,0,0,42
rancher/mirrored-neuvector-controller,5.2.3,2023/11/10,0,2,0,0,0,2
rancher/terraform-controller-appliance,v0.0.13-alpha1,2020/11/19,null
airbyte/source-talkdesk-explore,0.1.0,2022/05/26,0,21,51,8,0,80
balenalib/raspberry-pi2-alpine,20231106,2023/11/07,0,2,2,0,0,4
google/apigee-cert-manager-webhook,v0.12.0,2019/11/28,0,0,0,0,6,6
rancher/jenkins-swarm,v0.3.0,2016/08/09,119,459,479,214,35,1306
balenalib/orangepi-plus2-ubuntu-golang,20231026,2023/11/02,133,131,0,0,0,264
circleci/exim,0.2,2022/02/23,108,90,174,26,1,399
balenalib/colibri-imx6dl-node,18.6-20220714,2022/07/21,124,71,73,18,0,286
airbyte/destination-listen-and-echo,dev,2021/05/21,99,45,55,19,6,224
circleci/testing-cli,1.0.0,2018/05/01,442,1390,974,250,72,3128
bitnami/apisix,3.6.0,2023/11/04,95,30,10,2,0,137
rancher/istio-node-agent-k8s,1.5.9,2020/08/07,405,1084,143,0,0,1632
balenalib/zynq-xz702-alpine-golang,20220714,2022/07/27,8,39,38,12,0,97
docker/extension-npm-installer,0.2.14,2022/11/16,0,11,9,0,0,20
rancher/kubernetes-dashboard-amd64,v1.10.1,2018/12/17,null
portainer/agent-k8s-beta,linux-arm,2020/03/30,null
balenalib/orbitty-tx2-debian-openjdk,20231106,2023/11/07,125,44,29,4,0,202
vmware/mariadb-photon,10.2.10,2017/11/21,11,110,119,59,0,299
airbyte/source-freshdesk,3.0.4,2023/06/23,0,16,25,1,0,42
balenalib/artik5-debian-golang,20220714,2022/07/22,473,263,219,28,1,984
redislabs/redisedgevision-bionic,0.1.1,2019/06/11,235,517,41,6,0,799
balenalib/hummingboard-fedora-golang,20221210,2022/12/13,null
redislabs/redis-connect-db2,0.7.0-18,2022/01/22,4,27,36,13,0,80
rancher/mirrored-s3gw-s3gw,v0.14.0,2023/03/30,5,36,13,0,1,55
balenalib/nitrogen6x-openjdk,20210602,2021/06/05,230,233,143,39,8,653
rapidfort/mysql8-ib,8.0.31,2023/10/25,101,43,0,0,0,144
sysdig/agent-s390x,0.78.1,2018/03/15,null
rancher/mirrored-cilium-operator-aws,v1.14.4,2023/11/13,null
kasmweb/core-oracle-8,1.14.0,2023/09/09,8,14,815,0,0,837
bitnami/kubewatch-archived,0.1.0,2022/03/23,130,83,83,23,6,325
intel/flexran_l1_spree,v23.07,2023/10/12,79,116,10,0,0,205
airbyte/source-yandex-metrica,1.0.0,2023/03/20,0,16,25,1,0,42
vmware/vsan-prometheus-operator,v20210225,2021/02/26,14,100,109,45,0,268
rancher/strato,0.0.3,2018/01/16,null
kasmweb/manager,1.14.0,2023/09/14,28,9,1,0,0,38
vmware/photon-2.0-wavefront-proxy,v4.26-20180619,2018/06/19,41,146,203,88,0,478
balenalib/nitrogen6x-fedora-node,36-build-20220714,2022/07/22,0,1,1,0,0,2
balenalib/rpi-debian-golang,20231106,2023/11/07,378,52,42,5,0,477
airbyte/source-everhour,0.1.0,2023/03/23,0,16,25,1,0,42
balenalib/parallella-debian-python,20230904,2023/09/09,118,38,38,6,0,200
lacework/datacollector,6.10.0,2023/11/10,19,7,0,0,0,26
mattermost/channel-spammer,0.0.4,2021/05/07,2,22,40,4,0,68
atlassian/proforma-jre-with-fonts,8u121-jre-alpine,2020/04/27,9,25,17,13,0,64
balenalib/generic-aarch64-fedora,20231106,2023/11/06,null
vmware/lightwave-sts-photon2,1.3.1-35,2018/08/24,37,165,310,101,0,613
docker/runc,v1.0.0-rc5,2018/08/07,null
objectscale/kahm,v2.74.0,2021/05/25,2,18,22,0,0,42
balenalib/kitra710-ubuntu-python,20230904,2023/09/09,42,10,4,0,0,56
pingidentity/pingdelegator,2310,2023/11/01,0,2,1,0,0,3
rancher/vm-rancheros,1.4.2,2018/11/27,null
atlassian/bamboo-specs-runner,9.4.1,2023/11/07,72,88,9,13,0,182
bitnami/keycloak-config-cli,5.9.0,2023/10/13,74,13,6,2,0,95
balenalib/amd64-alpine-python,20231106,2023/11/07,0,3,2,0,0,5
kumahq/kuma-dp,2.4.4,2023/11/06,7,4,4,0,0,15
rancher/goharbor-notary-signer-photon,v0.6.1-v1.7.5,2019/04/01,14,63,88,37,0,202
balenalib/amd64-debian-openjdk,20231106,2023/11/06,118,44,23,4,0,189
vmware/photon-2.0-k8s-dns-dnsmasq-nanny-amd64,1.14.10-20180619,2018/06/19,19,75,92,57,0,243
kasmweb/debian-bullseye-desktop,1.14.0,2023/09/14,952,384,421,91,2,1850
airbyte/source-orbit,0.3.0,2023/10/25,0,13,24,1,0,38
rancher/longhorn-driver,88639e7,2017/12/12,89,230,14,0,0,333
airbyte/integration-base-python,20230210,2023/02/10,0,9,7,0,0,16
balenalib/beaglebone-green-alpine,20231106,2023/11/07,0,2,2,0,0,4
bitnami/testlink-archived,1.9.20,2022/03/23,297,279,160,24,11,771
bitnami/wavefront-adapter-for-istio-archived,0.1.5,2022/07/09,94,69,74,16,0,253
balenalib/amd64-node,20231106,2023/11/06,107,23,22,4,0,156
hashicorp/consul,1.17,2023/11/03,0,3,0,0,0,3
objectscale/rep,0.71.3,2021/04/15,13,89,96,14,3,215
rancher/grafana,5.3.0,2018/10/10,55,45,77,24,10,211
airbyte/source-googleanalytics-singer,0.2.6,2021/06/25,571,314,279,39,7,1210
pingidentity/pingcentral,2310,2023/11/01,7,19,11,2,0,39
objectscale/csi-baremetal-controller,0.69.0,2021/03/07,2,17,26,1,0,46
bitnami/geode-archived,1.15.1,2022/11/30,77,58,55,16,0,206
vmware/dind-sshuttle-bosh-ci,dev,2018/09/26,3,51,14,19,0,87
purestorage/psctl,v1.1.2,2022/07/07,0,2,6,0,0,8
docker/hub-explorer-extension,0.0.5,2022/03/09,0,15,20,1,0,36
mirantis/ucp-csi-node-driver-registrar,3.5.3,2022/04/05,0,0,0,0,6,6
docker/desktop-kubernetes-controller-manager,v1.28.2,2023/09/13,0,3,4,0,0,7
docker/ucp-swarm-s390x,3.1.0-beta3,2018/10/04,0,1,7,8,0,16
rancher/mirrored-idealista-prom2teams,4.2.1,2022/12/21,1,25,26,0,0,52
balenalib/beaglebone-green-alpine-openjdk,8-20231106,2023/11/07,0,2,2,0,0,4
lacework/container-auto-scan,1.1.2,2023/03/28,77,34,24,2,0,137
objectscale/objectscale-component-pre-update,1.4.0-397.adb0726,2023/11/13,0,3,2,0,0,5
redislabs/redismod,feature-search-json,2021/04/19,151,97,138,42,9,437
bitnami/drupal,10.1.6,2023/11/03,160,82,50,4,0,296
balenalib/asus-tinker-board-s-fedora-node,36-build-20230530,2023/06/29,0,1,1,0,0,2
datadog/agent-buildimages-system-probe_arm64,v22885174-c6364642,2023/11/06,849,341,282,7,0,1479
bitnami/etcd,3.5.10,2023/11/08,72,13,10,2,0,97
ubuntu/jre,17-22.04_24,2023/10/31,null
circleci/api-gateway-test-server,0.2.629-9503714,2023/02/02,0,4,4,0,0,8
grafana/loki-docker-driver,2.9.2,0001/01/01,0,4,3,0,0,7
airbyte/integration-singer-postgres-source,0.1.3,2020/10/07,126,102,159,32,11,430
rancher/mirrored-k8s-dns-dnsmasq-nanny,1.22.20,2023/02/22,11,16,4,0,0,31
balenalib/zynq-xz702-debian-python,20220604,2022/06/12,124,82,74,20,0,300
google/deepsomatic,1.6.0,2023/10/19,123,164,8,0,0,295
kasmweb/filezilla,1.14.0,2023/09/14,189,379,0,0,0,568
bitnami/fluentd,1.16.2,2023/10/09,159,60,26,2,0,247
airbyte/destination-convex,0.2.0,2023/05/24,0,15,25,1,0,41
kasmweb/thunderbird,1.14.0,2023/09/14,187,410,0,0,0,597
onlyoffice/4testing-docspace-proxy,1.1.3.2484,2023/09/08,153,261,19,0,0,433
astronomerinc/ap-redis,6.2.13,2023/09/25,137,56,24,3,0,220
bitnami/external-dns,0.14.0,2023/11/08,74,13,6,2,0,95
docker/dockerfile-upstream,1.6,2023/07/12,0,4,5,0,0,9
mattermost/mattermod,0.18.0,2023/10/11,35,36,19,0,0,90
kong/pulp-worker,1.1.38,2022/08/24,4,11,9,4,0,28
balenalib/odroid-xu4-debian-golang,20230911,2023/09/11,448,109,72,9,0,638
bitnami/jupyterhub,4.0.2,2023/11/15,84,23,12,3,0,122
airbyte/source-appstore-singer,0.2.6,2021/12/23,3,24,52,8,0,87
balenalib/apalis-imx6q-ubuntu-golang,20220523,2022/06/03,222,535,46,0,0,803
appdynamics/infra-agent,21.5.0-1784,2021/04/27,77,99,64,0,0,240
balenalib/orbitty-tx2-ubuntu-openjdk,11-xenial-20231103,2023/11/06,null
hashicorp/consul-enterprise-fips,1.17.0-ent.fips1402-ubi,2023/11/03,36,22,3,0,0,61
balenalib/odroid-c1-python,20220604,2022/06/12,124,82,74,20,0,300
onlyoffice/4testing-ds-spellchecker-de,6.2.0-eu-r2,2021/03/04,536,493,32,3,0,1064
rancher/plugin-manager,v0.2.12,2016/11/30,306,399,26,0,0,731
balenalib/am571x-evm-ubuntu-openjdk,20210826,2021/09/04,136,435,10,0,0,581
rancher/istio-galley,1.5.9,2020/08/07,405,1084,142,0,0,1631
greenbone/pg-gvm,22.6.1,2023/07/26,120,33,35,2,0,190
docker/ucp-calico-kube-controllers-s390x,3.1.0-beta3,2018/10/04,0,2,2,2,0,6
vmware/admiral_agent,1.3.1,2018/07/23,8,55,72,37,0,172
kasmweb/sublime-text,1.14.0,2023/09/14,187,379,0,0,0,566
kasmweb/core-rockylinux-9,1.14.0,2023/09/09,0,2,2,0,0,4
balenalib/intel-nuc-golang,20231106,2023/11/06,442,82,51,5,0,580
amazon/aws-lambda-java,21-preview,2023/11/12,null
rancher/pipeline-jenkins-server,v0.1.5,2020/02/14,214,201,267,76,9,767
grafana/mv-manager,7770886,1970/01/01,0,2,2,0,0,4
mattermost/mirror-sync-gitlab,latest-0743b65,2021/12/20,0,10,21,1,0,32
rapidfort/zookeeper-ib,3.8.2,2023/08/31,14,13,3,1,0,31
balenalib/amd64-openjdk,20231106,2023/11/06,118,44,23,4,0,189
redislabs/memtier_benchmark,2.0.0,2023/06/22,null
balenalib/odroid-c1-alpine-python,20220714,2022/07/19,7,38,35,10,0,90
circleci/cassandra,3.10,2017/05/25,59,174,159,79,23,494
balenalib/artik530-openjdk,20220714,2022/07/22,157,128,83,18,0,386
rapidfort/mariadb,11.1.2,2023/10/20,21,5,1,1,0,28
balenalib/asus-tinker-board-s-debian-node,20230911,2023/09/12,118,39,39,6,0,202
objectscale/telemetry-upload,3.0.4-413.8230f25,2023/10/03,2,3,3,0,0,8
balenalib/i386-nlp-debian-node,7.10.1,2018/11/07,398,1019,720,182,45,2364
airbyte/source-survey-sparrow,0.2.0,2022/12/09,0,16,25,1,0,42
balenalib/via-vab820-quad-python,20220604,2022/06/12,124,82,74,20,0,300
docker/artifactory-docker-desktop,v1.0.45,2023/10/02,null
rancher/vm-rhel,7.6-x86_64,2018/11/26,null
onlyoffice/documentserver-ee,7.5.1.1,2023/11/05,123,91,1,1,0,216
rancher/jimmidyson-configmap-reload,v0.4.0,2020/07/13,0,1,1,0,0,2
grafana/ci-e2e,12.19.0-1,2020/10/20,468,647,575,90,10,1790
rancher/rancher-csp-adapter,v3.0.0,2023/10/23,0,3,3,0,0,6
airbyte/source-convex,0.2.0,2023/06/21,0,13,17,0,0,30
datadog/cws-instrumentation,7.50.0-devel.git.506.5fb6ed0.pipeline.22983080,2023/11/07,null
rancher/mirrored-skopeo-skopeo,v1.13.2,2023/08/29,null
rancher/squareup-ghostunnel,v1.5.2,2019/11/20,5,17,34,2,0,58
puppet/puppetexplorer,2.0.0,2017/10/24,0,19,8,18,0,45
rancher/mirrored-istio-pilot,1.19.0,2023/09/01,29,12,6,0,0,47
continuumio/miniconda,4.7.12,2019/10/16,217,215,281,60,10,783
greenbone/ospd-openvas,22.6.1,2023/10/24,115,47,29,4,0,195
intel/pilot,1.19.0-intel.0,2023/09/27,29,12,6,0,0,47
airbyte/source-mysql,3.1.7,2023/11/08,6,24,15,3,0,48
balenalib/odroid-xu4-fedora-node,36-build-20230530,2023/06/29,0,1,1,0,0,2
bitnami/rmq-default-credential-updater,1.0.4,2023/11/09,null
balenalib/artik533s-fedora-openjdk,8-20220224,2022/03/05,null
rancher/strato-min,0.0.2,2017/01/02,null
bitnami/spring-cloud-skipper,2.11.1,2023/10/13,74,14,11,4,0,103
rancher/opni-inference-service,v0.12.1-rc1,2023/11/10,8,70,74,5,11,168
balenalib/beaglebone-black-fedora,20221109,2022/12/04,null
passbolt/labs,2.13.5-fpm,1970/01/01,84,251,186,59,6,586
hashicorp/secrets-store-csi-driver-provider-vault,0.0.7,2021/01/20,2,14,14,1,0,31
docker/ucp-agent,3.3.1,2020/06/26,2,8,9,1,0,20
redislabs/redisedge-bionic,0.1,2019/06/09,94,76,7,0,0,177
nginxinc/mra_python_base,3.5,2018/05/31,418,1554,1058,274,69,3373
balenalib/jetson-tx1-debian,20230530,2023/06/28,118,40,39,6,0,203
rancher/goharbor-chartmuseum-photon,v0.8.1-v1.7.5,2019/04/01,14,63,88,37,0,202
rancher/storage-rbd,v0.9.7,2018/07/09,251,509,17,0,0,777
balenalib/bananapi-m1-plus-ubuntu,20231026,2023/11/02,37,8,0,0,0,45
mirantis/dtr,2.9.14,2023/09/28,0,11,8,0,0,19
mattermost/notice-file-generator-daily,v0.0.2,2022/07/08,0,2,4,0,0,6
rancher/mirrored-cloud-provider-vsphere-csi-release-syncer,v3.1.1,2023/10/24,3,8,9,3,0,23
google/apigee,nginx,2019/04/16,43,55,81,31,7,217
balenalib/beaglebone-black-node,20230911,2023/09/12,118,39,39,6,0,202
snyk/container-registry-agent,70316042f6291a25d1ddf2e0535c057570aebd42,2021/11/10,0,21,47,6,0,74
rancher/security-scan,v0.2.13,2023/09/12,2,6,12,0,3,23
airbyte/source-dockerhub,0.2.0,2023/08/24,0,15,24,1,0,40
balenalib/qemux86-64-debian,20231106,2023/11/06,114,21,27,4,0,166
objectscale/objectscale-operator,0.71.3,2021/04/19,4,15,18,0,0,37
balenalib/generic-armv7ahf-ubuntu-python,20230904,2023/09/09,42,10,4,0,0,56
rancher/connectivity-check,v0.0.8,2018/07/17,306,388,24,0,0,718
mirantis/k8s-netchecker-agent,v1.2.2,2018/01/02,null
airbyte/source-posthog,0.1.15,2023/11/03,64,8,2,1,0,75
rancher/tektoncd-controller,80e040a5,2019/05/29,0,0,0,0,6,6
bitnami/wavefront-prometheus-storage-adapter,1.0.7,2023/06/17,74,27,17,2,0,120
balenalib/rpi-alpine-openjdk,8-20231026,2023/11/01,8,10,2,0,0,20
balenalib/beaglebone-green-wifi-debian-golang,20230911,2023/09/12,448,109,72,9,0,638
rancher/mirrored-cilium-kvstoremesh,v1.14.4,2023/11/13,null
airbyte/source-weatherstack,0.1.0,2022/11/07,0,15,17,0,0,32
mattermost/mattermost-push-proxy,5.26.0,2023/11/01,0,2,2,0,0,4
intel/intelligent_traffic_management_pipeline_server_init,2.0,2022/11/15,45,49,5,0,0,99
bitnami/supabase-studio,0.23.10,2023/11/09,78,19,7,3,0,107
mongodb/mongodb-community-server,7.0.3-ubuntu2204-20231115T085830Z,2023/11/15,142,137,0,0,0,279
mattermost/genesis,209d026,2021/04/14,1,24,54,5,0,84
bitnami/redis-sentinel,7.2.3,2023/11/09,74,13,6,2,0,95
docker/remote,server,2017/09/15,0,26,3,0,0,29
rancher/rancher-cleanup,130,2022/05/30,5,53,28,3,11,100
pingidentity/pingintelligence,2310,2023/11/01,509,517,6,0,0,1032
bitnami/mxnet-archived,1.9.1,2023/10/11,606,188,82,9,0,885
rancher/harvester-pcidevices,v0.2.6,2023/08/29,4,9,13,0,5,31
balenalib/i386-node,16.19.1-20231106,2023/11/06,107,23,22,4,0,156
intel/esp-uos-builder,v3.1.2,2023/07/25,2,12,38,4,0,56
balenalib/zynq-xz702-openjdk,20210602,2021/06/05,230,233,143,39,8,653
sysdig/falco_rules_installer,12,2022/09/23,829,893,641,32,5,2400
balenalib/artik530-alpine-node,20220803,2022/08/04,7,38,34,10,0,89
rancher/istio-citadel,1.5.9,2020/08/07,406,1087,142,0,0,1635
airbyte/source-metabase,1.1.0,2023/10/31,64,8,4,1,0,77
rancher/metadata-syncer,319,2023/11/15,0,2,2,0,0,4
rancher/kube-api-auth,v0.2.0,2023/07/12,2,8,9,0,1,20
google/cloud-sdk,455.0.0,2023/11/15,541,169,127,13,0,850
balena/open-balena-db,5.2.1,2023/04/21,112,41,35,2,0,190
onlyoffice/dropbox-callback,1.0.0-rc7,2023/09/04,0,6,6,0,0,12
jetbrains/qodana-go,2023.2,2023/09/06,490,158,137,17,0,802
balenalib/odroid-xu4-fedora-python,20221109,2022/11/16,0,1,0,0,0,1
astronomerinc/ap-elasticsearch,8.9.2,2023/10/31,25,17,2,0,0,44
pachyderm/seldon-pachyderm-rsi-deployer,0.1.4,2021/02/11,8,31,52,7,0,98
airbyte/migration,0.33.0-alpha,2021/12/03,99,85,89,24,6,303
rancher/mirrored-istio-coredns-plugin,0.2-istio-1.1,2019/03/06,331,452,37,0,0,820
balenalib/stem-x86-32-golang,20230904,2023/09/09,448,111,72,9,0,640
bitnami/odoo,17.0.20231105,2023/11/10,104,33,31,6,0,174
airbyte/source-vitally,0.1.0,2022/11/14,0,17,25,1,0,43
objectscale/chunks3server,1.0.0-367.df32ef43,2022/09/09,7,45,52,4,3,111
airbyte/source-http-request,0.2.4,2021/06/09,143,94,109,34,7,387
rancher/rke-nginx-proxy,v0.1.1,2018/01/20,0,26,9,23,0,58
balenalib/zynq-xz702-fedora-golang,20220507,2022/05/12,null
rancher/agent,v2.0.3,2018/03/07,7,31,0,0,0,38
hashicorp/vault-enterprise,1.15.2-ent,2023/11/07,0,3,2,0,0,5
balena/open-balena-vpn,11.29.17,2023/10/18,336,98,76,5,2,517
google/apigee-istio-galley,1.4.6,2020/02/22,650,1305,152,0,0,2107
rancher/build-base,v1.14.2,2020/08/09,1237,1920,1452,83,16,4708
rancher/linkerd-install,stable-2.8.1,2020/07/30,122,226,28,0,0,376
snyk/snyk-operator-bundle,1.63.0-pre0,2021/06/04,94,203,35,2,0,334
objectscale/objectstore-connectivity,0.71.3,2021/03/24,2,17,21,0,0,40
okteto/gc,1.0.0,2020/03/13,2,18,41,4,0,65
objectscale/chunkserver,1.0.0-418.1b630f7e,2023/11/14,0,3,5,0,0,8
rancher/net,v0.13.17,2018/07/19,306,388,24,0,0,718
balenalib/nitrogen6x-ubuntu-golang,20220523,2022/06/03,222,535,46,0,0,803
rancher/kube-rbac-proxy,v0.5.0,2020/02/17,2,19,42,4,0,67
mattermost/awat-e2e,8330887,2022/03/30,498,366,299,55,1,1219
mattermost/cloud-db-factory-vertical-scaling,7665090,2020/09/21,3,24,41,4,0,72
airbyte/source-tyntec-sms,0.1.0,2022/11/16,0,17,25,1,0,43
intel/esp-certbot,v3.1.2,2023/07/25,4,6,4,0,0,14
redislabs/redis-webcli,yuvallevy2-webcli_tls_support-RED-37222,2020/02/09,590,1653,1281,279,16,3819
rancher/cleanup-1-1,v0.1.2,2017/01/19,141,323,293,146,0,903
cimg/clojure,1.11.1,2022/11/28,460,958,100,0,0,1518
rapidfort/mysql,8.1,2023/10/17,21,5,1,0,0,27
kasmweb/zoom,1.14.0,2023/09/14,189,379,0,0,0,568
mirantis/ucp-hardware-info,3.7.1,2023/09/26,2,3,6,2,0,13
atlassian/bitbucket,8.15.1,2023/11/14,60,71,11,1,0,143
docker/desktop-kubernetes-pause,3.9,2022/10/13,null
intel/search-image-by-image,evi-2.0.0,2022/10/31,51,43,36,8,0,138
bitnami/spark,3.5.0,2023/11/03,88,42,56,6,0,192
airbyte/source-slack,0.3.5,2023/10/15,64,22,6,1,0,93
rancher/harvester-cloud-provider,v0.2.0,2023/06/07,1,7,9,0,1,18
bitnami/laravel,10.2.9,2023/11/14,156,86,51,5,0,298
bellsoft/liberica-native-image-kit-container,jdk-17-nik-22.3.2-stream-musl,2023/11/15,null
airbyte/source-yotpo,0.1.0,2023/05/01,0,16,25,1,0,42
balenalib/amd64-fedora-golang,20231103,2023/11/04,null
mirantis/ucp-metrics-swarm-only,3.7.1,2023/09/26,2,10,10,2,0,24
balenalib/armv7hf-alpine-python,20231106,2023/11/07,0,3,2,0,0,5
daggerio/ci-test,32728,2022/07/25,0,12,14,1,0,27
rancher/storage-secrets,v0.9.7,2018/07/09,125,218,12,0,0,355
amazon/aws-lambda-nodejs,20.2023.11.13.16,2023/11/13,0,2,0,1,0,3
pachyderm/worker-arm64,97276071e371d5b1ea221437e99cfd87b5599ddf,2023/11/03,1,7,8,0,0,16
docker/tutum-test-alpine,quantal,2020/05/29,2,10,32,4,0,48
airbyte/source-pipedrive,2.2.1,2023/11/06,0,13,24,1,0,38
circleci/android,example,2021/03/18,887,731,805,154,18,2595
rancher/metrics-server,v0.4.1,2020/11/16,0,7,12,1,5,25
airbyte/source-dremio,0.1.0,2023/01/12,0,16,25,1,0,42
airbyte/source-chargebee,0.2.5,2023/10/15,64,22,6,1,0,93
balenalib/orbitty-tx2-alpine-openjdk,8-20231106,2023/11/06,8,10,2,0,0,20
grafana/dd-proxy,v0.1.0,2020/09/24,6,31,49,4,0,90
balenalib/raspberrypi3-debian-node,20230530,2023/07/02,118,39,39,6,0,202
kasmweb/chromium,1.14.0,2023/09/14,187,379,0,0,0,566
circleci/twistlock-secret-fetcher,0.1.31-be7da25,2019/05/28,0,6,5,7,0,18
airbyte/source-hubplanner,0.2.0,2023/09/04,0,15,24,1,0,40
ambassador/aes-authsvc,v4.0.0-preview.2.dev.1,2023/10/27,0,1,1,0,0,2
rancher/os-selinuxtools,v1.5.8,2021/02/05,null
balenalib/asus-tinker-board-s-alpine-python,20231106,2023/11/07,0,3,2,0,0,5
rancher/opensearch-dashboards,1.3.1,2022/05/19,19,166,329,29,1,544
mattermost/matterbuild,0.12.1,2023/10/11,25,15,7,0,0,47
balenalib/stem-x86-32-node,16.19.1-20230904,2023/09/09,118,39,39,6,0,202
rancher/k8s-dns-sidecar,1.15.10,2020/03/05,16,17,19,8,1,61
balenalib/intel-nuc-debian-openjdk,20231103,2023/11/05,125,44,29,4,0,202
balenalib/amd64-fedora-python,20231103,2023/11/04,null
rancher/mirrored-sig-storage-csi-attacher,v4.4.2,2023/11/09,null
onlyoffice/documentserver-de,7.5.1.1,2023/11/05,123,91,1,1,0,216
balenalib/artik530-fedora-openjdk,8-20220224,2022/03/05,null
balenalib/via-vab820-quad-ubuntu-openjdk,20210826,2021/09/04,136,435,10,0,0,581
google/apigee-istio-pilot,1.4.6,2020/02/22,650,1310,159,1,0,2120
balenalib/artik530-fedora-python,20220714,2022/07/23,0,1,1,0,0,2
docker/ucp-controller,3.3.1,2020/06/26,2,8,9,1,0,20
airbyte/source-datascope,0.1.0,2022/11/11,0,17,25,1,0,43
docker/fab-backend,50b36877f5c4f4f9947837690a988f592450d1de,2018/11/21,1,0,14,11,0,26
airbyte/source-instatus,0.1.0,2023/01/13,0,16,25,1,0,42
intel/intel-deviceplugin-operator,0.28.0,2023/09/22,null
objectscale/bookkeeper-operator,0.1.9-99-582916f,2023/02/10,1,13,17,0,0,31
airbyte/destination-s3,1.0.0,2023/01/13,33,149,250,30,1,463
intel/evi-fm-master,master-ae213cd97d6931b1d44fc7689867cf5701e0f15d,2023/09/23,55,9,3,1,0,68
balenalib/armv7hf-debian,20230929,2023/10/02,111,37,33,6,0,187
circleci/erlang,25,2022/02/22,854,1015,761,100,3,2733
balenalib/jetson-tx2-debian-python,20231106,2023/11/07,114,22,27,4,0,167
airbyte/source-breezometer,0.1.0,2022/11/08,0,17,25,1,0,43
atlassian/pipelines-kubectl,1.28.1,2023/08/31,0,1,1,0,0,2
rancher/os-extras,v0.7.1,2016/10/03,0,53,26,10,0,89
rancher/os-rootfs,3929481,2017/02/03,null
balena/i386-nlp-supervisor-base,v1.4.7,2019/05/28,null
snyk/kubernetes-operator-index,1.100.2,2023/01/03,3,26,53,3,0,85
balenalib/artik10-debian-openjdk,20220714,2022/07/22,157,128,83,18,0,386
balenalib/odroid-xu4-alpine,20231106,2023/11/07,0,2,2,0,0,4
newrelic/cluster-api-controller-ppc64le,mv1a,2019/04/17,0,0,0,0,6,6
airbyte/destination-mongodb-strict-encrypt,0.2.0,2023/07/26,30,120,199,15,1,365
graphcore/ipu-operator-launcher,1.2.0,2023/05/30,31,15,3,0,0,49
rancher/os-cloudinit,v0.7.1,2016/11/01,null
balenalib/am571x-evm-debian-python,20220604,2022/06/12,124,82,74,20,0,300
mattermost/community-continuous-profiling,6055961,2021/01/20,10,21,40,6,0,77
onlyoffice/4testing-docspace-healthchecks,2.0.0.33,2023/11/15,993,142,206,12,0,1353
intel/intelligent_traffic_management_analytics_dev,2.0,2022/12/06,102,203,15,0,0,320
rancher/mirrored-curlimages-curl,7.85.0,2022/08/31,0,11,12,0,0,23
balenalib/artik5-ubuntu,20220714,2022/08/02,87,81,11,0,0,179
grafana/technical-documentation-build-image,6673591,2022/11/15,1,14,15,3,0,33
objectscale/csi-baremetal-node-controller,1.4.0-652.08b8de3,2023/11/13,null
adobecoldfusion/apimanager2021,2021.0.1,2021/12/17,109,246,99,40,0,494
kasmweb/alpine-317-desktop,1.14.0,2023/09/14,12,116,148,19,0,295
vmware/vs-api-manager,v0.0.1,2017/12/05,15,81,98,70,0,264
rancher/mirrored-jenkins-jnlp-slave,4.7-1,2021/03/24,237,155,190,54,10,646
okteto/traefik,dev,2020/04/10,12,38,68,8,0,126
cockroachdb/xgo,20170218,2017/02/19,764,1408,75,1,0,2248
mirantis/operations-ui,remove-keycloak-stuff,2018/11/08,409,1276,811,204,49,2749
objectscale/csi-baremetal-scheduler-patcher,0.69.0,2021/03/07,0,15,49,12,0,76
docker/proxy_init,1.1.2,2019/04/12,40,35,0,0,0,75
balena/aarch64-supervisor-base,v1.4.7,2019/05/28,null
balenalib/apalis-imx6q,20220714,2022/07/20,124,69,72,18,0,283
percona/dbaas-operator-bundle,0.1.17,2023/07/04,null
intel/intel-iaa-plugin,0.28.0,2023/09/22,null
circleci/nomad,0.9-8443593,2019/08/16,60,69,111,16,10,266
airbyte/proxy,0.51.0,2023/07/20,91,42,17,3,2,155
bellsoft/liberica-openjre-centos,21.0.1-12,2023/11/14,543,499,32,3,0,1077
redislabs/mp-vault,0.0.2,2019/06/26,0,0,0,2,0,2
bitnami/memcached,1.6.22,2023/10/16,78,13,7,3,0,101
balenalib/via-vab820-quad-alpine-python,20220714,2022/07/19,7,38,35,10,0,90
rancher/mirrored-library-busybox,1.36.1,2023/07/18,null
airbyte/destination-postgres-strict-encrypt,0.4.0,2023/06/29,34,145,243,30,1,453
rancher/mirrored-jimmidyson-configmap-reload,v0.8.0,2022/10/11,null
onlyoffice/4testing-ds-proxy-de,6.2.0-eu-r2,2021/03/04,593,590,37,3,0,1223
balena/open-balena-api,14.14.3,2023/11/13,336,90,56,5,2,489
onlyoffice/documentserver-builder,develop-latest,2019/02/18,17,29,10,6,0,62
vmware/photon2,20180620,2018/06/20,15,71,90,57,0,233
airbyte/source-workable,0.1.0,2022/10/27,0,17,25,1,0,43
couchbase/sync-gateway,1.4.0-2,2019/04/10,606,637,48,3,0,1294
circleci/migratorator-test,0.1,2017/08/26,501,1809,1164,312,70,3856
amazon/aws-secrets-manager-secret-rotator,v1,2020/10/14,0,7,13,0,6,26
balenalib/orangepi-plus2-alpine,20231106,2023/11/07,0,2,2,0,0,4
balenalib/revpi-core-3-ubuntu,20231026,2023/11/02,37,8,0,0,0,45
rancher/rdns-server,v0.5.8-rancher-amd64,2019/12/27,108,74,12,0,0,194
okteto/test-auth,dev,2020/02/06,2,10,29,4,0,45
rancher/slack-irc,3.12.0,2018/08/13,333,485,42,4,0,864
grafana/benchtool,v0.11.0,2023/09/06,0,2,3,0,0,5
balenalib/odroid-xu4-golang,20230911,2023/09/11,448,109,72,9,0,638
netdata/os-test,ubuntu1904,2020/04/14,0,4,0,0,0,4
newrelic/synthetics-minion-runner,3.0.95,2023/11/03,34,224,238,45,0,541
grafana/vale,6673591,2022/11/15,0,5,4,1,0,10
balenalib/aarch64-alpine-openjdk,8-20231106,2023/11/06,6,8,2,0,0,16
pachyderm/split-loadtest-supervisor,20191119.0802,2019/11/19,null
hashicorp/consul-esm,0.7.1,2023/01/06,0,23,21,0,0,44
grafana/metrictank,v1.1,2021/01/14,4,14,9,3,0,30
docker/dtr-notary-signer,2.8.1,2020/06/17,2,9,8,1,0,20
pachyderm/job-shim,1.3.19,2017/03/30,376,507,68,1,0,952
airbyte/source-klaviyo,2.0.1,2023/11/09,64,22,6,1,0,93
bitnami/git,2.42.1,2023/11/02,136,16,29,5,0,186
rancher/klipper-lb,v0.4.4,2023/05/27,0,10,2,3,0,15
mattermost/mattermost-enterprise-edition,9.2.2,2023/11/08,52,27,6,0,0,85
intel/esp-uos-wifi,v3.1.2,2023/07/25,null
okteto/java-maven-getting-started,1.0.0,2023/02/27,111,77,111,34,0,333
onlyoffice/4testing-ds-converter,6.0.0,2020/10/21,555,569,32,3,0,1159
rancher/rancher-operator,v0.2.0-alpha03,2021/04/13,1,12,42,4,0,59
airbyte/tests,dev-3,2022/01/23,104,112,91,30,0,337
airbyte/source-linkedin-pages,1.0.2,2023/05/30,0,15,25,1,0,41
docker/ucp-agent-s390x,3.1.0-beta3,2018/10/04,0,2,6,16,0,24
airbyte/destination-r2,0.1.0,2022/09/26,80,93,101,34,0,308
balenalib/generic-armv7ahf-debian-python,20230904,2023/09/09,118,38,38,6,0,200
circleci/dynamodb,19,2022/02/22,16,80,39,1,0,136
objectscale/base-service-tools,2.69.0,2021/03/16,18,135,156,6,6,321
rapidfort/haproxy,2.8.3,2023/10/17,26,9,4,1,0,40
balenalib/raspberry-pi2-fedora-golang,20220523,2022/06/04,null
puppet/continuous-delivery-for-puppet-enterprise,4.3.3,2021/02/23,112,79,84,28,6,309
solace/solace-pubsub-standard,10.6.0.34,2023/10/27,180,92,6,0,0,278
rancher/bats-bats,v1.1.0,2018/08/02,0,0,0,2,0,2
cimg/base,2023.11,2023/11/07,160,148,5,0,0,313
balenalib/jetson-tx2-ubuntu,20231103,2023/11/06,37,8,0,0,0,45
balenalib/beaglebone-green-wifi-debian,20230911,2023/09/11,118,37,38,6,0,199
couchbase/operator-certification,2.5.0,2023/08/14,246,103,60,8,0,417
docker/ucp-pause-s390x,3.1.0-beta3,2018/10/04,null
vmware/log-intelligence-fluentd,3.6,2021/03/12,1430,1358,981,149,37,3955
circleci/circleci-inferconfig,0.1412,2023/10/03,207,231,32,0,0,470
airbyte/source-alloydb,3.1.8,2023/09/20,10,49,25,5,0,89
ubuntu/squid,6.1-23.10_edge,2023/11/07,15,5,0,0,0,20
kong/go-plugin-tool,47123c5-alpine-latest,2020/05/22,8,30,74,11,0,123
rancher/agent-windows,v0.2.0,2018/03/15,null
intel/esp-uos-firmware-wifi,v3.1.2,2023/07/25,null
airbyte/destination-aws-datalake,0.1.4,2023/10/25,64,8,3,2,0,77
balenalib/asus-tinker-board-ubuntu-node,20231026,2023/11/02,38,9,1,0,0,48
airbyte/source-google-ads,2.0.4,2023/11/10,64,22,6,1,0,93
docker/ucp-interlock-s390x,3.1.0-beta3,2018/10/04,0,2,6,16,0,24
astronomerinc/ap-keda-metrics-adapter,1.5.0,2020/08/03,132,304,47,1,0,484
dynatrace/easytravel-frontend,7.1,2018/05/11,3,19,11,22,0,55
rancher/enterprise,v1.6.30,2020/05/05,74,91,60,25,0,250
balenalib/artik5-fedora-openjdk,8-20220224,2022/03/05,null
onlyoffice/docspace-ssoauth,1.1.4.1,2023/10/23,984,166,231,22,0,1403
mattermost/mm-cloud-ee,2786a79-102,2020/10/14,10,55,84,11,0,160
balenalib/raspberry-pi2-ubuntu-golang,20231026,2023/11/02,133,131,0,0,0,264
balenalib/raspberry-pi2-python,20230911,2023/09/12,118,38,38,6,0,200
rancher/mirrored-calico-kube-controllers,v3.26.3,2023/10/06,0,2,3,0,0,5
balenalib/kitra710-debian-node,20230904,2023/09/09,118,39,39,6,0,202
docker/dtr-content-cache,2.8.1,2020/06/17,2,9,8,1,0,20
balena/rpi-supervisor-node,1244-update-lock-weirdness,2020/04/02,736,709,620,70,8,2143
vmware/lightwave-toolchain-photon3,1.0.1,2019/11/27,53,282,388,86,0,809
balenalib/raspberry-pi2-node,20230911,2023/09/12,118,39,39,6,0,202
bitnami/wavefront-hpa-adapter,0.9.10,2023/05/21,0,3,5,0,0,8
balenalib/kitra710-fedora,20230904,2023/09/09,null
snyk/sweater-comb,2.3.9,2023/11/06,0,4,2,0,0,6
rancher/network-diagnostics-agent,v0.1.0,2017/06/17,307,389,24,0,0,720
balenalib/odroid-xu4-fedora-golang,20221210,2022/12/13,null
kasmweb/telegram,1.14.0,2023/09/14,187,379,0,0,0,566
balenalib/am571x-evm-fedora,20220604,2022/06/12,null
balenalib/beaglebone-black-alpine-openjdk,8-20231106,2023/11/07,0,2,2,0,0,4
mirantis/ucp-kube-compose,3.5.3,2019/11/07,4,14,9,1,0,28
rancher/mirrored-fluent-fluent-bit,1.9.5,2022/06/20,28,31,24,5,0,88
lacework/codesec-iac,v1.0.4,2023/10/02,57,47,11,0,0,115
bitnami/redis-cluster,7.2.3,2023/11/09,75,14,6,2,0,97
amazon/aws-ebs-csi-driver,8382640,2021/07/12,132,107,114,38,3,394
balenalib/orbitty-tx2-debian,20231106,2023/11/07,114,21,27,4,0,166
airbyte/source-strava,0.2.0,2023/10/24,0,13,24,1,0,38
apachepinot/pinot-superset,470541885905-20220907,2022/09/07,823,800,610,50,1,2284
rancher/mirrored-dexidp-dex,v2.37.0,2023/06/30,0,14,6,3,0,23
ambassador/aes-envoy,v4.0.0-preview.2.dev.1,2023/10/27,21,4,1,0,0,26
mirantis/ucp-interlock-extension,3.7.1,2023/09/26,2,3,7,2,0,14
grafana/openshift-cloud-log-forwarder,1.0.1,2022/03/08,69,108,21,0,0,198
airbyte/scheduler,0.101.0-alpha,2021/06/04,252,228,212,48,12,752
okteto/chaat,dev,2020/07/22,1361,1133,1066,120,19,3699
sysdig/aws-mfa,0.1.0,2020/02/12,112,108,95,33,7,355
bitnami/grafana,10.2.0,2023/11/08,88,17,18,4,0,127
redislabs/rcp-gcloud,8a3bb250e2bf37a24038396891e68b5f,2019/07/14,351,677,524,101,16,1669
balenalib/fincm3-fedora,20221031,2022/11/04,null
rapidfort/influxdb,2.7.1,2023/10/12,42,11,13,3,0,69
balenalib/ts4900-alpine-golang,20220714,2022/07/27,8,39,38,12,0,97
okteto/python-job-launcher,launcher,2020/08/18,104,81,86,31,7,309
hashicorp/consul-k8s,0.26.0,2021/06/22,5,31,48,8,0,92
bellsoft/liberica-runtime-container,jre-21.0.1-stream-musl,2023/11/14,null
okteto/welcome,44,2018/12/20,1,9,11,4,0,25
objectscale/iamsvc,0.71.3,2021/04/14,13,93,105,14,3,228
grafana/grafana-arm32v7-linux,7.0.6,2020/07/09,4,30,54,9,0,97
onlyoffice/trello-proxy,1.0.7,2023/11/15,0,2,2,0,0,4
airbyte/source-mailjet-mail,0.1.1,2023/04/19,0,16,25,1,0,42
rancher/fluent-fluent-bit,1.6.10,2021/01/08,13,33,25,10,4,85
atlassian/bamboo-server,9.4.1,2023/11/07,102,144,10,6,0,262
docker/dev-environments-default,639923ad2c5ce6f29a24ca8d11c8f38f9206c462,2021/06/21,495,259,411,60,12,1237
amazon/aws-sam-cli-emulation-image-dotnetcore3.1,20220125,2022/01/25,5,29,25,10,1,70
google/apigee-busybox,1.30.1,2019/05/09,null
snyk/broker,4.169.3-rhel-ubi-nexus2,2023/11/14,58,14,0,0,0,72
newrelic/external-dns,ns1,2019/04/02,4,14,8,2,0,28
newrelic/cluster-api-controller-s390x,mv1a,2019/04/17,0,0,0,0,6,6
balenalib/odroid-xu4-ubuntu-golang,20231026,2023/11/02,133,131,0,0,0,264
onlyoffice/gdrive-gateway,1.0.0-rc15,2023/09/18,0,6,6,0,0,12
mattermost/mattermost-prod-app,v5.33.3,2021/03/31,2,23,28,1,0,54
bitnami/tensorflow-serving,2.14.0,2023/11/06,315,31,24,3,0,373
hashicorp/consul-lambda-registrator,0.1.0-beta4,2023/04/28,10,34,32,4,1,81
dynatrace/dynatrace-oneagent-operator,v0.10.2,2021/09/07,97,189,34,0,0,320
rapidfort/airflow,2.7.1,2023/10/25,28,7,2,1,0,38
percona/percona-server-mongodb,7.0.2-1,2023/10/10,0,4,18,0,0,22
rancher/storage-efs,v0.9.0,2018/01/12,395,723,49,3,0,1170
rancher/terraform-provider-harvester,v0.6.3,2023/08/21,4,15,24,1,1,45
balenalib/intel-nuc-openjdk,20231103,2023/11/05,125,44,29,4,0,202
grafana/logql-analyzer,2.9.2-amd64,2023/10/25,0,2,2,0,0,4
balenalib/aarch64-openjdk,20231106,2023/11/07,118,44,23,4,0,189
mattermost/awat,8330887,2022/03/30,3,30,18,3,0,54
newrelic/cluster-api-controller-amd64,79dda1d3,2019/07/01,0,0,0,0,6,6
intel/query-web,evi-2.0.0,2022/10/31,62,88,1,0,0,151
onlyoffice/docspace-notify,1.1.4.1,2023/10/23,993,143,209,12,0,1357
ubuntu/postgres,14-22.04_edge,2023/08/21,32,10,3,0,0,45
balenalib/generic-armv7ahf-python,20230904,2023/09/09,118,38,38,6,0,200
atlassian/maven,3.5-jdk-8-alpine,2017/09/27,21,69,47,44,0,181
jetbrains/upsource-opscenter,2020.1.1992,2022/03/11,79,148,241,95,0,563
appdynamics/ad-nite-go-services,2019-03-13-1552519571,2019/03/13,210,514,556,132,35,1447
balenalib/qemux86-64-ubuntu-node,20230911,2023/09/11,43,10,5,0,0,58
docker/ucp-kube-compose-s390x,3.1.0-beta3,2018/10/04,0,0,0,2,0,2
rapidfort/nginx-official,1.23.4-perl,2023/05/23,42,31,10,1,0,84
datadog/dd-lib-dotnet-init,v2.41.0,2023/11/05,0,2,2,0,0,4
balenalib/orbitty-tx2-debian-node,20231106,2023/11/07,114,23,28,4,0,169
balenalib/am571x-evm-ubuntu-node,20220715,2022/07/19,88,103,12,0,0,203
balenalib/nitrogen6x-fedora-openjdk,30-20210825,2021/09/03,null
intel/storage-rest,evi-2.0.0,2022/10/31,127,231,43,0,0,401
kumahq/kuma-cp,2.4.4,2023/11/06,0,0,1,0,0,1
balenalib/ts4900-golang,20220714,2022/07/28,473,260,213,28,1,975
rancher/longhornio-longhorn-instance-manager,v1_20220808-s390x,2022/08/08,8,77,66,3,11,165
airbyte/source-google-search-console-singer,0.1.3,2021/07/06,565,318,282,39,7,1211
netdata/base,v2,2023/11/15,83,21,14,1,0,119
balenalib/orbitty-tx2-openjdk,20231106,2023/11/07,125,44,29,4,0,202
rancher/opni-gpu-service-controller,v0.3.1,2022/03/07,8,100,104,7,14,233
rancher/mirrored-sig-storage-snapshot-validation-webhook,v6.2.2,2023/05/27,0,2,1,0,0,3
mirantis/virtlet-base,v1-6348ee2277c565d3895260bccb5ada96,2018/11/30,339,505,35,0,0,879
airbyte/destination-mongodb,0.2.0,2023/07/27,30,120,199,15,1,365
balenalib/qemux86-64-ubuntu-python,20230911,2023/09/11,42,10,4,0,0,56
okteto/guestbook,golang,2020/10/30,97,41,51,16,6,211
kasmweb/core-fedora-37,1.14.0,2023/09/09,null
balenalib/armv5e,20200221,2020/02/29,173,129,166,30,6,504
jetbrains/intellij-http-client,233.11799.6,2023/11/09,0,10,8,0,0,18
balenalib/bananapi-m1-plus-golang,20230904,2023/09/09,448,109,72,9,0,638
balenalib/ts4900-node,18.6-20220714,2022/07/21,124,71,73,18,0,286
vmware/nginx-photon,1.11.13,2017/11/21,8,63,80,49,0,200
redislabs/prometheus-redistimeseries-adapter,version-0.0.17,2020/05/12,2,18,45,4,0,69
pachyderm/goimage,778b7030efafdab9c9d33e97d5b7ea27508c62df,2020/07/14,2,10,32,4,0,48
redislabs/hoverfly,v0.17.7,2019/01/14,83,76,150,28,12,349
grafana/docker-desktop-extension,0.0.5,2023/09/27,0,4,7,0,0,11
mattermost/chaos-dashboard,v0.0.1,2021/08/11,94,38,55,13,6,206
bitnami/nats-exporter,0.13.0,2023/11/08,74,13,8,2,0,97
bellsoft/buildpacks.syft,1.26.0,1980/01/01,null
grafana/grafana-marketing-build,248877623c,2023/06/05,3,23,40,2,0,68
intel/intelligent_traffic_management,4.0,2022/03/23,456,1404,68,0,0,1928
atlassian/jira-core,9.11.3,2023/11/11,25,21,13,1,0,60
balenalib/intel-nuc-alpine-python,20231106,2023/11/07,0,3,2,0,0,5
rapidfort/memcached-ib,1.6.22,2023/10/25,90,37,0,0,0,127
kasmweb/postgres,1.12.0,2022/12/12,0,10,11,0,0,21
balenalib/odroid-xu4-alpine-openjdk,8-20231106,2023/11/07,0,2,2,0,0,4
rancher/dapper,19.03,2020/04/27,2,11,29,4,0,46
onlyoffice/wrata,v1.30.0-197-gb37558a,2023/11/10,0,8,4,0,0,12
airbyte/source-bigcommerce,0.2.0,2023/09/15,0,15,24,1,0,40
newrelic/k8s-nri-nginx,2.0.0,2020/01/28,2,11,29,4,0,46
ubuntu/redis,6.0-22.04_edge,2023/06/19,23,8,2,0,0,33
objectscale/zookeeper-operator,0.28.0,2019/10/09,0,0,0,2,0,2
rancher/helm-project-operator,v0.2.1,2023/06/26,0,11,5,0,1,17
amazon/aws-stepfunctions-local,1.13.2,2023/10/31,0,4,4,1,0,9
balenalib/up-board-ubuntu-python,20230911,2023/09/12,42,10,4,0,0,56
vmware/csp-driver,v1.13.1,2019/03/14,141,580,481,92,18,1312
docker/pipeline_scratch,0.2.0-alpha,2017/04/04,null
rancher/mirrored-library-nginx,1.24.0-alpine-s390x,2023/10/21,0,2,3,0,0,5
airbyte/normalization-tidb,0.4.3,2023/05/12,492,378,329,49,2,1250
balenalib/raspberry-pi2-debian-node,20230911,2023/09/12,118,39,39,6,0,202
balenalib/intel-nuc-alpine,20231106,2023/11/07,0,2,2,0,0,4
balenalib/generic-armv7ahf-debian-openjdk,20230904,2023/09/09,129,65,42,6,0,242
airbyte/connector-builder-server-wrapped,dev-9895397664,2023/08/19,16,61,54,7,0,138
hashicorp/dashboard-init,0.0.4,2018/11/15,0,0,6,14,0,20
rancher/submariner-route-agent,v0.0.1,2019/03/12,45,68,11,0,0,124
mirantis/ucp-kube-dns-sidecar,3.2.15,2021/06/29,0,0,0,2,0,2
astronomerinc/ap-nginx,1.9.4,2023/10/31,0,3,0,0,0,3
graphcore/pytorch-minimal,3.3.0,2023/07/03,140,178,27,0,0,345
ubuntu/grafana-agent,0.35.2-22.04,2023/08/16,22,16,7,0,0,45
pachyderm/example-python-spout-producer,6.x,2021/08/04,34,14,46,13,4,111
grafana/xk6,0.9.2,2023/06/13,470,154,127,14,0,765
airbyte/source-python-http-tutorial,0.1.3,2021/12/30,104,60,72,27,7,270
airbyte/source-postgres,3.2.21,2023/11/09,6,24,15,3,0,48
bitnami/orangehrm-archived,4.9.0-0,2022/01/17,290,279,179,32,12,792
docker/desktop-storage-provisioner,v2.0,2021/04/26,0,6,11,0,0,17
balenalib/beaglebone-green-wifi-fedora-golang,20220523,2022/06/05,null
snyk/snyk-docker-desktop-extension,0.7.4,2023/10/02,null
vmware/photon-2.0-calico-cni,v1.11.2-20180619,2018/06/19,15,72,90,57,0,234
grafana/enterprise-traces,v2.2.4,2023/10/26,0,3,3,0,0,6
intel/oact-rpc-go,v2.22.0,2023/11/07,null
amazon/aws-sam-cli-emulation-image-provided,20220125,2022/01/25,6,120,86,15,1,228
airbyte/source-tempo,0.3.1,2023/03/08,0,16,25,1,0,42
airbyte/source-customer-io,0.2.0,2023/08/29,0,15,24,1,0,40
newrelic/infrastructure,1.48.1,2023/11/02,0,5,0,0,0,5
balenalib/generic-aarch64-fedora-node,20231106,2023/11/06,0,1,1,0,0,2
balenalib/beaglebone-green-fedora-openjdk,30-20210825,2021/09/03,null
hashicorp/counting-init,0.0.9,2018/11/15,0,0,6,14,0,20
rancher/k3d,5.3.0,2022/02/03,9,70,84,17,0,180
atlassian/jira-servicedesk,5.11.3,2023/11/11,27,28,16,2,0,73
intel/gsg_nginx,12.0,2022/12/12,107,109,50,9,0,275
lacework/alert-evidence-materialization,2022-12-29_ANEP-1281_draft_4044af177dd2d4d11f902f86d0afc2916d800af1_RA,2022/12/29,102,270,6,0,0,378
rancher/coreos-prometheus-operator,v0.43.0,2020/10/27,1,7,13,0,0,21
okteto/vote-ssh,dev,2019/05/19,562,1498,1176,245,14,3495
airbyte/seed,0.101.0-alpha,2021/06/03,0,10,2,0,0,12
balenalib/via-vab820-quad-alpine-node,20220714,2022/07/19,7,38,34,10,0,89
datadog/agent-buildimages-windows_1809_x86,v3686353-1e75137,2021/01/12,8,49,134,12,0,203
intel/edge_to_azure_bridge,3.0,2022/04/14,80,87,6,0,0,173
bitnami/kaniko,1.18.0,2023/11/08,0,4,6,0,0,10
balenalib/generic-aarch64-fedora-python,20231106,2023/11/06,null
objectscale/dtsm,3.9.0.0-139102.b4b5064355c,2023/05/03,12,48,41,2,0,103
balenalib/aarch64-alpine-python,20231106,2023/11/06,0,3,2,0,0,5
balenalib/am571x-evm-fedora-openjdk,30-20210825,2021/09/03,null
percona/percona-xtrabackup,8.1.0-1,2023/10/19,96,36,2,0,0,134
balenalib/generic-armv7ahf-fedora-python,20221109,2022/11/16,0,1,0,0,0,1
hashicorp/dev-portal,sha-9855822,2023/01/12,3,138,55,6,0,202
pachyderm/metric-collector,v4,2023/03/31,100,40,32,3,3,178
rancher/ui-plugin-operator,v0.1.1,2023/04/04,0,6,5,0,1,12
balenalib/rpi-golang,20231106,2023/11/07,378,52,42,5,0,477
okteto/rust,1.47.0,2020/11/16,1484,1547,1187,198,37,4453
astronomerinc/ap-airflow,2.4.3-6,2023/03/31,114,81,50,11,0,256
datadog/agent-buildimages-datadog-ci-uploader,v22885174-c6364642,2023/11/06,106,146,12,0,0,264
grafana/celery-exporter,056e4f902d-linux-arm64,2023/10/20,1,2,4,0,0,7
balenalib/generic-armv7ahf-fedora-golang,20221210,2022/12/13,null
grafana/enterprise-logs-provisioner,v1.8.4,2023/10/18,0,2,2,0,0,4
grafana/phlare,0.6.1,2023/06/13,0,19,9,0,0,28
mirantis/ucp-openstack-ccm,3.5.3,2020/03/31,7,32,53,5,0,97
atlassian/confluence,8.6.1,2023/11/11,25,19,7,2,0,53
circleci/rabbitmq-delayed,3.8.9-management-38,2020/10/28,2,15,42,12,0,71
grafana/cortex-ruler,w37-0193e7b7,2018/09/11,0,0,0,2,0,2
airbyte/source-recruitee,0.1.0,2022/11/08,0,17,25,1,0,43
airbyte/source-github,20211124-rc1,2021/11/24,79,60,57,24,1,221
airbyte/connector-builder,0.40.17,2022/10/25,78,40,39,3,0,160
newrelic/nri-network-telemetry,v1.0.3,2020/05/19,2,11,27,4,0,44
hashicorp/levant,0.3.3,2023/10/05,0,1,1,0,0,2
rancher/istio-kubectl,1.5.10,2020/08/19,405,1076,128,0,0,1609
vmware/event-publisher-toolchain,0.2.8,2019/01/23,57,263,298,111,0,729
mattermost/cloud-thanos-store-discovery,v0.1.1,2021/12/08,0,16,24,1,0,41
balenalib/fincm3-golang,20230530,2023/06/27,385,58,46,8,0,497
apachepinot/thirdeye,0.5.0-SNAPSHOT-8900ebb99-20200904,2020/09/04,105,93,104,35,6,343
newrelic/deployer,v1.0.4,2023/11/07,812,724,526,29,0,2091
balenalib/stem-x86-32-alpine-node,16.19.1-20230712,2023/07/15,2,9,7,2,0,20
launchdarkly/ld-find-code-refs-github-action,2.11.4,2023/10/16,0,2,2,0,0,4
okteto/registry-configurator,0.1.5,2021/05/28,101,34,49,15,6,205
sysdig/workload-agent,3.0.1-experimental,2022/07/27,0,0,2,0,0,2
percona/pmm-client,2.40.1,2023/10/20,3,16,8,0,0,27
docker/ucp-interlock-config,3.3.1,2020/06/26,2,19,34,5,0,60
balenalib/kitra520-ubuntu,20220714,2022/08/02,87,81,11,0,0,179
graphcore/pytorch-geometric-jupyter,3.2.1,2023/05/31,297,491,27,0,0,815
greenbone/openvas-smb,22.5.4,2023/10/17,60,5,2,1,0,68
intel/data-analytics,2023.2-py3.10,2023/09/20,100,89,6,1,0,196
netdata/static-builder,v1,2023/11/15,null
airbyte/source-nasa,0.2.0,2023/10/25,0,13,24,1,0,38
okteto/daemon,0.4.0,2023/08/28,0,2,1,0,0,3
balenalib/colibri-imx6dl-ubuntu-openjdk,20210826,2021/09/04,136,435,10,0,0,581
bitnami/service-catalog-archived,0.3.1,2022/01/12,131,86,90,24,6,337
kasmweb/desktop-deluxe,1.14.0,2023/09/14,270,552,0,0,0,822
snyk/ubuntu,nlatest,2023/09/05,21,3,0,0,0,24
balenalib/intel-nuc-node,20231106,2023/11/06,114,23,28,4,0,169
onlyoffice/docs-docservice-ee,7.5.1-1,2023/11/09,0,0,1,1,0,2
rancher/mirrored-metrics-server,v0.6.3,2023/03/21,0,3,4,0,0,7
bitnami/attu,2.3.2,2023/10/24,77,18,7,2,0,104
docker/desktop-kubernetes-etcd,3.5.9-0,2023/05/16,0,12,12,0,0,24
balenalib/intel-nuc-ubuntu,20230911,2023/09/11,42,9,4,0,0,55
objectscale/kubectl,v1.25.15,2023/11/03,0,0,1,0,0,1
airbyte/source-xkcd,0.1.1,2022/10/24,0,15,17,0,0,32
astronomerinc/ap-nats-exporter,0.12.0-1,2023/11/08,0,3,2,0,0,5
mattermost/calls-recorder-daily,v0.4.2-dev,2023/08/16,0,2,1,0,0,3
airbyte/source-mssql,3.0.0,2023/11/07,6,24,15,3,0,48
airbyte/source-lokalise,0.1.0,2022/10/28,0,17,25,1,0,43
rancher/mirrored-thanos-thanos,v0.30.2,2023/01/31,0,4,4,0,0,8
mirantis/ucp-kube-gmsa-webhook,3.5.3,2019/07/17,null
airbyte/source-glassfrog,0.2.0,2023/08/30,0,15,24,1,0,40
hashicorp/vault-k8s,1.3.1,2023/10/25,0,2,2,0,0,4
balenalib/bananapi-m1-plus-debian-golang,20230904,2023/09/09,448,109,72,9,0,638
balenalib/am571x-evm-debian-openjdk,20210602,2021/06/05,230,233,143,39,8,653
balenalib/amd64,20231106,2023/11/06,107,21,21,4,0,153
objectscale/diagnostic-service,0.71.3,2021/04/15,17,149,212,36,6,420
airbyte/source-sftp-bulk,0.1.2,2023/04/19,80,34,26,2,0,142
rancher/hardened-sriov-network-config-daemon,14bd335c17c1b4c6cb7d37c2972c05cc62cadeeb-build20211119,2021/11/19,461,444,36,4,0,945
mirantis/ucp-sf-notifier,3.7.1,2023/09/26,3,4,4,0,0,11
pachyderm/iris-train,rstats-svm,2017/04/20,234,640,709,121,40,1744
rancher/os-logrotate,v1.5.8,2021/02/05,null
airbyte/connector-builder-server,0.50.34,2023/11/09,22,77,79,9,0,187
onlyoffice/box-gateway,1.0.1,2023/09/12,0,6,6,0,0,12
onlyoffice/4testing-docspace-nodejs-runtime,v1.0.0,2023/09/04,984,175,233,15,0,1407
rancher/storage-abs,v0.9.7,2018/07/09,317,492,36,0,0,845
bitnami/tensorflow,2.14.0,2023/10/30,77,15,7,2,0,101
balenalib/ts4900-fedora-node,36-build-20220714,2022/07/22,0,1,1,0,0,2
atlassian/nucleus,88049123,2018/07/12,430,1227,887,242,52,2838
mirantis/ucp-interlock-config,3.7.1,2023/09/26,2,2,4,2,0,10
okteto/node-getting-started,1.0.0,2023/02/27,90,27,30,2,3,152
balenalib/rpi-debian-python,20231106,2023/11/07,107,36,29,4,0,176
balenalib/stem-x86-32-ubuntu,20210812,2021/08/22,108,183,10,0,0,301
airbyte/source-klarna,0.2.0,2023/10/23,0,13,24,1,0,38
intel/observability-telegraf,1.3.0,2023/09/21,0,5,6,0,0,11
mirantis/jnlp-slave,3.7-1,2018/07/11,595,2213,1660,277,27,4772
rancher/mirrored-library-traefik,2.10.5,2023/10/11,0,7,3,0,0,10
airbyte/source-facebook-marketing,20220315-rc1,2022/03/15,79,47,50,17,1,194
accurics/gitlab-connector,1.3,2021/06/11,0,12,40,4,0,56
airbyte/source-github-singer,0.2.8,2021/06/09,105,63,76,30,7,281
rancher/os-acpid,3929481,2017/02/03,null
couchbase/operator,2.5.0,2023/08/14,0,2,1,0,0,3
newrelic/newrelic-super-agent,nightly,2023/11/15,59,7,1,1,0,68
atlassian/deployment-locker,1.7,2021/08/04,null
kasmweb/terminal,1.14.0,2023/09/14,189,387,0,0,0,576
intel/multimodal-data-visualization-streaming,3.0,2022/07/28,158,381,43,0,0,582
rapidfort/zookeeper,3.9.1,2023/10/17,37,10,3,1,0,51
rancher/harvester-eventrouter,v0.1.1,2023/07/18,0,4,3,0,1,8
balenalib/asus-tinker-board-alpine-golang,20231106,2023/11/07,0,2,2,0,0,4
bitnami/node,20.9.0,2023/10/24,431,80,45,5,0,561
rancher/opni-preprocessing-service,v0.12.1-rc1,2023/11/10,2,10,13,0,7,32
bitnami/prometheus,2.47.2,2023/11/09,74,23,12,2,0,111
rancher/netes,v1.7.6-netes2-1,2017/09/23,597,900,62,1,0,1560
datadog/dd-lib-js-init,v4.18.0,2023/11/03,0,3,2,0,0,5
rancher/heapster-grafana-amd64,v4.4.3,2017/09/05,1,8,4,1,0,14
balenalib/i386-nlp-ubuntu-openjdk,20210225,2021/04/11,151,500,17,0,0,668
lacework/lacework-scan,1.2.0,2023/06/08,2,10,14,2,0,28
airbyte/source-qonto,0.2.0,2023/10/25,0,11,16,0,0,27
balenalib/nitrogen6x,20220714,2022/07/20,124,69,72,18,0,283
balenalib/hummingboard,20230904,2023/09/09,118,37,38,6,0,199
pachyderm/notebooks-user,v2.8.0-rc.2,2023/11/13,59,62,26,1,0,148
airbyte/integration-base,0.1.0,2023/01/18,9,74,246,24,0,353
grafana/tns-loadgen,842bd3b,2021/10/31,2,14,13,0,0,29
adobecoldfusion/coldfusion,latest-2023,2023/10/06,30,28,53,23,0,134
vmware/vss-remediation-worker,440-python3.8-alpine3.12,2023/09/27,66,218,168,28,0,480
rancher/network-manager,v0.8.8,2017/09/30,306,388,24,0,0,718
balenalib/revpi-core-3-alpine-openjdk,8-20231106,2023/11/07,0,2,2,0,0,4
balenalib/up-board-debian-python,20230712,2023/07/30,0,1,0,0,0,1
airbyte/source-appfollow,1.0.0,2023/08/21,140,76,40,3,0,259
rancher/mirrored-cilium-cilium,v1.14.4,2023/11/13,19,7,0,0,0,26
google/apigee-mart-server,1.8.0-preview.2,2022/02/18,10,29,28,3,4,74
rapidfort/oncall,v1.0.51,2023/02/15,0,18,18,1,0,37
docker/ecs-searchdomain-sidecar,1.0,2020/10/26,null
okteto/spring-boot-jib,debug2,1970/01/01,37,69,79,28,7,220
balenalib/asus-tinker-board-s-debian-golang,20230911,2023/09/12,448,109,72,9,0,638
docker/dtr,2.8.1,2020/06/17,5,29,37,4,0,75
airbyte/source-mongodb-v2,1.0.9,2023/11/14,6,24,15,3,0,48
okteto/admission-controller,0.2,2019/05/29,0,0,0,2,0,2
onlyoffice/dropbox-auth,1.0.0-rc7,2023/09/04,0,6,5,0,0,11
hashicorp/nomad-website,539195317e77b29c27ffbc0de027bbbf225e7e2cd2a97862659d2fc51dff90a7,2021/03/30,9,62,89,17,0,177
balenalib/asus-tinker-board-s,20230911,2023/09/11,118,37,38,6,0,199
rancher/dqlite-build,v1.4.1-r1,2020/04/23,null
rapidfort/envoy,1.27.1,2023/10/17,19,2,1,0,0,22
rancher/convoy-agent,v0.12.0,2016/09/30,null
astronomerinc/ap-e2e-test,0.3.6,2023/05/25,1109,458,295,19,1,1882
intel/intelligent_traffic_management_pipeline_server_init_dev,2.0,2022/11/15,45,49,5,0,0,99
balenalib/asus-tinker-board-s-ubuntu-python,20231026,2023/11/02,37,9,0,0,0,46
mirantis/dtr-notary-signer,3.0.0-alpha.2,2021/09/22,0,6,26,3,0,35
balenalib/fincm3-debian-node,20230530,2023/07/02,118,39,39,6,0,202
circleci/rabbitmq,3.7.7,2018/09/10,89,117,194,58,12,470
kasmweb/discord,1.14.0,2023/09/14,187,379,0,0,0,566
intel/opae-nlb-demo,0.28.0,2023/09/22,null
balenalib/colibri-imx6dl-alpine-node,20220714,2022/07/19,7,38,34,10,0,89
balenalib/beaglebone-green-wifi-alpine-python,20231106,2023/11/07,0,3,2,0,0,5
airbyte/container-orchestrator,0.50.34,2023/11/09,12,53,61,4,1,131
datadog/agent-buildimages-windows_1909_x64,v3686353-1e75137,2021/01/12,8,49,134,12,0,203
bellsoft/buildpacks.liberica,1.0.0,1980/01/01,0,4,2,0,0,6
mirantis/jenkins,2.121.3,2018/09/05,314,496,447,151,19,1427
pachyderm/chess-analyze,866d97ff6035463c92030b8f01b861c7,2016/12/01,640,1033,72,1,0,1746
google/dart,2.16-beta,2021/12/13,190,105,121,39,9,464
onlyoffice/docspace-studio-notify,1.1.4.1,2023/10/23,993,143,209,12,0,1357
bitnami/minio-client,2023.11.10,2023/11/11,74,13,6,2,0,95
onlyoffice/docs-converter-ee,7.5.1-1,2023/11/09,null
docker/desktop-kubernetes-proxy,v1.28.2,2023/09/13,22,11,5,0,0,38
balenalib/am571x-evm-fedora-node,36-build-20220714,2022/07/22,0,1,1,0,0,2
kasmweb/core-oracle-9,1.14.0,2023/09/09,18,5,835,0,0,858
balenalib/artik10-fedora,20220714,2022/07/23,null
kong/ubi-kuma-prometheus-sd,1.9.8,2023/07/28,42,43,9,0,0,94
purestorage/cockroach-operator,v1.2.2,2022/01/28,0,8,14,1,0,23
docker/embedded-docs-extension,0.0.1-alpha.2,2022/01/21,0,12,22,1,0,35
okteto/gradle,6.5,2023/08/24,170,328,40,2,0,540
intel/esp-logging-agent,v3.1.2,2023/08/17,92,31,30,6,0,159
astronomerinc/ap-openresty,1.21.4-12,2023/11/08,0,2,0,0,0,2
balenalib/bananapi-m1-plus-fedora-golang,20221210,2022/12/13,null
docker/ucp-calico-cni,3.3.1,2020/06/26,115,273,27,0,0,415
vmware/vfile,0.21,0001/01/01,0,16,8,2,0,26
balenalib/colibri-imx6dl-alpine-python,20220714,2022/07/19,7,38,35,10,0,90
airbyte/source-youtube-analytics-business,0.1.0,2022/11/09,0,17,25,1,0,43
bitnami/neo4j,5.13.0,2023/11/03,74,13,6,2,0,95
balenalib/artik710-python,20230829,2023/09/02,118,38,38,6,0,200
okteto/registry-auth,0.1.2,2020/02/05,3,18,41,4,0,66
balenalib/artik530-fedora-node,36-build-20220803,2022/08/04,0,1,1,0,0,2
rancher/opni-training-controller,v0.1.2,2021/07/12,188,147,137,44,8,524
balenalib/artik5-ubuntu-node,20220715,2022/08/02,88,82,12,0,0,182
mirantis/k8s-daemonupgradecontroller,1.5,2017/06/02,0,1,3,0,0,4
airbyte/source-apify-dataset,2.1.0,2023/10/13,0,14,24,1,0,39
airbyte/destination-firebolt,0.1.0,2022/06/27,80,45,45,9,0,179
hashicorp/packer,1.9.4,2023/08/18,1,5,7,1,0,14
pachyderm/pgbouncer,1.17.0-1,2022/05/05,458,313,213,21,1,1006
bitnami/sealed-secrets-controller,v0.24.3,2023/11/02,null
balenalib/apalis-imx6q-ubuntu-python,20220622,2022/06/23,87,112,13,0,0,212
datadog/watermarkpodautoscaler,v0.6.0,2023/10/10,60,20,8,0,0,88
grafana/loki-canary-boringcrypto,2.9.2,2023/10/25,0,1,5,0,0,6
dynatrace/dynatrace-activegate,1.277.180.20231107-134834,2023/11/07,24,5,0,0,0,29
rancher/git-porter,v2.0.0,2022/06/29,8,40,46,13,0,107
rancher/mirrored-calico-ctl,v3.26.3,2023/10/06,0,2,2,0,0,4
rancher/vm-ubuntu,18.04.1-server-amd64-old,2018/11/26,null
balenalib/raspberry-pi2-openjdk,20230911,2023/09/12,129,65,42,6,0,242
balenalib/beaglebone-green-debian-golang,20230911,2023/09/11,448,109,72,9,0,638
grafana/worldping-gw,37b8b2f,2017/11/23,0,1,1,0,0,2
airbyte/cli,0.40.15,2022/10/13,0,25,21,2,0,48
intel/xpumanager,v1.2.13,2023/06/29,24,16,5,0,0,45
graphcore/pytorch-jupyter,3.2.1,2023/05/31,297,489,26,0,0,812
lacework/ephemeral_job_controller_post_processor,20231113-main-9895c0e,1970/01/01,12,20,12,7,0,51
intel/oact-webui,v2.15.0,2023/10/31,0,2,0,0,0,2
grafana/github-repo-metrics,v2,2018/05/09,55,43,70,17,10,195
balenalib/artik533s-alpine-openjdk,8-jre-20220803,2022/08/04,34,78,46,10,0,168
intel/observability-collectd,1.0,2022/06/03,6,66,46,7,0,125
onlyoffice/documentserver-ie,6.0.2.5,2020/11/09,364,1043,60,0,0,1467
jetbrains/qodana-js,2023.2,2023/09/06,138,49,59,11,0,257
rancher/jenkins-jnlp-slave,3.40-1,2020/01/11,64,95,181,48,10,398
docker/ucp-nvidia-device-plugin,3.3.1,2020/06/26,5,26,25,1,0,57
google/cadvisor,v0.33.0,2019/02/27,0,0,8,8,0,16
rancher/mirrored-messagebird-sachet,0.3.1,2022/04/07,0,16,13,1,0,30
airbyte/base-airbyte-protocol-python,0.1.1,2021/04/03,105,58,75,30,7,275
amazon/amazon-ecs-network-sidecar,2.0.0,2022/12/23,3,18,19,0,0,40
balenalib/raspberry-pi2-ubuntu-openjdk,11-xenial-20231026,2023/11/02,null
pachyderm/mount-server-amd64,97276071e371d5b1ea221437e99cfd87b5599ddf,2023/11/03,94,17,26,2,0,139
bellsoft/liberica-openjre-debian,21.0.1-12,2023/11/14,105,18,18,4,0,145
balenalib/fincm3-debian-openjdk,20230530,2023/07/04,143,73,44,6,0,266
kasmweb/atom,1.14.0,2023/09/14,189,379,0,0,0,568
airbyte/destination-csv,1.0.0,2023/01/10,29,129,210,15,1,384
balenalib/armv5e-python,20191011,2019/10/29,185,171,172,35,8,571
balenalib/odroid-c1-alpine,20220714,2022/07/19,7,37,33,10,0,87
grafana/pyroscope,1.1.5,2023/10/12,0,8,8,0,0,16
kasmweb/only-office,1.14.0,2023/09/14,189,379,0,0,0,568
circleci/postgres,13.5,2021/12/18,120,82,75,26,0,303
balenalib/orbitty-tx2,20231106,2023/11/07,114,21,27,4,0,166
balenalib/beaglebone-green-wifi-alpine-openjdk,8-20231106,2023/11/07,0,2,2,0,0,4
vmware/pmdui-toolchain-photon2,1.0.0,2018/07/24,15,193,194,79,0,481
airbyte/source-facebook-marketing-api-singer,0.1.5,2020/12/16,574,370,311,40,7,1302
balenalib/nitrogen6x-ubuntu-node,20220715,2022/07/19,88,103,12,0,0,203
astronomerinc/ap-kube-state,2.10.0,2023/08/31,0,2,1,0,0,3
objectscale/dcm,0.71.3,2021/04/15,16,142,194,36,3,391
intel/rdma_rhel_intel,1.0,2023/04/11,102,76,8,0,0,186
rapidfort/mongodb-perfomance-test,7461f9faf40138c52dc31f5889eb04bddda66a43,2022/06/26,156,116,122,36,0,430
datadog/docker-dd-agent,12.9.5328,2020/10/08,131,83,105,27,6,352
pachyderm/test,9968828025df9eab37b9b01837c11a80cf624f75,2017/09/28,65,106,17,0,0,188
bitnami/pinniped-cli,0.27.0,2023/11/09,84,17,17,4,0,122
rancher/mirrored-directxman12-k8s-prometheus-adapter-amd64,v0.8.3,2021/01/26,null
balenalib/artik10-alpine-python,20220803,2022/08/04,7,38,35,10,0,90
pachyderm/ubuntu-with-s3-clients,v0.0.2,2022/02/18,357,725,69,0,0,1151
google/apigee-asm-istiod,1.12.9-asm.3,2022/09/30,74,138,14,0,0,226
kasmweb/hunchly,1.14.0,2023/09/14,189,379,0,0,0,568
balenalib/asus-tinker-board-ubuntu-openjdk,11-xenial-20231026,2023/11/02,null
google/apigee-runtime,1.8.0-preview.2,2022/02/18,10,36,34,3,4,87
airbyte/destination-dynamodb,0.1.7,2022/11/03,33,150,253,30,1,467
airbyte/source-workramp,0.1.0,2022/11/14,0,17,25,1,0,43
airbyte/source-instagram,1.0.14,2023/11/13,128,39,11,1,0,179
kasmweb/fedora-37-desktop,1.14.0,2023/09/14,0,3,2,0,0,5
objectscale/management-gateway,0.71.3,2021/04/02,5,52,64,5,2,128
balenalib/revpi-core-3-alpine-python,20231106,2023/11/07,0,3,2,0,0,5
newrelic/fastly-to-insights,1.3.2,2023/11/03,0,3,2,0,0,5
balenalib/armv5e-debian-golang,20200213,2020/02/19,679,535,490,63,9,1776
intel/mcss_covid19_solution,2021.4.2,2021/12/16,277,822,38,0,0,1137
newrelic/k8s-nri-couchbase,2.3.5,2020/02/03,2,10,29,4,0,45
cimg/php,8.2.12,2023/10/25,284,323,45,0,0,652
mattermost/builder,go-1.21.3-node-18.17.1-1,2023/10/12,493,109,83,9,0,694
appdynamics/ad-nite-demo-load,2019-03-13-1552504953,2019/03/13,0,0,4,8,0,12
newrelic/k8s-nri-postgresql,2.3.0,2020/01/03,null
appdynamics/analytics-agent,21.6.0,2021/07/13,145,108,38,4,0,295
airbyte/destination-clickhouse-strict-encrypt,0.2.5,2023/06/23,34,146,243,30,1,454
kong/kced,v0.1.16,2023/06/26,0,10,2,0,0,12
mirantis/ucp-containerd-shim-process,3.7.1,2023/07/28,0,2,2,0,0,4
kong/pulp-content,1.1.38,2022/08/24,4,11,9,4,0,28
airbyte/integration-base-singer,0.1.2,2021/08/02,105,58,75,30,7,275
balenalib/imx6ul-var-dart-fedora-python,20221109,2022/11/16,0,1,0,0,0,1
mattermost/mattermost-test-enterprise,8789a29,2020/03/28,6,45,80,9,0,140
mattermost/mattermost-loadtest,5.11,2019/06/21,205,533,558,123,24,1443
rancher/longhornio-longhorn-engine,v1.3.1,2022/08/11,9,82,76,3,11,181
rancher/ui,wagyu,2017/07/31,511,2270,1379,332,74,4566
mirantis/ucp-azure-ip-allocator,3.7.1,2023/09/26,2,2,4,2,0,10
airbyte/destination-meilisearch,1.0.0,2022/10/27,0,17,25,1,0,43
balenalib/odroid-xu4-python,20230911,2023/09/11,118,38,38,6,0,200
datadog/fips-proxy-dev,0.5.1-dev1,2023/05/17,31,18,2,0,0,51
airbyte/server,0.50.34,2023/11/09,13,53,61,4,1,132
airbyte/source-twilio-singer,0.2.3,2021/06/09,569,340,294,39,7,1249
grafana/agent,v0.37.4,2023/11/06,14,5,1,0,0,20
intel/esp-qemu,v3.1.2,2023/08/16,7,99,77,21,0,204
intel/dlstreamer-edge-ai-extension,0.7.1,2022/05/24,359,1234,52,0,0,1645
balenalib/hummingboard-debian-golang,20230904,2023/09/09,448,109,72,9,0,638
bitnami/ruby,3.2.2,2023/10/25,434,80,46,5,0,565
graphcore/pytorch-tutorials,3.1.0,2023/01/04,401,893,39,1,0,1334
rancher/secrets-bridge,v0.2.0,2016/11/27,null
greenbone/openvas-scanner-build,v22.7.6,2023/10/11,499,94,59,5,0,657
airbyte/source-sendgrid,0.4.1,2023/10/15,64,22,6,1,0,93
airbyte/source-shopify,1.1.4,2023/10/19,64,22,6,1,0,93
ddosify/selfhosted_backend,2.3.1,2023/11/01,418,107,55,3,0,583
hashicorp/consul-ecs,0.7,2023/11/07,0,6,2,0,0,8
rancher/os-pingan,v1.5.8,2021/02/05,135,85,99,23,6,348
circleci/vault-cci,0.4,2021/12/14,3,41,53,14,0,111
rancher/calico-cni,v3.18.1,2021/03/10,0,21,42,0,0,63
bitnami/dokuwiki,20230404.1.0,2023/10/11,160,84,55,5,0,304
rancher/alpine-git,1.0.4,2017/07/27,0,30,12,17,0,59
airbyte/source-google-analytics-data-api,2.0.3,2023/11/03,67,24,7,1,0,99
bitnami/openldap,2.6.6,2023/10/09,92,17,14,2,0,125
rancher/hardened-dns-node-cache,1.22.20-build20231010-s390x,2023/10/10,3,8,11,0,2,24
airbyte/source-s3-bulk,4.1.3-dev.cc832795bb,2023/11/14,128,39,11,2,0,180
balenalib/generic-aarch64-fedora-openjdk,8-20231106,2023/11/06,null
balenalib/generic-aarch64-alpine-openjdk,8-20231106,2023/11/06,8,10,2,0,0,20
jetbrains/datalore-agent,2023.5.1,1970/01/01,182,214,36,0,0,432
rancher/mirrored-neuvector-registry-adapter,0.1.1,2023/08/17,0,2,2,0,0,4
airbyte/source-commercetools,0.2.0,2023/08/24,0,15,24,1,0,40
balenalib/artik10-alpine,20220803,2022/08/03,7,37,33,10,0,87
continuumio/ap-auth-keycloak,4.5.0.Final,2018/10/16,866,1198,351,88,0,2503
cockroachdb/molt-lms,0.2.2,2023/11/13,0,2,2,0,0,4
airbyte/destination-s3-glue,0.1.7,2023/05/04,34,145,242,30,1,452
google/apigee-installer,1.8.1,2022/09/22,0,2,6,0,0,8
balenalib/spacely-tx2-fedora-golang,20231106,2023/11/06,null
okteto/fileserver,0.0.0,2021/12/17,null
redislabs/redis-connect-sqlserver,0.8.0-139,2022/01/22,4,27,36,13,0,80
bitnami/milvus,2.3.3,2023/11/14,74,15,10,2,0,101
airbyte/webapp,0.50.34,2023/11/09,0,4,1,0,0,5
balenalib/intel-nuc-fedora-golang,20231103,2023/11/04,null
rancher/tektoncd-kubeconfigwriter,2000fdb7,2019/05/29,0,0,0,0,6,6
datadog/observability-pipelines-worker,1.6.0,2023/11/03,28,9,0,0,0,37
pachyderm/python-build,2.0.0-alpha.20,2021/05/25,1443,1307,916,142,37,3845
balenalib/hummingboard-ubuntu-openjdk,11-xenial-20230904,2023/09/09,null
airbyte/source-quickbooks,3.0.0,2023/09/27,0,15,24,1,0,40
docker/binfmt,820fdd95a9972a5308930a2bdfb8573dd4447ad3,2019/05/20,null
hashicorp/learn-website,85289765ffa05e170f7e2faedbbfefa46cd3d8d8e4b307fabae676ce5bf0e131,2020/07/27,18,131,201,40,0,390
rancher/mirrored-ingress-nginx-kube-webhook-certgen,v1.3.0,2022/08/01,0,3,6,0,0,9
airbyte/base-python-test,0.1.1,2021/04/03,105,58,75,30,7,275
airbyte/source-zendesk-support-singer,0.2.3,2021/07/02,105,62,77,30,7,281
intel/intel-idxd-config-initcontainer,0.28.0,2023/09/22,null
bitnami/mysqld-exporter,0.15.0,2023/11/08,74,15,7,2,0,98
rapidfort/etcd-ib,v3.5.10,2023/11/08,18,27,2,0,0,47
grafana/prometheus-pulsar-remote-write,v0.3.0,2023/03/09,0,16,6,0,0,22
intel/oneapi-iotkit,2023.2.1-devel-ubuntu22.04,2023/07/31,183,173,34,0,0,390
balenalib/artik533s-debian-golang,20220714,2022/07/22,473,263,219,28,1,984
airbyte/source-genesys,0.1.0,2022/11/13,0,15,17,0,0,32
pachyderm/jupyterhub-pachyderm-user,1.1.0,2020/04/15,131,132,56,4,0,323
google/tf-serving-scann,2.11.0,2022/12/08,169,324,36,0,0,529
airbyte/source-google-search-console,1.3.6,2023/10/26,64,22,6,1,0,93
balenalib/raspberrypi3-fedora-golang,20220523,2022/06/04,null
rancher/lb-controller,v0.3.1,2016/10/16,0,9,27,8,0,44
okteto/charts,dev,2020/12/19,25,75,78,12,0,190
docker/ucp-interlock-proxy,3.3.1,2020/06/26,2,19,34,5,0,60
datadog/dd-trace-py,testrunner,2023/02/17,738,322,278,24,3,1365
balenalib/nitrogen6x-ubuntu-openjdk,20210826,2021/09/04,136,435,10,0,0,581
balenalib/qemux86-64-debian-openjdk,20231106,2023/11/06,125,44,29,4,0,202
airbyte/source-zendesk-sunshine,0.2.0,2023/08/24,0,15,24,1,0,40
bellsoft/buildpacks.spring-boot,5.23.0,1980/01/01,null
redislabs/redisml,edge,2019/02/21,49,24,49,9,7,138
docker/kube-compose-api-server,v0.5.0,2022/02/14,0,6,14,1,0,21
kong/inso,2023.5.8,2023/09/07,0,12,8,1,0,21
datadog/agent-buildimages-deb_x64,v20433308-6861270,2023/09/25,3,25,22,1,0,51
balenalib/via-vab820-quad-fedora-golang,20220507,2022/05/12,null
balena/rpi-supervisor,1299,2020/07/31,6,26,55,9,0,96
kasmweb/postman,1.14.0,2023/09/14,191,403,12,8,0,614
balenalib/raspberrypi3-alpine-golang,20231106,2023/11/07,0,2,2,0,0,4
objectscale/objectscale-lcm,1.3.0-274.bf1767e,2023/11/14,0,2,1,0,0,3
sysdig/node-image-analyzer,0.1.29,2023/10/10,99,52,8,0,0,159
airbyte/source-mailchimp,0.8.2,2023/11/14,64,22,7,1,0,94
docker/dtr-api,2.8.1,2020/06/17,7,73,99,18,1,198
airbyte/source-dixa,0.3.0,2023/10/30,0,13,24,1,0,38
intel/alpine,test-rm,2023/01/09,0,18,16,0,0,34
rancher/os2-framework,5517767-amd64,2021/10/22,32,214,199,8,8,461
kong/kubernetes-ingress-controller,3.0,2023/11/03,null
balenalib/artik533s-ubuntu-golang,20220803,2022/08/03,245,463,67,0,0,775
balenalib/armv7hf-fedora-python,20221031,2022/11/04,0,1,1,0,0,2
intel/rpbs_benchmark_service,1.0,2023/08/21,50,21,7,0,0,78
rancher/os-nvidiadriver,v1.5.8,2021/02/05,1327,1410,153,3,1,2894
onlyoffice/docs-spellchecker-de,6.2.2.17,2021/04/27,536,493,32,3,0,1064
balenalib/apalis-imx6q-alpine-golang,20220714,2022/07/27,8,39,38,12,0,97
rancher/rke-tools,v0.1.96,2023/10/30,1,19,18,0,0,38
bitnami/prometheus-rsocket-proxy,1.5.3,2023/11/09,74,23,12,4,0,113
rancher/busybox,1.31.1,2020/06/02,null
dynatrace/dynatrace-synthetic-vuc,1.277.38.20231010-152746,2023/10/10,22,15,5,0,0,42
mattermost/mattermost-team-edition,19698_b6746054,2023/07/31,62,46,10,0,0,118
rancher/telemetry,v0.6.1,2019/10/31,108,74,12,0,0,194
rancher/harvester-load-balancer,v0.2.2,2023/08/29,1,6,8,0,1,16
appdynamics/machine-agent-analytics,23.10.0,2023/10/30,128,32,4,1,0,165
onlyoffice/4testing-appserver-migration,test-2022081607,2022/08/16,1014,332,356,24,1,1727
tenable/audit-utils,20231109.14,2023/11/09,22,8,0,0,0,30
amazon/aws-cli,2.13.35,2023/11/13,null
kasmweb/opensuse-15-desktop,1.14.0,2023/09/14,6,27,44,3,1,81
rancher/mirrored-sig-storage-csi-node-driver-registrar,v2.9.1,2023/11/09,0,0,1,0,0,1
rapidfort/redis6-ib,6.2.14,2023/10/25,83,37,0,0,0,120
bitnami/consul-exporter,0.9.0,2023/11/08,74,15,10,2,0,101
bitnami/jruby,9.4.3-0,2023/10/24,431,86,46,4,0,567
mirantis/external-dns,v0.5.3,2018/06/15,0,2,2,2,0,6
rancher/mirrored-grafana-grafana-image-renderer,3.8.0,2023/08/25,0,7,7,1,0,15
appdynamics/dotnet-core-agent,23.10.0,2023/10/20,null
docker/cloudbees-jenkins-distribution,2.277.4.2,2021/04/28,253,210,304,79,10,856
airbyte/source-netsuite,0.1.3,2023/01/20,0,14,17,0,0,31
google/apigee-cassandra-backup-utility,1.8.0-preview.2,2022/01/20,9,35,29,6,4,83
redislabs/redisgears,1.2.5,2022/07/05,117,81,85,25,0,308
mirantis/ucp-nvidia-device-plugin,3.7.1,2023/09/26,34,34,9,0,0,77
rancher/nginx-ingress-controller,0.10.2,2018/01/25,88,108,197,64,9,466
bitnami/redis-sentinel-exporter-archived,1.7.1,2021/07/18,130,85,84,25,6,330
greenbone/gvmd,23.1,2023/11/14,94,16,15,2,0,127
onlyoffice/docs-converter,7.5.1-1,2023/11/09,null
airbyte/bootloader,0.50.34,2023/11/09,13,53,60,4,1,131
balenalib/ts4900-debian-golang,20220714,2022/07/28,473,260,213,28,1,975
atlassian/nfs-server-test,2.1,2023/02/02,220,162,20,0,0,402
rancher/mirrored-prometheus-prometheus,v2.42.0,2023/02/01,0,14,11,0,0,25
docker/extended-logs-extension,0.1.2,2022/04/28,0,12,8,1,0,21
balenalib/artik10-fedora-golang,20220714,2022/07/23,null
balenalib/hummingboard-openjdk,20230904,2023/09/09,129,65,42,6,0,242
airbyte/source-salesforce-singer,0.2.5,2021/08/02,565,316,279,39,7,1206
airbyte/source-tmdb,0.1.0,2022/11/16,0,17,25,1,0,43
airbyte/workload-api-server,final-0,2023/11/14,12,50,58,4,1,125
bitnami/nginx-ldap-auth-daemon-archived,0.20200116.0,2022/04/05,135,84,77,22,6,324
rancher/coreos-configmap-reload,v0.0.1,2017/01/02,null
balenalib/orangepi-plus2,20230911,2023/09/11,118,37,38,6,0,199
hashicorp/sentinel-website,621533a472164fac1133e38562d81440dc48783a,2020/07/06,13,82,133,29,0,257
airbyte/source-my-hours,0.1.1,2022/06/09,0,17,26,1,0,44
ddosify/selfhosted_hammermanager,1.2.2,2023/06/20,77,31,23,2,0,133
balenalib/imx6ul-var-dart-python,20230911,2023/09/12,118,38,38,6,0,200
objectscale/csi-baremetal-loopbackmgr,0.69.0,2021/03/07,68,67,16,0,0,151
balenalib/via-vab820-quad-alpine,20220714,2022/07/19,7,37,33,10,0,87
mirantis/ucp-calico-node,3.7.1,2023/09/26,32,22,8,0,0,62
rancher/storage-nfs,v0.9.7,2018/07/09,125,242,12,0,0,379
docker/ucp-azure-ip-allocator,3.3.1,2020/06/26,2,8,7,1,0,18
datadog/agent-amd64,7.29.1,2021/07/12,34,118,102,5,0,259
hashicorp/terraform-k8s,1.1.2,2022/11/23,0,15,19,1,0,35
balenalib/odroid-c1,20220714,2022/07/20,124,69,72,18,0,283
datadog/chaos-handler,8.3.0,2023/10/26,null
rancher/favorite-tweets,v1.0.2,2019/02/11,589,1564,1276,267,16,3712
rancher/goreleaser,v0.0.1-alpha,2023/03/07,5,42,31,8,0,86
rancher/hardened-whereabouts,v0.6.2-build20231009,2023/10/09,2,6,8,0,2,18
airbyte/source-datadog,0.3.0,2023/08/29,0,15,24,1,0,40
grafana/pdc-agent,0.0.20,2023/11/08,0,2,2,0,0,4
balenalib/asus-tinker-board-golang,20230904,2023/09/09,448,109,72,9,0,638
atlassian/pipelines-agent-log-sidecar,stg-stable,2019/07/03,91,162,171,44,11,479
intel/image-segmentation,tf-spr-3d-unet-mlperf-inference,2023/03/31,33,23,6,0,0,62
balenalib/orangepi-plus2-ubuntu-openjdk,11-xenial-20231026,2023/11/02,null
rancher/mirrored-kube-rbac-proxy,v0.14.0,2022/12/15,0,3,5,0,0,8
kong/kong-build-tools,rpm-1.8.3,2023/02/16,898,1003,52,0,0,1953
balenalib/up-board-alpine,20231106,2023/11/07,0,2,2,0,0,4
okteto/doppler-injector,0.2,2019/02/15,4,14,8,2,0,28
balenalib/artik533s-ubuntu-openjdk,20210826,2021/09/21,136,435,10,0,0,581
rancher/mirrored-jettech-kube-webhook-certgen,v1.5.2,2021/04/07,0,5,10,0,4,19
balenalib/raspberrypi3-golang,20230530,2023/06/27,385,58,46,8,0,497
rancher/mirrored-kiwigrid-k8s-sidecar,1.24.6,2023/07/06,0,12,3,3,0,18
balenalib/zynq-xz702-fedora-node,36-build-20220714,2022/07/22,0,1,1,0,0,2
balenalib/parallella-ubuntu,20230904,2023/09/09,42,9,4,0,0,55
kasmweb/api,1.14.0,2023/09/14,28,9,1,0,0,38
rancher/os-iscsi,v2.0.873-2,2019/07/23,556,1489,1160,245,14,3464
bitnami/grafana-image-renderer,3.8.4,2023/10/27,159,74,31,2,6,272
bitnami/fluxcd-source-controller,1.1.2,2023/11/15,75,16,8,2,0,101
mattermost/matterwick,v0.3.17,2023/11/14,5,26,13,1,0,45
atlassian/pipelines-docker-daemon,v20-beta,2021/03/04,10,56,62,9,0,137
mattermost/poc-simple-service-daily,v0.0.4,2022/06/22,0,4,5,0,0,9
mattermost/calls-offloader,v0.4.1,2023/10/12,3,10,6,0,0,19
astronomerinc/ap-build,0.3.0-2,2023/08/03,190,216,49,0,0,455
intel/intel-optimized-ml,xgboost-1.4.2,2021/09/07,79,79,8,1,0,167
airbyte/source-postgres-singer,0.1.4,2020/10/26,594,408,393,42,11,1448
atlassian/agent-setup-git,1.6,2016/06/28,1,62,59,23,0,145
balenalib/ts4900-debian-python,20220604,2022/06/12,124,82,74,20,0,300
balenalib/odroid-c1-debian-node,18.6-20220714,2022/07/21,124,71,73,18,0,286
rancher/kolla-base,mitaka,2016/06/16,435,2519,1677,451,78,5160
rancher/docker-elasticsearch-kubernetes,5.6.2,2017/09/28,17,76,47,13,0,153
hashicorp/envoy,1.27.2,2023/10/23,7,0,0,0,0,7
grafana/enterprise-metrics-boringcrypto,v2.10.4,2023/11/14,0,2,2,0,0,4
rancher/mirrored-prometheus-operator-prometheus-operator,v0.65.1,2023/05/05,0,4,3,0,0,7
balenalib/amd64-ubuntu,20230929,2023/10/07,39,9,4,0,0,52
redislabs/debezium-server,2.0.0.cassandra,2022/11/28,119,200,47,1,0,367
datadog/agent-buildimages-windows_1909_x86,v3686353-1e75137,2021/01/12,8,49,134,12,0,203
airbyte/source-zendesk-singer,0.1.1,2020/12/11,105,81,87,31,7,311
mattermost/chimera,6908324,2021/09/22,0,3,6,0,4,13
newrelic/infrastructure-bundle,3.2.25-rc,2023/11/15,0,9,2,0,0,11
balenalib/hummingboard-debian-python,20230904,2023/09/09,118,38,38,6,0,200
balenalib/armv7hf-debian-openjdk,20230929,2023/10/02,122,65,37,6,0,230
balenalib/parallella-debian,20230904,2023/09/09,118,37,38,6,0,199
rancher/webhook-receiver,v0.2.7,2022/06/08,0,10,5,1,2,18
bellsoft/alpaquita-linux-base,stream-musl-231114,2023/11/14,null
okteto/git-installer,1.2.9,2021/03/11,234,154,184,46,9,627
amazon/opendistro-for-elasticsearch,1.13.3,2021/12/11,558,571,116,10,0,1255
rancher/mirrored-sig-storage-snapshot-controller,v6.2.1,2023/01/04,0,2,2,0,0,4
kasmweb/core-remnux-focal,1.13.1,2023/06/06,250,505,0,0,0,755
vmware/vsphere-storage-for-docker,0.21,0001/01/01,0,1,5,2,0,8
airbyte/source-e2e-test-cloud,2.1.5,2023/10/07,12,53,65,20,0,150
airbyte/destination-weaviate-preview,dev2,2023/09/18,65,25,7,4,0,101
rancher/mirrored-coreos-prometheus-operator,v0.40.0,2020/06/18,0,8,12,0,0,20
greenbone/gvm-libs,23.3.0,2023/03/30,90,34,25,2,0,151
rancher/mirrored-kubernetes-external-dns,v0.7.3,2020/08/05,4,21,46,4,0,75
bitnami/dotnet,7.0.14,2023/11/14,434,78,47,5,0,564
objectscale/objectscale-performance,1.4.0-397.adb0726,2023/11/13,0,3,2,0,0,5
objectscale/ecs-flex-vsphere-plugin,0.71.3,2021/04/14,5,52,64,5,2,128
airbyte/source-mailerlite,0.1.0,2022/10/28,0,17,25,1,0,43
greenbone/notus-scanner,22.6,2023/08/30,73,29,13,1,0,116
balenalib/raspberry-pi2-alpine-python,20231106,2023/11/07,0,3,2,0,0,5
rancher/rke-service-sidekick,v0.1.2,2018/04/02,null
airbyte/integration-singer-postgres-destination,0.1.2,2020/10/08,586,415,398,41,11,1451
datadog/fakeintake,v94025128,2023/07/04,22,8,2,0,0,32
cockroachdb/tpc-e,master,2023/04/27,71,24,19,2,0,116
rancher/os-waagent,v2.2.34-1,2019/01/14,73,165,170,42,19,469
google/apigee-envoy-adapter,v2.1.1,2023/06/07,0,5,8,0,0,13
airbyte/destination-rockset,0.1.4,2022/08/08,81,100,123,34,0,338
airbyte/source-e2e-test,2.1.5,2023/10/06,12,53,65,20,0,150
kasmweb/oracle-8-desktop,1.14.0,2023/09/14,8,17,848,0,0,873
balenalib/beaglebone-green-wifi-debian-node,20230911,2023/09/12,118,39,39,6,0,202
balenalib/kitra710-debian-python,20230829,2023/09/02,118,38,38,6,0,200
airbyte/airbyte-bigquery-destination-abprotocol,0.1.0,2020/10/20,100,76,83,24,6,289
intel/user-oob-client-for-azure,v0.7,2022/09/13,185,447,41,0,0,673
balenalib/artik10-ubuntu,20220714,2022/08/02,87,81,11,0,0,179
astronomerinc/ap-git-sync,3.6.9,2023/08/16,99,25,27,5,0,156
astronomerinc/ap-git-daemon,3.18.4-1,2023/11/06,0,3,0,0,0,3
balenalib/raspberry-pi2-debian,20230911,2023/09/11,118,37,38,6,0,199
balenalib/artik10-alpine-golang,20220803,2022/08/04,8,39,38,12,0,97
balenalib/beaglebone-black-debian-openjdk,20230911,2023/09/12,129,65,42,6,0,242
airbyte/destination-elasticsearch,0.1.6,2022/10/26,29,129,211,15,1,385
balenalib/colibri-imx6dl-debian-python,20220604,2022/06/12,124,82,74,20,0,300
amazon/aws-sam-cli-emulation-image-go1.x,20220125,2022/01/25,6,120,86,15,1,228
objectscale/telegraf,0.54.0,2020/11/06,2,49,53,6,2,112
bitnami/golang,1.21.4,2023/11/08,423,76,43,5,0,547
bellsoft/buildpacks.java-native-image,1.0.0,1980/01/01,0,4,2,0,0,6
intel/recommendation,wide-deep-large-ds-int8-inference,2021/07/24,678,988,164,7,0,1837
rancher/ui-plugin-catalog,1.0.1,2023/10/03,3,5,8,0,2,18
bitnami/oras,1.1.0,2023/11/09,null
bitnami/kubeapps-oci-catalog,2.9.0,2023/10/26,74,13,6,2,0,95
amazon/aws-virtual-gpu-device-plugin,v0.1.1,2020/03/03,27,328,257,34,1,647
airbyte/source-freshcaller,0.3.0,2023/11/07,0,13,24,1,0,38
rancher/mirrored-istio-mixer,1.7.8,2021/02/24,1,9,15,1,4,30
amazon/aws-lambda-provided,alami.2023.11.12.08,2023/11/12,null
intel/reconfigurable-ri-server,4.0,2022/12/21,32,40,25,3,0,100
airbyte/source-db2-strict-encrypt,0.1.19,2023/03/22,30,129,203,15,1,378
objectscale/resource-service,0.71.3,2021/04/15,16,142,194,36,3,391
bitnami/memcached-exporter,0.13.0,2023/11/08,74,15,7,2,0,98
portainer/pri-fidoiot,rv-master,2022/02/02,98,248,8,4,0,358
docker/dtr-notary-signer-s390x,2.5.0-beta3,2018/01/17,0,16,41,34,0,91
onlyoffice/docspace-login,1.1.4.1,2023/10/23,982,150,214,12,0,1358
balenalib/beaglebone-black-debian-python,20230911,2023/09/12,118,38,38,6,0,200
rancher/rancher-flexvol,567229c-dirty,2016/09/14,97,122,23,0,0,242
balenalib/artik5-python,20220714,2022/07/22,124,70,74,18,0,286
rancher/k8s-dns-sidecar-amd64,1.15.0,2018/11/12,0,0,0,2,0,2
google/apigee-udca,1.8.0-preview.2,2022/04/05,7,30,32,3,4,76
airbyte/destination-redshift,0.6.10,2023/11/09,10,41,61,18,0,130
intel/spark,evi-2.0.0,2022/10/31,67,151,305,136,0,659
airbyte/destination-starburst-galaxy,0.0.1,2023/04/21,36,157,257,33,1,484
airbyte/source-cart,0.2.1,2023/02/23,0,16,25,1,0,42
grafana/loki-query-tee,2.9.2-amd64,2023/10/25,0,3,3,0,0,6
balenalib/asus-tinker-board-s-debian,20230911,2023/09/11,118,37,38,6,0,199
balenalib/nitrogen6x-debian-openjdk,20210602,2021/06/05,230,233,143,39,8,653
circleci/python,3.11-rc,2021/12/18,872,1037,794,103,3,2809
balenalib/hummingboard-fedora-node,36-build-20230530,2023/06/29,0,1,1,0,0,2
airbyte/source-elasticsearch,0.1.1,2022/12/02,29,128,210,15,1,383
balenalib/beaglebone-black-ubuntu-openjdk,11-xenial-20230712,2023/07/14,null
airbyte/source-pocket,0.1.0,2022/11/10,0,17,25,1,0,43
balenalib/spacely-tx2-ubuntu-openjdk,11-xenial-20231103,2023/11/06,null
airbyte/source-captain-data,0.1.0,2023/07/25,0,15,24,1,0,40
rancher/fluentd,v0.1.31,2021/11/16,75,66,54,20,0,215
adobecoldfusion/pmt2021,2021.0.4,2022/12/02,60,88,59,27,0,234
circleci/mariadb,10.7.1,2022/02/22,111,325,8,0,0,444
okteto/golang-http-template,0.1.1,2020/06/01,710,536,507,64,9,1826
pachyderm/tf_job_s3_gateway,1.9.2,2019/08/02,462,737,173,18,0,1390
rancher/git-mirror,v2.0.0,2022/06/29,4,26,27,7,0,64
airbyte/source-sftp,0.1.2,2022/06/17,76,76,61,19,0,232
rancher/k8s-dns-dnsmasq-nanny-amd64,1.15.0,2018/11/12,0,0,0,2,0,2
rancher/mongodb-conf,v0.1.1,2017/02/27,null
grafana/grafana-image-renderer,3.8.4,2023/10/19,0,5,3,1,0,9
airbyte/mirrored-keycloak,21.1,2023/06/28,15,36,7,0,0,58
intel/dlstreamer-pipeline-server-k8s-sidecar,2022.2.0,2022/10/22,77,35,37,3,0,152
newrelic/php-daemon,10.14.0,2023/11/13,null
bitnami/schema-registry,7.5.2,2023/11/09,74,17,8,8,0,107
rancher/mirrored-istio-install-cni,1.19.0,2023/09/01,29,13,8,0,0,50
balenalib/beaglebone-green-wifi-alpine-golang,20231106,2023/11/07,0,2,2,0,0,4
rancher/mirrored-neuvector-updater,latest-amd64,2023/11/14,null
onlyoffice/4testing-docspace-notify,2.0.0.33,2023/11/15,993,142,206,12,0,1353
balenalib/fincm3-ubuntu-python,20230530,2023/07/02,54,20,4,0,0,78
puppet/estate-reporting-query,85360599b21e795d92898b540e0faac15c0b2d7b,2020/03/24,0,5,5,0,0,10
balenalib/fincm3-ubuntu-node,20230530,2023/07/04,55,20,5,0,0,80
apachepinot/pinot-presto,0.274,2022/07/20,1083,551,837,113,1,2585
balenalib/beaglebone-green-debian,20230911,2023/09/11,118,37,38,6,0,199
balenalib/artik5-debian,20220714,2022/07/22,124,69,72,18,0,283
google/apigee-stackdriver-prometheus-sidecar,1.0.0-beta,2019/03/25,null
newrelic/k8s-golang-apm-linkage-demo,1.1.0,2019/04/01,6,20,11,2,0,39
dynatrace/dynatrace-push-event-bitbucket-pipe,0.1.0,2021/04/15,4,10,9,1,0,24
rancher/calico-node,v3.18.1,2021/03/11,59,108,32,0,0,199
atlassian/agent-setup-hg,1.15,2016/06/30,0,57,44,18,0,119
rancher/cli2,v2.8.0,2023/10/23,0,4,6,0,1,11
bitnami/nginx-exporter,0.11.0,2023/11/09,74,13,6,2,0,95
airbyte/destination-mysql,0.2.0,2023/06/29,34,145,243,30,1,453
syncfusion/pdfviewer-server,23.1.36,2023/09/15,184,108,53,3,0,348
balenalib/kitra520-fedora,20220714,2022/07/23,null
okteto/syncthing,1.3.0,2019/10/07,4,19,21,1,0,45
qualys/qualys-client-for-jira-integration,1.2.0,2023/10/13,0,6,4,0,0,10
okteto/dns,0.1.0,2020/06/13,3,20,41,4,0,68
mirantis/virtlet,v1.5.1,2019/05/16,339,505,35,0,0,879
okteto/node,18,2023/08/24,482,282,90,10,0,864
objectscale/csi-baremetal-scheduler,0.69.0,2021/03/07,72,83,27,1,0,183
airbyte/source-paystack,0.1.3,2023/03/21,0,16,25,1,0,42
balenalib/odroid-xu4-fedora-openjdk,30-20210825,2021/09/03,null
balenalib/revpi-core-3-ubuntu-golang,20231026,2023/11/02,133,131,0,0,0,264
rancher/mirrored-k8s-dns-kube-dns,1.22.20,2023/02/22,0,2,1,0,0,3
redislabs/rgcluster,1.2.7,2022/07/05,117,81,85,29,0,312
rancher/opni-training-controller-service,v0.12.1-rc1,2023/11/10,8,84,93,6,11,202
rancher/istio-pilot,1.8.3,2021/02/05,302,918,127,2,0,1349
balenalib/armv5e-debian-openjdk,20200221,2020/02/29,259,276,212,44,8,799
formio/sql-connector,2.0.10,2022/09/22,5,84,84,14,0,187
mirantis/ucp,3.7.1,2023/09/26,4,5,8,2,0,19
balenalib/amd64-alpine-golang,20231106,2023/11/07,0,2,2,0,0,4
kasmweb/agent,1.14.0,2023/09/14,25,8,0,0,0,33
balenalib/asus-tinker-board-fedora-python,20221109,2022/11/16,0,1,0,0,0,1
mattermost/mm-ee-test,9986853,2023/05/07,72,77,12,0,0,161
rancher/openzipkin-zipkin,2.14.2,2019/06/15,5,42,83,31,6,167
rancher/system-agent-installer-k3s,v1.28.3-k3s2-linux-s390x,2023/11/08,null
mirantis/ucp-pause,3.7.1,2022/12/22,null
bitnami/mongodb,7.0.3,2023/11/14,81,14,11,3,0,109
percona/mongodb_exporter,2.37.0,2023/04/06,0,2,3,0,0,5
airbyte/source-drift,0.3.0,2023/08/15,0,15,24,1,0,40
rancher/gc-manager,v0.1.0,2017/05/17,97,113,18,0,0,228
balenalib/apalis-imx6q-debian,20220714,2022/07/20,124,69,72,18,0,283
bitnami/grafana-loki,2.9.2,2023/11/08,74,15,8,2,0,99
newrelic/newrelic-infra-operator,0.13.0,2023/11/13,0,2,2,0,0,4
balenalib/stem-x86-32-debian-openjdk,20230904,2023/09/09,129,65,42,6,0,242
percona/dbaas-catalog,0.0.66,2023/09/13,1,8,10,0,0,19
okteto/maven,3,2023/08/24,12,99,64,0,0,175
sysdig/kubewatcher,0.3.0,2019/11/26,503,2377,1485,386,72,4823
adobecoldfusion/coldfusion2021,2021.0.11,2023/10/06,32,56,177,105,0,370
docker/dtr-rethink-s390x,2.5.0-beta3,2018/01/17,2,16,7,15,0,40
graphcore/pytorch-paperspace,3.3.0,2023/07/03,220,336,28,0,0,584
vmware/cascade,1.0,2018/04/13,14,145,161,65,0,385
intel/oneapi,2023.2-devel-ubuntu22.04,2023/07/14,189,178,39,0,0,406
circleci/circleci-cli,0.1.29314,2023/11/08,294,325,45,0,0,664
redislabs/redis-connect-cli,v0.24.1-beta.15,2022/10/31,67,78,10,0,0,155
rancher/library-busybox,1.32.1,2021/04/08,null
rancher/giddyup,v0.19.0,2017/08/24,40,79,82,22,18,241
objectscale/csi-baremetal-scheduler-extender,0.69.0,2021/03/07,71,78,21,0,0,170
okteto/actions-base,1.0,2022/04/06,194,248,190,30,7,669
mattermost/release-bot-daily,66938499,2022/08/25,null
rancher/hardened-kubernetes,v1.21.2,2021/06/28,454,440,101,8,0,1003
balenalib/ts4900-debian-node,18.6-20220714,2022/07/21,124,71,73,18,0,286
puppet/puppetboard,0.3.0,2018/06/05,1,21,15,1,0,38
balenalib/jetson-tx2-alpine-golang,20231106,2023/11/06,0,2,2,0,0,4
docker/ucp-hrm,2.2.22,2019/10/07,4,11,20,1,0,36
rancher/mirrored-plugins-docker,19.03.8,2020/11/19,3,13,33,5,0,54
intel/intel-optimized-lammps,202302,2023/02/13,262,406,56,0,0,724
bitnami/cassandra,4.1.3,2023/11/15,79,27,17,2,0,125
datadog/serverless-init,1.1.3,2023/11/01,0,0,1,0,0,1
rancher/os-amazonmetadata,v1.5.8,2021/02/05,2,10,28,5,0,45
astronomerinc/ap-postgres-operator,1.8.2,2023/02/07,0,3,7,1,0,11
kasmweb/signal,1.14.0,2023/09/14,187,379,0,0,0,566
rancher/cert-manager-controller-arm64,v0.7.2-rio.1,2019/05/15,0,0,0,2,0,2
rancher/mirrored-istio-galley,1.5.9,2020/08/07,405,1084,142,0,0,1631
grafana/tns-lint,6daf0b2,2020/06/29,4,15,37,5,0,61
kong/ubi-kuma-cni,2.4.4,2023/11/06,29,29,8,0,0,66
airbyte/source-postmarkapp,0.1.0,2022/11/09,0,17,25,1,0,43
rancher/mirrored-openpolicyagent-gatekeeper,v3.13.0,2023/08/08,0,3,3,0,0,6
balenalib/artik530-ubuntu-node,20220715,2022/08/02,88,82,12,0,0,182
balenalib/fincm3-alpine-openjdk,8-20230530,2023/06/26,8,18,7,2,0,35
appdynamics/ad-nite-java-services,2019-03-13-1552511460,2019/03/13,114,123,123,40,0,400
kong/httpbin,0.1.0,2022/06/23,214,544,54,3,0,815
balenalib/artik5-ubuntu-golang,20220803,2022/08/03,245,463,67,0,0,775
rancher/mirrored-cilium-hubble-ui,v0.12.1,2023/10/11,2,6,7,5,0,20
rancher/build-master,v0.20.0,2016/06/23,582,863,84,1,0,1530
amazon/lambda-build-node10.x,20190802,2019/08/13,75,573,542,62,1,1253
bitnami/configmap-reload,0.12.0,2023/11/08,74,13,6,2,0,95
jetbrains/upsource-cluster-init,2020.1.1992,2022/03/11,79,148,241,95,0,563
intel/xfastertransformer,1.0.0,2023/11/07,76,74,0,0,0,150
balenalib/am571x-evm-debian-node,18.6-20220714,2022/07/21,124,71,73,18,0,286
balenalib/qemux86-64-debian-python,20231106,2023/11/06,114,22,27,4,0,167
rancher/mongodb-config,v0.1.1,2017/02/27,null
grafana/mimir-build-image,5335_d9796228c4f26ab68a87f048f39245de,2023/06/26,494,209,191,18,0,912
balenalib/via-vab820-quad-golang,20220714,2022/07/28,473,260,213,28,1,975
datadog/fake-datadog,20220621,2022/06/15,1,14,22,1,0,38
okteto/installer,75436354,2023/09/21,0,20,11,0,0,31
bitnami/pinniped,0.27.0,2023/11/09,0,2,4,0,0,6
astronomerinc/ap-alertmanager,0.26.0,2023/08/24,0,4,2,0,0,6
airbyte/source-auth0,0.5.1,2023/10/20,64,22,6,1,0,93
circleci/cci-demo-docker-primary,0.0.2,2017/03/15,153,470,416,136,53,1228
docker/aci-hostnames-sidecar,1.0,2020/10/28,null
rapidfort/redis,7.2.1,2023/10/17,28,5,1,0,0,34
balenalib/armv5e-golang,20200213,2020/02/19,679,535,490,63,9,1776
bitnami/kafka,3.6.0,2023/11/14,84,15,13,6,0,118
hashicorp/spark-nomad,2.1.1,2017/06/06,102,290,333,175,30,930
balenalib/fincm3-alpine-python,20230530,2023/06/21,2,13,6,2,0,23
rapidfort/etcd,3.5.9,2023/10/11,32,12,9,0,0,53
bitnami/vault-k8s,1.3.1,2023/11/09,84,15,13,4,0,116
mattermost/mattermost-cloud-e2e,9839667,2022/12/09,0,10,8,0,0,18
bitnami/gitlab-runner,16.5.0,2023/11/08,109,20,28,5,0,162
balenalib/kitra710-node,20230904,2023/09/09,118,39,39,6,0,202
jetbrains/upsource-frontend,2020.1.1992,2022/03/11,79,148,241,95,0,563
balenalib/odroid-c1-debian-openjdk,20210602,2021/06/05,230,233,143,39,8,653
airbyte/source-amazon-sqs,0.1.0,2021/10/26,0,21,50,8,0,79
cockroachdb/builder-arm64v8,20180403-041732,2018/04/03,445,767,44,0,0,1256
balenalib/aarch64,20231106,2023/11/07,107,21,21,4,0,153
balenalib/intel-nuc-fedora,20231103,2023/11/04,null
balenalib/stem-x86-32-python,20230904,2023/09/09,118,38,38,6,0,200
rancher/mirrored-cilium-cilium-etcd-operator,v2.0.7,2019/09/18,null
puppet/puppet-inventory,0.4.0,2018/05/09,113,148,12,0,0,273
balena/yocto-build-env,9980750,2022/08/11,90,296,14,0,0,400
docker/buildx-bin,0.12.0-rc2,2023/11/14,0,2,4,0,0,6
balenalib/artik710-alpine-node,20230811,2023/08/22,2,1,6,2,0,11
percona/everest-catalog,0.4,2023/10/20,1,6,9,0,0,16
rapidfort/memcached-official,1-bullseye,2023/06/14,20,5,3,0,0,28
airbyte/java-datadog-tracer-base,3.2,2022/10/07,15,97,188,13,1,314
rancher/mirrored-epinio-epinio-server,v1.10.0,2023/09/25,0,9,3,0,0,12
redislabs/vault-ca,1.8,2017/12/26,146,158,15,0,0,319
airbyte/destination-sftp-json,0.1.0,2021/11/24,82,61,58,24,1,226
ddosify/ddosify-docker-extension,0.2.3,2023/03/23,0,12,10,0,0,22
amazon/aws-sam-cli-emulation-image-ruby2.5,20220125,2022/01/25,6,120,90,16,1,233
balenalib/via-vab820-quad-alpine-golang,20220714,2022/07/27,8,39,38,12,0,97
balenalib/odroid-xu4,20230911,2023/09/11,118,37,38,6,0,199
solace/solace-pubsub-connector-jms,1.0.0,2023/10/16,71,39,3,1,0,114
objectscale/nginx,3.9.0.0-1588.729cf194,2023/04/25,4,34,22,0,0,60
hashicorp/tfc-agent,1.14,2023/11/09,26,24,1,0,0,51
astronomerinc/ap-keda,2.3.0,2021/06/30,0,4,12,0,4,20
balenalib/bananapi-m1-plus-ubuntu-node,20231026,2023/11/02,38,9,1,0,0,48
redislabs/redis-connect-mysql,0.5.0-13,2022/01/22,4,28,36,13,0,81
balenalib/kitra520-debian-golang,20220714,2022/07/22,473,263,219,28,1,984
objectscale/object-control,0.71.3,2021/04/15,17,149,212,36,6,420
rancher/prometheus-auth,v0.3.0,2022/12/14,0,9,9,0,2,20
balenalib/apalis-imx6q-python,20220604,2022/06/12,124,82,74,20,0,300
kong/kong-operator,v0.9.0,2021/10/13,123,322,50,2,0,497
balenalib/i386-debian-node,16.19.1-20231106,2023/11/06,107,23,22,4,0,156
intel/intelligent_traffic_management_rule_engine_dev,2.0,2022/12/06,61,84,12,0,0,157
objectscale/mock-notifier,v2.74.0,2021/05/25,2,16,16,0,0,34
airbyte/source-acceptance-test,0.5.0,2023/01/30,0,17,26,1,0,44
airbyte/source-mailersend,0.1.0,2022/11/13,0,17,25,1,0,43
balenalib/bananapi-m1-plus-alpine-golang,20231106,2023/11/07,0,2,2,0,0,4
balenalib/bananapi-m1-plus-alpine-openjdk,8-20231106,2023/11/07,0,2,2,0,0,4
rancher/node-exporter,v0.17.0,2018/11/30,null
okteto/remote,0.4.2,2021/04/28,0,1,3,0,0,4
snyk/kubernetes-operator-bundle,1.100.2,2023/01/03,null
newrelic/k8s-nri-memcached,2.1.0,2019/11/25,null
google/apigee-emulator,1.9.1,2023/04/11,8,42,35,6,4,95
newrelic/k8s-nri-f5,2.1.0,2019/11/25,null
mirantis/ucp-node-exporter,3.7.1,2023/09/26,2,2,6,2,0,12
rancher/pushprox-client,v0.1.0-rancher2-client,2021/06/03,0,7,28,4,0,39
amazon/amazon-ecs-agent,78294847,2020/02/18,null
objectscale/postgres-operator,ubi8-5.2.0-114.c95664e-226,2023/08/29,60,32,10,1,0,103
balenalib/i386-nlp-node,6.17.1-20190503,2021/04/19,53,49,83,12,5,202
redislabs/kuber,4.5.0-18.1,2017/04/29,598,1068,65,1,0,1732
cockroachdb/cockroach-k8s-request-cert,0.4,2018/10/10,null
balenalib/artik530-debian,20220714,2022/07/22,124,69,72,18,0,283
accurics/cli-kubescan-arm64,1.0.41,2022/09/14,0,28,28,1,0,57
balenalib/nitrogen6x-alpine-node,20220714,2022/07/19,7,38,34,10,0,89
balenalib/raspberry-pi2-debian-openjdk,20230911,2023/09/12,129,65,42,6,0,242
mirantis/ucp-etcd,3.7.1,2023/09/26,2,9,14,2,0,27
balenalib/parallella-node,20230904,2023/09/09,118,39,39,6,0,202
balenalib/spacely-tx2,20231106,2023/11/07,114,21,27,4,0,166
rancher/brand-guidelines,2017-05-09,2017/05/10,71,115,156,56,12,410
docker/vpnkit-forwarder,76371f3a7a14e1f0412c719eea60990ff5938cf7,2019/09/06,null
newrelic/newrelic-k8s-metrics-adapter,0.8.0,2023/11/13,0,2,3,0,0,5
mongodb/apix_test,mongot-noauth,2023/08/22,142,49,13,0,0,204
okteto/crond,0.0.2,2020/10/10,2,10,32,4,0,48
kasmweb/gimp,1.14.0,2023/09/14,213,383,0,0,0,596
google/apigee-redis,1.8.1,2022/05/23,0,0,0,0,4,4
balenalib/artik5,20220714,2022/07/22,124,69,72,18,0,283
airbyte/source-appsflyer,0.1.0,2022/11/29,0,17,25,1,0,43
airbyte/source-shopify-singer,0.2.3,2021/06/09,569,336,293,39,7,1244
rancher/fluent-bit-out-syslog,0.1.0,2020/07/30,83,57,12,0,0,152
circleci/config-setup,0.869,2023/11/07,170,192,5,0,0,367
redislabs/redis,7.2.4-72,2023/10/03,null
dynatrace/dynatrace-operator,0.14.2,0001/01/01,null
redislabs/olmtest,100.0.6-1439.0,2023/11/15,null
balenalib/artik533s-alpine-node,20220803,2022/08/04,7,38,34,10,0,89
bitnami/mongodb-exporter,0.39.0,2023/10/11,74,15,7,2,0,98
grafana/prometheus-pulsar-remote-write-build-image,73484513,2020/08/06,138,251,299,33,10,731
rancher/hardened-cilium-runtime,v1.9.6-build20210526,2021/05/26,444,384,21,3,0,852
intel/rpbs_pipeline_builder_micro_frontend,1.0,2023/08/21,0,2,3,0,0,5
balenalib/raspberrypi3-ubuntu-node,20231026,2023/11/02,38,9,1,0,0,48
airbyte/source-vantage,0.1.0,2022/11/13,0,17,25,1,0,43
grafana/tns-app,842bd3b,2021/10/31,2,14,13,0,0,29
vmware/likewise-open-toolchain-photon,1.0.0,2018/04/10,21,213,227,87,0,548
airbyte/source-k6-cloud,0.1.0,2022/11/09,0,17,25,1,0,43
rancher/kim,v0.1.0-beta.7,2021/10/17,4,18,15,0,0,37
ambassador/telepresence-docker-extension,1.0.19,2023/11/14,0,18,39,0,0,57
intel/oneapi-aikit,2023.2.0-devel-ubuntu22.04,2023/08/09,187,183,42,1,0,413
google/apigee-cassandra-client,1.0.0-beta2,2019/04/06,103,78,35,8,0,224
rancher/rke2-upgrade,v1.28.3-rke2r2-s390x,2023/11/08,0,4,5,0,0,9
atlassian/bitbucket-server,8.15.1,2023/11/14,60,71,11,1,0,143
airbyte/source-kustomer,0.1.2,2021/12/24,0,21,51,8,0,80
bitnami/centos-base-buildpack,7-r9,2022/09/07,886,1017,56,0,0,1959
circleci/server-nomad,0.9-8443593,2019/08/16,312,1443,1027,138,12,2932
balenalib/raspberrypi3-debian-python,20230530,2023/06/27,118,38,38,6,0,200
circleci/server-keysets,v1.0-34-8c6e430,2020/09/14,75,67,2,0,0,144
astronomerinc/ap-certgenerator,0.1.6,2023/10/03,0,2,3,0,0,5
balenalib/revpi-core-3-debian-golang,20230530,2023/06/27,385,58,46,8,0,497
vmware/vs-ui,v0.0.1,2017/12/06,71,75,130,42,12,330
balenalib/asus-tinker-board-s-ubuntu-golang,20231026,2023/11/02,133,131,0,0,0,264
airbyte/source-mssql-strict-encrypt,3.0.0,2023/11/07,6,24,15,3,0,48
airbyte/source-surveycto,0.1.2,2023/07/27,77,37,31,3,0,148
hashicorp/vault-service-broker,0.2.0,2017/07/25,null
onlyoffice/4testing-ds-docservice,6.0.0,2020/10/21,555,569,32,3,0,1159
cimg/rlang,4.2.0,2022/06/13,455,1137,64,0,0,1656
docker/ucp-istio-pilot,3.3.1,2020/06/26,471,1162,150,1,0,1784
mirantis/ucp-metallb-controller,3.7.1,2023/09/26,0,4,3,0,0,7
rancher/mirrored-longhornio-longhorn-ui,v1.5.1,2023/07/19,5,17,12,0,7,41
okteto/calculate,golang,2020/10/01,708,513,489,63,9,1782
balenalib/parallella-openjdk,20230904,2023/09/09,129,65,42,6,0,242
rancher/mirrored-calico-operator,v1.31.1,2023/09/01,0,2,1,0,0,3
balenalib/asus-tinker-board-debian-golang,20230904,2023/09/09,448,109,72,9,0,638
kasmweb/ubuntu-jammy-dind,1.14.0,2023/09/14,270,412,33,0,0,715
airbyte/dst-sf-perf,18,2023/03/22,25,96,124,21,1,267
airbyte/source-cockroachdb,0.1.22,2023/03/22,30,129,203,15,1,378
cimg/aws,2023.09.1,2023/09/26,294,337,51,0,0,682
rancher/klipper-helm,v0.4.3,2021/01/08,12,36,68,15,0,131
hashicorp/consul-dataplane,1.3,2023/11/06,11,7,2,0,0,20
vmware/volume-metadata-syncer,v1.0.0,2019/08/16,14,55,70,30,0,169
kasmweb/almalinux-8-desktop,1.14.0,2023/09/14,0,21,842,0,0,863
onlyoffice/4testing-docspace-people-server,2.0.0.33,2023/11/15,993,142,206,12,0,1353
balena/armv7hf-supervisor-base,v1.4.7,2019/05/28,null
redislabs/rcp-deployer,94370089edddb8d42e02662046f94cdb,2021/10/03,209,507,60,1,0,777
airbyte/src-e2e-parallel-perf,partial-serde-1,2023/05/27,30,127,200,15,1,373
balenalib/amd64-ubuntu-golang,20230929,2023/10/07,146,135,13,0,0,294
balenalib/aarch64-ubuntu-openjdk,11-xenial-20231103,2023/11/06,null
airbyte/kpy-test,1,2021/05/20,143,96,110,34,7,390
balenalib/hummingboard-ubuntu-node,20230904,2023/09/09,43,10,5,0,0,58
balenalib/beaglebone-black-openjdk,20230911,2023/09/12,129,65,42,6,0,242
docker/devenv-vm-service,v0.2.5,2023/06/02,0,15,7,3,0,25
onlyoffice/docspace-healthchecks,1.1.4.1,2023/10/23,993,144,210,12,0,1359
mirantis/ucp-secureoverlay-mgr,3.7.1,2023/09/26,2,2,6,2,0,12
onlyoffice/4testing-documentserver-ie,99.99.99.2412,2021/04/23,467,1858,88,0,0,2413
balenalib/artik10-ubuntu-openjdk,20210826,2021/09/21,136,435,10,0,0,581
rancher/opni-metrics-service,v0.7.0,2022/11/23,3,43,30,0,10,86
rancher/grafana-grafana,7.2.1,2020/10/08,4,28,66,9,0,107
objectscale/objectscale-capacity,1.4.0-397.adb0726,2023/11/13,0,3,2,0,0,5
balenalib/beaglebone-green-alpine-golang,20231106,2023/11/07,0,2,2,0,0,4
pachyderm/haberdashery,2.8.0-rc.2,2023/11/13,90,26,25,2,1,144
jetbrains/qodana-jvm,2023.2,2023/09/06,141,56,68,13,0,278
atlassian/stash,3.11,2016/08/22,107,307,352,167,34,967
bitnami/kong-ingress-controller,3.0.0,2023/11/14,74,13,6,2,0,95
balenalib/asus-tinker-board-s-ubuntu,20231026,2023/11/02,37,8,0,0,0,45
docker/ucp-kube-dns-s390x,3.1.0-beta3,2018/10/04,0,0,0,2,0,2
bitnami/azure-cli,2.54.0,2023/11/14,77,16,8,2,0,103
purestorage/node-config,v0.1.0,2020/12/15,2,10,32,4,0,48
bitnami/pytorch,2.1.0,2023/10/26,77,16,7,2,0,102
bitnami/sealed-secrets-kubeseal,v0.24.3,2023/11/02,null
airbyte/source-s3,4.2.1,2023/11/14,128,39,11,2,0,180
graphcore/ipu-operator-controller,1.2.0,2023/05/30,0,3,2,0,0,5
rancher/swarmkit,v1.13-1,2017/01/25,2,49,28,26,0,105
balenalib/parallella-fedora-openjdk,30-20210825,2021/09/03,null
intel/intel-gpu-resource-driver,v0.2.0,2023/09/29,0,4,4,0,0,8
docker/desktop-kubernetes-coredns,v1.10.1,2023/02/06,0,3,3,0,0,6
intel/intel-optimized-cassandra,jdk14,2023/02/13,218,395,12,0,0,625
bitnami/apache-exporter,1.0.3,2023/11/08,72,12,6,2,0,92
airbyte/destination-kinesis,0.1.5,2022/09/22,76,73,57,19,0,225
amazon/amazon-ecs-local-container-endpoints,1.3.0,2020/07/16,24,309,240,34,1,608
appdynamics/appdynamics-cloud-log-collector-agent,23.10.0-759,2023/10/24,0,9,6,0,0,15
rancher/istio-proxy_init,1.3.3,2019/10/11,363,521,36,0,0,920
airbyte/source-slack-singer,0.2.3,2021/06/09,570,338,292,39,7,1246
graphcore/tools,3.2.0,2023/03/14,42,18,0,0,0,60
objectscale/ons,0.71.3,2021/04/15,16,142,194,36,3,391
balenalib/i386-nlp-debian-python,20210225,2021/04/18,195,122,139,43,9,508
docker/ucp-interlock-proxy-s390x,3.1.0-beta3,2018/10/04,2,23,10,5,0,40
balenalib/odroid-c1-openjdk,20210602,2021/06/05,230,233,143,39,8,653
balenalib/parallella-golang,20230904,2023/09/09,448,109,72,9,0,638
circleci/node,17.2.0,2021/12/18,846,1026,788,101,3,2764
airbyte/destination-timeplus,0.1.0,2023/06/14,0,15,25,1,0,41
appdynamics/appdynamics-cloud-operator,23.10.0-1114,2023/10/16,0,2,2,0,0,4
balenalib/bananapi-m1-plus-node,20230904,2023/09/09,118,39,39,6,0,202
rapidfort/elasticsearch-official,8.6.2,2023/05/23,5,21,16,0,0,42
portainer/portainer,1.25.0,2022/05/09,5,19,21,0,0,45
vmware/photon-controller-seed,1.0.3,2017/01/12,10,84,108,57,0,259
rapidfort/apache,2.4.57,2023/10/12,47,12,4,1,0,64
balenalib/revpi-core-3-ubuntu-node,20231026,2023/11/02,38,9,1,0,0,48
airbyte/source-trustpilot,0.1.0,2023/03/16,0,14,17,0,0,31
rancher/pipeline-jenkins-boot,v1.0.0,2018/01/11,15,170,199,107,0,491
onlyoffice/4testing-docspace-files-services,2.0.0.33,2023/11/15,993,142,206,12,0,1353
pachyderm/market_sentiment,dev0.25,2022/05/04,223,488,74,9,0,794
intel/pmem-csi-driver,v1.1.0,2022/12/19,92,35,44,3,3,177
nginxinc/nginmesh_proxy_init,0.7.1,2018/07/11,53,24,57,13,9,156
rancher/harvester-webhook,v1.2.1,2023/10/26,0,1,4,0,0,5
cockroachdb/cockroach-misc,v23.1.0-alpha.7,2023/03/15,68,48,5,0,0,121
rancher/mirrored-gmsa-webhook-k8s-gmsa-webhook,v0.7.0,2023/08/22,0,1,1,0,0,2
balenalib/artik530-fedora,20220714,2022/07/23,null
rapidfort/mongodb-official,6.0.4-focal,2023/07/26,26,40,10,0,0,76
amazon/aws-lambda-ruby,3.2.2023.11.03.14,2023/11/03,0,2,2,1,0,5
amazon/opendistro-for-elasticsearch-data-prepper,1.0.3,2021/12/20,22,132,221,28,1,404
redislabs/operator-internal,100.0.8-2088,2023/11/14,60,37,17,0,0,114
objectscale/csi-baremetal-operator,0.69.0,2021/03/07,121,226,47,3,0,397
netdata/netdata-debug,v1.43.2,2023/10/30,0,4,0,0,0,4
cimg/ruby,3.2.2,2023/08/30,378,476,49,0,0,903
vmware/cascade-event-toolchain-photon,1.0.7,2018/09/18,61,273,276,115,0,725
grafana/grizzly,0.2.1,2023/02/17,0,19,7,0,0,26
kasmweb/core-debian-bookworm,1.14.0,2023/09/09,379,140,109,18,0,646
balenalib/raspberry-pi2-debian-golang,20230911,2023/09/12,385,58,46,8,0,497
solaceiotteam/apim-portal,0.0.10,2021/09/06,199,262,313,42,8,824
ubuntu/mlflow,2.1.1_1.0-22.04,2023/10/02,27,17,3,6,0,53
google/apigee-cassandra,1.0.0-beta2,2019/05/08,101,181,189,48,6,525
onlyoffice/appserver,1.0.485b,2021/01/28,352,2009,1179,243,0,3783
portainer/portainer-docker-extension,2.19.2,2023/11/12,0,16,12,0,0,28
circleci/slanger,0.4,2022/02/23,50,77,101,12,3,243
hashicorp/nomad-autoscaler,0.3.7,2022/06/10,0,15,13,1,0,29
google/apigee-istio-kubectl,1.4.6,2020/02/22,650,1296,137,0,0,2083
newrelic/k8s-nri-kafka,2.9.2,2020/02/05,47,35,52,5,0,139
syncfusion/boldbi,6.16.12,2023/11/03,215,106,98,11,0,430
atlassian/pipelines-agent,1.80,2016/11/29,73,206,228,114,27,648
balena/i386-supervisor-base,v1.4.7,2019/05/28,null
bitnami/phpbb,3.3.11,2023/10/22,152,86,63,6,0,307
balenalib/amd64-ubuntu-openjdk,11-xenial-20230929,2023/10/07,null
intel/intel-sgx-admissionwebhook,0.28.0,2023/09/22,null
rancher/kubernetes-external-dns,v0.7.3,2020/08/05,4,21,46,4,0,75
rancher/mirrored-longhornio-backing-image-manager,v1.5.1,2023/07/19,4,18,21,0,7,50
rancher/os-preload,v0.7.1,2016/11/11,null
rancher/jenkins-plugins-docker,17.12,2018/02/21,0,8,3,3,0,14
pachyderm/issuesummarization,7927321a08ce4e62a42aa13f057b711c,2018/04/25,516,1492,1030,254,52,3344
docker/ucp-cfssl-s390x,3.1.0-beta3,2018/10/04,0,2,6,16,0,24
balenalib/generic-armv7ahf-ubuntu-golang,20230904,2023/09/09,141,146,23,0,0,310
airbyte/source-intruder,0.1.0,2022/11/14,0,17,25,1,0,43
pachyderm/cert-manager-acmesolver,v0.15.1,2020/05/27,0,0,0,0,6,6
datadog/agent-buildimages-system-probe_x64,v22885174-c6364642,2023/11/06,942,447,376,8,0,1773
vmware/postgresql,9.6.5-photon,2017/11/21,11,78,131,50,0,270
newrelic/cluster-api-controller-arm64,mv1a,2019/04/17,0,0,0,0,6,6
objectscale/objmt,0.71.3,2021/04/15,17,149,212,36,6,420
grafana/ebpf-autoinstrument,0.0.3,2023/07/21,22,11,4,0,0,37
rancher/gitwatcher,v0.4.5,2020/01/03,4,14,12,2,0,32
docker/kube-compose-e2e-tests,v0.5.0,2022/02/14,0,7,14,1,0,22
intel/evi-test-tool,master-ae213cd97d6931b1d44fc7689867cf5701e0f15d,2023/09/23,59,17,5,1,0,82
balenalib/nitrogen6x-ubuntu-python,20220622,2022/06/23,87,112,13,0,0,212
onlyoffice/docspace-files-services,1.1.4.1,2023/10/23,993,143,209,12,0,1357
balenalib/jetson-tx2-debian-golang,20231106,2023/11/07,442,81,51,5,0,579
rancher/mirrored-grafana-grafana,9.1.5,2022/09/13,0,20,24,0,0,44
balenalib/nitrogen6x-ubuntu,20220714,2022/08/02,87,81,11,0,0,179
balenalib/up-board-ubuntu-golang,20230911,2023/09/12,147,146,23,0,0,316
objectscale/deos-fio,3.14,2020/06/15,10,32,65,6,0,113
docker/app,test.pr420,2018/11/21,0,0,0,2,0,2
vmware/vs-event-manager,v0.0.1,2017/12/05,15,81,98,70,0,264
snyk/kubernetes-operator,2.4.17,2023/11/07,68,55,10,0,0,133
objectscale/objs-pre-upgrade-crds,1.4.0-2770,2023/11/15,0,0,1,0,0,1
percona/everest-operator,0.4,2023/10/31,0,1,1,0,0,2
rancher/os-statescript,v0.7.1,2016/11/11,null
circleci/sshd,0.1,2023/01/16,0,0,0,1,0,1
rancher/mesos-master,0.28.1,2016/05/24,235,326,17,0,0,578
balenalib/stem-x86-32-openjdk,20230904,2023/09/09,129,65,42,6,0,242
intel/deep-learning,2023.2-py3.10,2023/09/20,166,173,24,1,0,364
redislabs/redisstatemachine,edge,2023/05/17,73,26,17,2,0,118
balenalib/i386-golang,20231106,2023/11/06,441,80,51,5,0,577
grafana/tempo,2.3.0,2023/10/30,0,3,3,0,0,6
rapidfort/zookeeper-official,3.8.3-jre-17,2023/10/31,null
bitnami/argo-cd,2.9.1,2023/11/14,117,19,29,3,0,168
airbyte/source-twilio,0.10.0,2023/07/27,151,84,60,10,0,305
puppet/puppetserver,7.9.2,2022/10/17,36,138,2,0,0,176
balenalib/imx6ul-var-dart-ubuntu-python,20231026,2023/11/02,37,9,0,0,0,46
airbyte/destination-clickhouse,0.2.5,2023/06/23,34,146,243,30,1,454
docker/doodle,summer2019,2019/06/19,null
bitnami/kubeapps-apis,2.9.0,2023/11/08,74,30,18,2,0,124
docker/hlb-backend,50b36877f5c4f4f9947837690a988f592450d1de,2018/10/23,1,0,14,11,0,26
google/apigee-hybrid-cassandra,1.8.1,2022/09/13,3,31,46,3,4,87
rancher/metrics-server-amd64,v0.3.1,2018/09/17,null
balenalib/qemux86-64-fedora,20231103,2023/11/04,null
rancher/mirrored-neuvector-scanner,latest-amd64,2023/11/09,1,4,1,0,0,6
okteto/movies-frontend,prod,2020/04/02,2,13,13,1,0,29
rancher/os-docker,19.03.15,2021/02/03,null
atlassian/jira-servicemanagement,5.11.3,2023/11/11,27,28,16,2,0,73
amazon/aws-lambda-python,3.12.2023.11.12.08,2023/11/12,0,2,0,0,0,2
opensearchproject/opensearch,2.11.0,2023/11/09,0,3,5,0,0,8
amazon/amazon-ec2-instance-selector,v2.0.3,2021/08/19,null
intel/intel-optimized-tensorflow-serving,2.8.0,2022/03/29,61,40,2,0,0,103
balenalib/rpi-debian-node,16.19.1-20231106,2023/11/07,107,37,30,4,0,178
rancher/harvester-bundle,v0.2.0,2021/04/30,114,189,11,0,0,314
rancher/mirrored-longhornio-longhorn-manager,v1.5.1,2023/07/19,4,21,29,0,7,61
snyk/snyk,swift,2023/11/14,0,1,1,0,0,2
airbyte/source-fastbill,0.2.0,2023/08/23,0,15,24,1,0,40
rancher/hardened-calico,v3.13.3,2020/09/25,468,530,104,4,0,1106
balenalib/via-vab820-quad-node,18.6-20220714,2022/07/21,124,71,73,18,0,286
balenalib/apalis-imx6q-debian-node,18.6-20220714,2022/07/21,124,71,73,18,0,286
docker/ecs-secrets-sidecar,1.0,2020/10/26,null
airbyte/source-freshsales,1.0.0,2023/11/13,0,13,24,1,0,38
balenalib/asus-tinker-board-fedora-node,36-build-20230911,2023/09/12,0,1,1,0,0,2
okteto/tfenv-ci,1.4,2022/04/28,9,46,60,17,0,132
newrelic/cluster-api-aws-controller,8325527a,1970/01/01,7,18,13,3,6,47
continuumio/repodb,main,2023/03/27,76,38,24,2,0,140
pachyderm/go-build,2.0.0-alpha.20,2021/06/01,691,432,396,62,9,1590
mattermost/rtcd,v0.12.0,2023/11/09,null
balenalib/qemux86-64-python,20231106,2023/11/06,114,22,27,4,0,167
bitnami/postgrest,11.2.2,2023/11/02,79,14,9,2,0,104
balenalib/artik710-node,20230904,2023/09/09,118,39,39,6,0,202
bitnami/harbor-notary-server,2.8.4,2023/09/15,83,178,227,2,0,490
balenalib/bananapi-m1-plus-debian-node,20230904,2023/09/09,118,39,39,6,0,202
balenalib/up-board-alpine-python,20231106,2023/11/07,0,3,2,0,0,5
grafana/cortex-tools,v0.11.0,2023/09/08,0,3,3,0,0,6
grafana/mt-gateway,v1.1,2021/01/14,4,14,9,3,0,30
onlyoffice/docspace-socket,1.1.4.1,2023/10/23,982,157,217,18,0,1374
kasmweb/debian-bookworm-desktop,1.14.0,2023/09/14,624,294,240,52,2,1212
airbyte/source-zoom,0.1.1,2022/12/02,0,17,25,1,0,43
onlyoffice/gdrive-auth,1.0.0-rc15,2023/09/18,0,6,5,0,0,11
bitnami/redmine,5.1.0,2023/11/06,275,179,101,4,0,559
rancher/mirrored-coreos-etcd,v3.5.9,2023/05/11,0,9,9,0,0,18
bitnami/magento,2.4.6,2023/10/11,149,236,176,25,0,586
intel/intel-optimized-wordpress,src,2023/03/10,71,24,19,2,0,116
airbyte/destination-bigquery,2.3.15,2023/11/14,7,36,57,18,0,118
balenalib/artik530-alpine-python,20220803,2022/08/04,7,38,35,10,0,90
bitnami/moodle,4.3.0,2023/11/03,163,87,50,4,0,304
mattermost/platform,9.1.1,2023/11/01,108,19,12,1,0,140
airbyte/destination-selectdb,0.1.0,2023/04/05,30,130,202,15,1,378
balenalib/armv7hf-fedora,20221109,2022/12/03,null
onlyoffice/oform-config,1.0.3,2022/01/13,0,19,19,11,0,49
balenalib/aarch64-debian-openjdk,20231106,2023/11/07,118,44,23,4,0,189
astronomerinc/ap-awsesproxy,1.5.0-3,2023/11/09,0,3,0,0,0,3
rancher/helm-controller,v0.15.4,2023/08/16,0,4,3,0,0,7
grafana/cortex-cortex,v1.1.0-grafana-2,2020/06/08,2,15,18,0,0,35
airbyte/source-zoho-crm,0.1.2,2023/03/19,77,34,25,2,0,138
nginxinc/ingress-demo,latest-unprivileged,2021/01/10,165,164,163,47,7,546
balenalib/ts4900-alpine-node,20220714,2022/07/19,7,38,34,10,0,89
formio/formio-upload,1.0.0,2018/11/03,1,11,12,7,0,31
airbyte/metrics-reporter,0.50.34,2023/11/09,12,50,58,4,1,125
sysdig/orchestrator-agent,3.0.1-dev-ossl-debug,2022/08/19,78,96,24,0,0,198
vmware/pmd-toolchain-photon2,1.0.0,2018/07/22,45,322,376,140,0,883
balenalib/colibri-imx6dl-fedora-openjdk,30-20210825,2021/09/03,null
ubuntu/alertmanager,0.25.0-22.04,2023/10/05,22,12,4,0,0,38
redislabs/redisinsight,1.14.0,2023/05/02,80,64,44,5,0,193
rancher/system-upgrade-controller,v0.13.1,2023/08/28,0,2,1,0,0,3
grafana/cortex-test-exporter,v1.1.0-grafana-2,2020/06/08,0,6,9,0,0,15
pingidentity/pingone-ldap-gateway,3.0.1,2023/11/01,10,26,24,6,0,66
balenalib/artik10-fedora-python,20220714,2022/07/23,0,1,1,0,0,2
mirantis/ucp-hrm,2.2.22,2019/10/07,4,11,20,1,0,36
rancher/vm-fedora,27-1.6.x86_64,2018/04/11,null
balenalib/bananapi-m1-plus-fedora,20221210,2022/12/12,null
vmware/vs-image-manager,v0.0.1,2017/11/28,15,81,98,70,0,264
hashicorp/waypoint,0.11.4,2023/08/09,1,46,32,1,0,80
onlyoffice/4testing-appserver-webhooks-wervice,test-2022062807,2022/06/28,372,841,49,0,0,1262
amazon/aws-alb-ingress-controller,v2.4.5,2022/11/09,0,3,7,1,1,12
balenalib/artik5-fedora-node,36-build-20220803,2022/08/04,0,1,1,0,0,2
airbyte/airbyte-e2e-testing-tool,0.4.3,2022/09/30,76,72,59,17,0,224
onlyoffice/4testing-documentserver,99.99.99.2737,2021/12/03,438,1346,68,0,0,1852
couchbase/ubuntu-1404-sdk-build,20180806,2018/08/08,309,385,40,8,0,742
pingidentity/pingauthorize,2310,2023/11/01,3,14,8,0,0,25
vmware/kafka-slo-exporter,v1.1.0,2023/05/29,0,2,1,0,0,3
rancher/mirrored-longhornio-longhorn-share-manager,v1.5.1,2023/07/19,6,22,19,0,7,54
circleci/postgres-upgrade,9.4-to-9.5,2017/10/26,59,172,150,64,27,472
astronomerinc/ap-elasticsearch-exporter,1.6.0,2023/06/30,0,2,1,0,0,3
balenalib/amd64-python,20231106,2023/11/06,107,22,21,4,0,154
intel/intel-fpga-admissionwebhook,0.28.0,2023/09/22,null
bitnami/tensorflow-resnet,2.14.0,2023/11/06,324,27,13,4,0,368
portainer/open-amt-cloud-toolkit-postgres,v2.1.0,2022/02/03,116,64,64,26,0,270
rancher/harvester-seeder,v0.1.0,2023/08/29,4,5,11,0,5,25
rancher/longhornio-backing-image-manager,v3_20220808-s390x,2022/08/08,7,65,49,3,11,135
okteto/result,1,2020/02/19,35,39,65,13,7,159
kasmweb/blender,1.14.0,2023/09/14,187,387,2,0,0,576
balenalib/spacely-tx2-python,20231106,2023/11/07,114,22,27,4,0,167
objectscale/csi-baremetal-node-kernel-5.4,0.69.0,2021/03/07,121,249,32,0,0,402
newrelic/c-daemon,1.3.0,2020/01/08,2,10,9,1,0,22
balenalib/stem-x86-32-alpine,20230530,2023/06/29,2,6,6,2,0,16
onlyoffice/docspace-files,1.1.4.1,2023/10/23,993,143,209,12,0,1357
bitnami/supabase-postgres,15.1.0,2023/11/07,102,30,15,4,0,151
ngrok/kubernetes-ingress-controller,0.10.1,2023/10/20,0,1,1,0,0,2
intel/oneapi-basekit,2023.2.1-devel-ubuntu22.04,2023/07/31,183,173,34,0,0,390
balenalib/beaglebone-black-python,20230911,2023/09/12,118,38,38,6,0,200
graphcore/poplar,3.3.0,2023/07/03,131,186,24,0,0,341
kasmweb/libre-office,1.14.0,2023/09/14,195,382,0,0,0,577
intel/fm-worker,evi-2.0.0,2022/10/31,32,17,0,0,0,49
docker/dtr-nginx-s390x,2.5.0-beta3,2018/01/17,0,16,41,34,0,91
bitnami/parse-dashboard,5.2.0,2023/10/24,87,30,14,6,0,137
airbyte/destination-qdrant-preview,dev,2023/08/31,64,25,9,4,0,102
kong/immunity,4.2.0,2021/08/03,608,364,334,43,14,1363
dynatrace/easytravel-loadgen,7.1,2018/05/11,196,244,194,46,14,694
datadog/dd-trace-ci,vegeta,1970/01/01,94,45,58,17,6,220
balenalib/orangepi-plus2-fedora-node,36-build-20230911,2023/09/11,0,1,1,0,0,2
circleci/java,8,2017/05/22,110,316,349,194,30,999
amazon/aws-glue-libs,glue_libs_4.0.0_image_01,2023/07/12,65,293,408,102,0,868
grafana/grafana-oss-image-tags,10.3.0-146415-ubuntu-arm64,2023/11/15,24,8,0,0,0,32
vmware/lightwave-base-photon2,1.0.1,2018/08/24,37,136,237,67,0,477
grafana/usage-stats-handler,v9,2023/11/08,0,11,43,11,0,65
vmware/vs-openfaas-nodejs6-base,0.0.3-dev1,2017/12/12,15,111,151,85,0,362
adobecoldfusion/coldfusion2018,2018.0.18,2023/07/20,59,101,145,61,0,366
rancher/os-fedoraconsole,v1.5.8,2021/02/05,null
rancher/pipeline-jenkins-slave,v1.0.0,2018/01/11,278,496,32,2,0,808
balenalib/am571x-evm-fedora-python,20220622,2022/07/12,0,1,1,0,0,2
airbyte/source-mixpanel,2.0.0,2023/11/03,64,22,6,1,0,93
hashicorp/consul-terraform-sync,0.7.1,2023/10/30,0,2,2,0,0,4
cockroachdb/cdc-sink,pr-470,2023/09/12,0,2,2,0,0,4
balenalib/up-board-debian-node,20230712,2023/07/16,0,1,1,0,0,2
balenalib/kitra710-ubuntu-node,20230904,2023/09/09,43,10,5,0,0,58
atlassian/dcapt,7.6.0,2023/10/11,678,82,150,3,0,913
airbyte/source-commcare,0.1.0,2023/01/05,77,39,34,3,0,153
airbyte/source-square,1.6.1,2023/11/07,0,13,24,1,0,38
balenalib/zynq-xz702-alpine-openjdk,8-3.14-20220112,2022/01/19,2,50,42,13,0,107
graphcore/tensorflow-jupyter,2,2023/03/31,381,803,59,1,0,1244
balenalib/artik10-python,20220714,2022/07/22,124,70,74,18,0,286
rancher/migration-tools,v0.1.3,2020/01/31,38,27,0,0,0,65
intel/esp-gitea,v3.1.2,2023/07/25,0,5,11,0,0,16
rancher/terraform-operator-appliance,v0.0.5,2019/03/26,null
amazon/aws-efs-csi-driver,6954596,2023/03/01,6,25,12,2,1,46
airbyte/source-tvmaze-schedule,0.1.0,2022/10/27,0,17,25,1,0,43
mattermost/mattermost-build-webapp,v5.2.0,2018/08/07,412,1147,807,214,50,2630
balenalib/imx6ul-var-dart-debian-openjdk,20230911,2023/09/12,129,65,42,6,0,242
grafana/drone-vault,master-011e819,2023/04/14,0,15,15,0,0,30
docker/compose-tests,1.25.2-rc1,2020/01/17,144,362,372,68,10,956
hashicorp/consul-terraform-sync-enterprise,0.7.1-ent,2023/10/31,0,2,2,0,0,4
airbyte/cloud-airbyte-api-server,dev-97763408ca,2023/11/02,14,57,64,4,1,140
grafana/grafana-image-tags,10.3.0-146415-ubuntu-arm64,2023/11/15,24,8,0,0,0,32
mirantis/dtr-garant,3.0.0-alpha.2,2021/09/22,2,25,39,4,0,70
bitnami/dex,2.37.0,2023/11/08,84,18,15,4,0,121
airbyte/source-pendo,0.1.0,2023/03/30,0,16,25,1,0,42
intel/python,py310-full,2023/07/25,33,17,6,0,0,56
airbyte/source-wikipedia-pageviews,0.1.0,2022/11/03,0,17,25,1,0,43
rapidfort/envoy-official,v1.22.11,2023/04/12,null
kasmweb/workspaces,1.14.0,2023/09/18,53,51,27,1,0,132
balenalib/orangepi-plus2-alpine-openjdk,8-20231106,2023/11/07,0,2,2,0,0,4
datadog/operator-bundle,0.7.1,2021/10/22,null
intel/ai-structuring,evi-2.0.0,2022/10/31,32,17,0,0,0,49
hashicorp/consul-template,0.35,2023/11/08,0,2,2,0,0,4
snyk/snyk-container-demo,sha-654f899,2023/03/19,407,1129,788,200,50,2574
kong/ubi-kuma-init,2.4.4,2023/11/06,29,29,8,0,0,66
rancher/longhornio-csi-resizer,v1.2.0,2021/05/05,0,5,9,0,4,18
balenalib/i386-nlp-ubuntu-golang,20200213,2020/02/19,507,699,59,0,0,1265
airbyte/destination-amazon-sqs,0.1.0,2021/12/09,0,21,50,8,0,79
docker/tilt-golang-cross,1.19.3,2022/11/03,618,281,237,30,0,1166
pingidentity/pingauthorizepap,2310,2023/11/01,3,6,5,2,0,16
mattermost/kube-spot-termination-notice-handler,v1.23.4,2023/02/10,821,624,377,28,0,1850
docker/engine-community-dm,18.09.9,2019/09/04,null
balenalib/parallella-fedora-python,20221109,2022/11/16,0,1,0,0,0,1
vertica/verticasdk,ubuntu-v23.4.0,2023/11/06,155,160,3,0,0,318
balenalib/parallella-fedora-golang,20221210,2022/12/13,null
rancher/goharbor-harbor-portal,v1.7.5,2019/04/01,14,67,85,37,0,203
objectscale/fluxd,0.54.0,2020/11/06,2,54,65,6,2,129
newrelic/nri-kubernetes,3.20.0,2023/11/13,0,2,2,0,0,4
bitnami/vault,1.15.2,2023/11/09,84,16,13,4,0,117
google/apigee-diagnostics-runner,1.8.1,2022/09/20,0,0,0,0,4,4
datadog/dogstatsd,7.50.0-rc.2,2023/11/14,0,2,2,0,0,4
okteto/hello-job,golang,2020/08/14,97,41,51,16,6,211
jetbrains/upsource,2020.1.2006,2022/10/28,153,274,557,217,0,1201
bitnami/wordpress-nginx,6.4.1,2023/11/13,148,81,48,4,0,281
portainer/authenticator,develop,2023/06/29,null
balenalib/odroid-c1-golang,20220714,2022/07/28,473,260,213,28,1,975
cockroachdb/sql_efficiency_check,main,2022/06/22,0,1,4,0,0,5
objectscale/pravega,0.71.3,2021/03/30,221,264,260,76,8,829
rancher/mirrored-bats-bats,v1.4.1,2022/04/30,0,12,14,1,0,27
newrelic/kps,0.10.3,2019/09/02,4,14,9,1,0,28
airbyte/destination-heap-analytics,0.1.0,2023/01/04,0,16,25,1,0,42
balenalib/spacely-tx2-alpine-python,20231106,2023/11/06,0,3,2,0,0,5
objectscale/objectscale-gateway,0.71.3,2021/04/14,6,65,63,3,6,143
grafana/integration-grafana-publisher,v10,2023/09/13,7,27,23,7,0,64
rancher/clusterscan-operator,v0.0.1,2020/08/25,2,10,32,4,0,48
okteto/okteto,78462652,2023/03/28,1,31,17,0,0,49
rancher/nginx-ingress-controller-amd64,0.16.2-rancher1,2018/07/18,83,137,218,69,6,513
ubuntu/prometheus-alertmanager,0.23-22.04_edge,2023/02/13,33,29,18,0,0,80
datadog/cluster-agent-dev-amd64,7-27-0-snmp-batch-size-config,2021/04/09,8,26,20,2,0,56
airbyte/source-pypi,0.1.0,2022/11/07,0,17,25,1,0,43
rancher/prom-alertmanager,v0.21.0,2020/06/17,0,12,26,0,0,38
jetbrains/qodana-jvm-android,2023.2,2023/09/06,142,63,82,13,0,300
kasmweb/vs-code,1.14.0,2023/09/14,190,380,0,0,0,570
objectscale/livenessprobe,v2.6.0,2022/02/01,0,4,7,0,0,11
astronomerinc/ap-airflow-operator,0.0.1,2019/02/21,null
balenalib/am571x-evm-debian-golang,20220714,2022/07/28,473,260,213,28,1,975
objectscale/geoservice,0.71.3,2021/04/15,17,149,212,36,6,420
docker/ucp-interlock,3.3.1,2020/06/26,5,22,21,1,0,49
bitnami/dreamfactory-archived,4.12.0,2022/12/21,173,213,118,17,0,521
intel/proxyv2,1.19.0-intel.0,2023/09/27,29,12,6,0,0,47
vmware/notary-photon,signer-0.5.1,2017/11/21,8,60,81,49,0,198
objectscale/storageserver,0.71.3,2021/04/15,11,102,116,9,4,242
intel/pccs,v2.4,2023/10/15,22,8,0,0,0,30
rancher/os-bootstrap,3929481,2017/02/03,null
balenalib/aarch64-fedora-openjdk,8-20231106,2023/11/06,null
bitnami/spring-cloud-dataflow-composed-task-runner,2.11.1,2023/10/13,74,13,10,4,0,101
astronomerinc/ap-prometheus,2.45.1,2023/09/29,0,10,7,0,0,17
mathworks/matlab-deps,R2023b-ubuntu22.04,2023/11/13,44,29,0,0,0,73
rapidfort/python-chromedriver,7c9a7149476b73f54b17a674c2de4836bd252b70,2023/11/12,1481,1334,889,90,37,3831
airbyte/api-server,dev-5842ec8,2022/11/03,16,105,201,13,1,336
datadog/operator,1.3.0-rc.1,2023/11/13,17,13,2,0,0,32
vmware/audit-trail-toolchain,0.2.1,2018/09/26,16,163,183,93,0,455
rancher/opni-insights-service,v0.3.1,2022/03/07,8,86,76,4,14,188
astronomerinc/ap-houston-api,4650,2023/05/15,2,19,4,4,0,29
mirantis/ucp-dsinfo,3.7.1,2023/09/26,32,31,11,0,0,74
cimg/postgres,16.1,2023/11/10,290,319,44,0,0,653
vmware/photon-syslog,8.15.0,2017/10/23,10,81,101,57,0,249
grafana/tempo-vulture,2.3.0,2023/10/30,0,2,2,0,0,4
rancher/aks-operator,v1.2.1-rc1,2023/11/02,0,1,1,0,0,2
adobecoldfusion/pmt2018,2018.0.5,2022/12/02,60,88,61,27,0,236
balenalib/spacely-tx2-alpine,20231106,2023/11/06,0,2,2,0,0,4
airbyte/source-activecampaign,0.1.0,2022/10/27,0,17,25,1,0,43
rancher/goharbor-harbor-jobservice,v1.7.5,2019/04/01,14,63,88,37,0,202
appdynamics/nodejs-agent,23.10.0-20-slim,2023/11/06,55,5,1,1,0,62
bitnami/logstash,8.11.1,2023/11/13,76,40,17,6,0,139
circleci/build-image,ultra-minimal-01,2016/08/16,1535,2016,94,12,0,3657
bitnami/kibana,8.10.4,2023/10/17,96,21,17,6,0,140
datadog/agent-buildimages-windows_2004_x64,v3686353-1e75137,2021/01/12,8,49,134,12,0,203
balenalib/orangepi-plus2-fedora,20221210,2022/12/12,null
balenalib/generic-aarch64-ubuntu-python,20231103,2023/11/06,37,9,0,0,0,46
docker/dev-environments-java,639923ad2c5ce6f29a24ca8d11c8f38f9206c462,2021/06/21,534,290,452,69,13,1358
balenalib/hummingboard-fedora,20221210,2022/12/12,null
hashicorp/vault-secrets-operator,0.3.4,2023/10/20,null
bitnami/wordpress,6.4.1,2023/11/13,148,81,48,4,0,281
objectscale/targetmgr,3.9.0.0-139102.b4b5064355c,2023/05/03,2,14,9,0,0,25
solace/event-management-agent,1.3.1,2023/11/01,0,2,2,0,0,4
rancher/rio-cert-checker,v0.1.0,2019/05/21,6,20,9,2,0,37
grafana/consent-service,19789620,2020/02/06,2,16,38,4,0,60
mattermost/pgbouncer,v0.7.0,2023/11/10,0,3,0,0,0,3
docker/desktop-git-helper,706820a528d3553e3631118f8113adbce5c5f1db,2023/01/25,3,24,30,17,0,74
bitnami/chartmuseum,0.15.0,2023/05/21,75,68,34,5,0,182
appdynamics/secureapp-otel-java-extension,23.10.0-1153,2023/10/24,0,2,2,0,0,4
mattermost/cloud-blackbox-target-discovery,22696c7,2021/11/24,0,16,24,1,0,41
balenalib/raspberrypi3-ubuntu-openjdk,11-xenial-20231026,2023/11/02,null
airbyte/source-braintree-singer,0.2.3,2021/07/06,112,63,77,30,7,289
balenalib/odroid-xu4-ubuntu,20231026,2023/11/02,37,8,0,0,0,45
accurics/broker,9531878,2020/08/15,6,16,48,6,0,76
balenalib/beaglebone-green-wifi-ubuntu-node,20230911,2023/09/11,43,10,5,0,0,58
puppet/kerminator-build-image,474351,2018/11/09,4,30,50,15,0,99
intel/rpbs_gpu_telegraf,1.0,2022/11/29,39,33,3,0,0,75
intel/intelligent_traffic_management_dashboard_dev,2.0,2022/12/06,62,89,15,0,0,166
intel/evi-fm-worker,master-ae213cd97d6931b1d44fc7689867cf5701e0f15d,2023/09/23,55,9,3,1,0,68
rancher/hardened-flannel,v0.23.0-build20231109-s390x,2023/11/09,null
newrelic/nri-ecs,1.10.8,2023/10/19,8,30,16,2,0,56
rancher/opensearch,v0.11.0-rc1,2023/07/28,19,38,41,4,0,102
netdata/agent-sd,v0.2.9,2023/08/22,0,3,3,0,0,6
objectscale/object-service,0.71.3,2021/04/15,13,92,102,14,3,224
pachyderm/python-datum-batching-ci,937fe6fa62fc7108984071dce1a3639afe7064c4,2023/08/09,140,77,39,3,0,259
vmware/photon-2.0-flannel,v0.9.1-20180619,2018/06/19,17,84,105,59,0,265
mirantis/rethinkcli,v2.3.0,2016/11/28,55,174,168,65,22,484
bitnami/aspnet-core,7.0.14,2023/11/14,428,76,43,3,0,550
onlyoffice/4testing-documentserver-ee,99.99.99.3631,2023/11/12,123,89,1,1,0,214
sysdig/agent-slim,12.17.1,2023/10/24,84,53,16,0,0,153
grafana/har-to-k6,0.14.5,2023/10/13,55,7,2,2,0,66
balenalib/nitrogen6x-alpine-golang,20220714,2022/07/27,8,39,38,12,0,97
rancher/pause,3.6,2021/08/25,null
onlyoffice/4testing-docspace-studio,2.0.0.33,2023/11/15,993,142,206,12,0,1353
astronomerinc/ap-nginx-es,3.13.5-4,2021/09/05,2,20,45,6,0,73
percona/proxysql2,2.5.5,2023/11/03,86,48,4,0,0,138
balenalib/kitra520-debian-openjdk,20220714,2022/07/22,157,128,83,18,0,386
adobecoldfusion/coldfusion2023,2023.0.5,2023/10/06,30,28,53,23,0,134
balenalib/odroid-c1-fedora-node,36-build-20220714,2022/07/22,0,1,1,0,0,2
portainer/template-swarm-monitoring,prometheus-v2.44.0,2023/05/24,0,10,7,0,0,17
rancher/mirrored-nginx-ingress-controller-defaultbackend,1.5-rancher1,2018/09/28,null
kumahq/kubectl,v1.20.15,2022/04/22,0,12,8,1,0,21
onlyoffice/communityserver,12.5.2.1848,2023/05/25,249,547,86,1,0,883
okteto/non-root,golang,2020/11/05,700,488,480,63,9,1740
mirantis/ucp-metrics,3.7.1,2023/09/26,2,5,7,2,0,16
intel/oneapi-hpckit,2023.2.1-devel-ubuntu22.04,2023/07/31,183,173,34,0,0,390
hashicorp/tfci,v1.1.1,2023/11/08,0,2,2,0,0,4
percona/proxysql,1.4.16,2020/02/05,38,33,25,5,2,103
vmware/cascade-toolchain,1.11.5-1,2019/02/05,18,176,232,105,0,531
balenalib/stem-x86-32-debian-node,16.19.1-20230904,2023/09/09,118,39,39,6,0,202
airbyte/source-launchdarkly,0.1.0,2022/11/10,0,17,25,1,0,43
rancher/mirrored-neuvector-prometheus-exporter,5.2.3,2023/11/14,0,2,2,0,0,4
airbyte/source-rki-covid,0.1.2,2022/12/05,0,17,25,1,0,43
balena/balena-generate-ami-env,9980750,2022/11/04,61,243,13,0,0,317
grafana/jmeter-to-k6,1.0.0,2020/05/22,9,36,47,8,0,100
vmware/govc,4561966a,2023/03/16,null
redislabs/redis-connect-cassandra,0.5.0-136,2022/01/22,1,31,32,7,0,71
rancher/mirrored-pstauffer-curl,v1.0.3,2018/07/11,0,0,6,18,0,24
onlyoffice/docs-converter-de,7.5.1-1,2023/11/09,null
cockroachdb/postgres-test,20190103-1358,2019/01/03,190,499,418,149,35,1291
objectscale/srs-notifier,2.0.51,2020/09/29,2,17,44,4,0,67
balenalib/aarch64-fedora-node,20231106,2023/11/06,0,1,1,0,0,2
bitnami/pgpool,4.4.4,2023/10/09,88,17,12,2,0,119
rancher/k8s-dns-kube-dns,1.15.10,2020/03/05,16,17,19,8,1,61
puppet/puppet-dev-tools,0.7,2020/02/25,646,537,510,59,10,1762
docker/mobywebsite,staging,2018/01/03,71,75,130,41,12,329
ddosify/golangtestapp,1.21.3-alpine3.18,2023/10/17,0,2,2,0,0,4
mirantis/dtr-notary-server,3.0.0-alpha.2,2021/09/22,0,6,26,3,0,35
airbyte/source-statuspage,0.1.0,2022/11/11,0,17,25,1,0,43
hashicorp/sentinel,0.23.1,2023/10/19,0,5,4,0,0,9
balenalib/armv7hf-fedora-openjdk,8-20221109,2022/12/05,null
bitnami/fluxcd-helm-controller,0.36.2,2023/11/08,74,16,8,2,0,100
rancher/istio-installer,0.1.7,2020/08/18,17,41,68,8,0,134
balenalib/jetson-tx2-fedora-golang,20231106,2023/11/06,null
redislabs/k8s-controller-internal,100.0.8-2088,2023/11/14,61,19,0,0,0,80
intel/its-query-web,master-ae213cd97d6931b1d44fc7689867cf5701e0f15d,2023/09/23,68,17,4,1,0,90
rancher/mirrored-k8s-dns-node-cache,1.22.20,2023/02/22,23,20,8,0,0,51
mirantis/dtr-nginx,3.0.0-alpha.2,2021/09/22,3,28,45,5,0,81
airbyte/source-smaily,0.1.0,2022/11/09,0,17,25,1,0,43
astronomerinc/ap-kubed,0.13.2,2022/03/25,0,5,10,1,0,16
onlyoffice/4testing-docspace-studio-notify,2.0.0.33,2023/11/15,993,142,206,12,0,1353
objectscale/object-heads,0.71.3,2021/04/15,13,95,140,24,3,275
bitnami/reportserverenterprise-archived,4.2.0-6068,2022/08/02,97,77,76,17,0,267
greenbone/report-formats,community,2023/11/15,null
balenalib/asus-tinker-board-s-fedora,20221210,2022/12/12,null
okteto/cloudbin,1.10.11,2022/04/05,6,46,57,4,0,113
airbyte/destination-oracle,0.2.0,2023/06/29,34,145,243,30,1,453
pachyderm/cert-manager-cainjector,v0.15.1,2020/05/27,0,0,0,0,6,6
pingidentity/pingaccess,2310,2023/11/01,5,16,8,2,0,31
google/shaka-packager,v2.5.1,2021/06/22,null
balenalib/i386-python,20231106,2023/11/06,107,22,21,4,0,154
google/deepconsensus,1.2.0,2023/03/01,127,90,120,16,0,353
bitnami/minideb,stretch,2022/06/16,31,4,23,2,0,60
circleci/nomad-drainer,1.0.227-4ac789f,2019/12/13,2,10,9,1,0,22
balenalib/qemux86-64-node,20231106,2023/11/06,114,23,28,4,0,169
mirantis/k8s-netchecker-server,v1.2.2,2018/01/02,0,23,10,4,0,37
sysdig/agent,12.17.1,2023/10/24,168,71,16,0,0,255
rancher/longhornio-csi-snapshotter,v3.0.3,2020/12/15,0,6,12,0,5,23
airbyte/source-clockify,0.3.0,2023/08/31,0,15,24,1,0,40
okteto/backend,80907703,2023/02/02,0,12,7,0,0,19
rapidfort/nats-ib,v2.9.21,2023/09/08,0,0,1,0,0,1
balenalib/via-vab820-quad-debian,20220714,2022/07/20,124,69,72,18,0,283
amazon/aws-sam-cli-emulation-image-python3.9,20220125,2022/01/25,5,31,20,10,1,67
rancher/mirrored-flannel-flannel-cni-plugin,v1.2.0,2023/07/21,null
puppet/puppetdb,7.10.0,2022/04/04,83,226,2,0,0,311
rapidfort/slim-init,v1.0,2023/11/02,0,2,2,0,0,4
grafana/rollout-operator-boringcrypto,v0.9.0,2023/11/14,0,2,2,0,0,4
rancher/system-agent,v0.3.4,2023/10/30,1,18,15,1,0,35
balenalib/artik710-golang,20230904,2023/09/09,448,112,72,9,0,641
accurics/siac-bot,1.3.14,2021/06/04,2,15,43,4,0,64
astronomerinc/ap-vector,0.32.2-1,2023/11/06,0,3,0,0,0,3
pachyderm/opencv,2.6.0,2023/04/26,191,367,33,0,0,591
bitnami/reportserver,4.6.1-6098,2023/10/09,75,19,12,2,0,108
bitnami/kubeapps-chart-repo-archived,1.10.0,2020/04/01,null
rancher/os-ubuntuconsole,v1.5.8,2021/02/05,211,443,16,0,0,670
pachyderm/example-no-skip,12,2021/03/29,1452,1332,949,147,37,3917
dynatrace/easytravel-mongodb-content-creator,2.0.0.3599,2023/08/04,145,82,37,2,0,266
jetbrains/datalore-external,2023.5.1,1970/01/01,141,308,62,7,0,518
balenalib/colibri-imx6dl-alpine-golang,20220714,2022/07/27,8,39,38,12,0,97
jetbrains/code-with-me-lobby,1867,2023/01/23,140,61,47,5,3,256
couchbase/elasticsearch-connector,4.4.6,2023/05/17,82,73,10,0,0,165
balena/i386-supervisor,1299,2020/07/31,6,26,55,9,0,96
airbyte/source-rd-station-marketing,0.1.2,2023/07/07,0,15,25,1,0,41
docker/desktop-kine,v1.1,2020/04/15,3,18,39,4,0,64
onlyoffice/docspace-bin-share,1.1.4.1,2023/10/23,0,2,6,0,0,8
balenalib/hummingboard-golang,20230904,2023/09/09,448,109,72,9,0,638
bitnami/alertmanager,0.26.0,2023/11/08,74,17,8,2,0,101
intel/afxdp-plugins-for-kubernetes,23.02,2023/03/15,1,17,7,0,0,25
rancher/mirrored-cilium-startup-script,62bfbe88c17778aad7bef9fa57ff9e2d4a9ba0d8,2020/08/26,1,5,13,2,0,21
bitnami/configurable-http-proxy,4.6.0,2023/10/24,77,16,7,2,0,102
graphcore/popart,3.3.0,2023/07/03,143,187,24,0,0,354
newrelic/k8s-webhook-cert-manager,1.4.0,2021/04/14,0,7,30,5,0,42
grafana/cortex-querier,WIP-diskcache-220510df,2018/08/31,0,0,0,2,0,2
rancher/kubectld,v1.0.0,2017/09/21,354,434,24,0,0,812
intel/evi-ai-structuring,master-ae213cd97d6931b1d44fc7689867cf5701e0f15d,2023/09/23,55,9,3,1,0,68
objectscale/atlas,1.1.3,2021/02/23,2,12,17,0,0,31
rancher/harvester-network-helper,v0.3.5,2023/08/29,1,6,8,0,1,16
objectscale/config-upload,1.2.6,2021/03/05,15,58,78,11,0,162
kumahq/merbridge,0.8.5,2022/11/02,216,464,83,0,0,763
airbyte/source-opsgenie,0.3.0,2023/11/09,0,13,24,1,0,38
rapidfort/postgresql12-ib,12.16,2023/10/20,101,44,2,0,0,147
jetbrains/teamcity-server,2023.05.4,2023/09/19,62,82,41,5,0,190
percona/pmm-server,2.40.1,2023/10/20,0,44,36,0,0,80
rancher/kiwigrid-k8s-sidecar,1.1.0,2020/10/13,2,24,48,12,0,86
intel/dlstreamer-pipeline-server-k8s-controller,2022.2.0,2022/10/22,77,41,38,3,0,159
rancher/rio-controller,v0.8.0,2020/10/12,2,8,4,0,0,14
airbyte/source-recurly,0.4.1,2022/08/11,0,18,25,1,0,44
adobecoldfusion/apimanager2018,2018.0.1,2021/12/17,109,246,99,40,0,494
rancher/containerd,v1.3.6-k3s2,2020/08/27,257,403,18,3,0,681
circleci/postgres-script-enhance,0.1,2021/12/07,47,17,46,8,3,121
jetbrains/hub,2023.2.20300,2023/11/02,76,50,36,10,0,172
onlyoffice/4testing-docspace-router,2.0.0.33,2023/11/15,102,139,2,0,0,243
rancher/rke2-runtime,v1.28.3-rke2r2-windows-amd64,2023/11/08,0,27,28,0,0,55
rapidfort/fluentd-official,v1.14.0-1.0,2023/06/16,1,2,0,0,0,3
bellsoft/alpaquita-linux-python,3.11-stream-musl,2023/11/14,null
bitnami/bitnami-shell,11,2023/07/15,86,28,23,6,0,143
rancher/network-diagnostics,v0.1.2,2017/07/19,310,388,24,0,0,722
bellsoft/buildpacks.executable-jar,6.6.1,1980/01/01,null
airbyte/source-merge,0.1.0,2023/05/01,0,16,25,1,0,42
couchbase/centos-70-sdk-build,20180808,2018/08/08,1756,2775,361,8,1,4901
okteto/dotnetcore,6,2023/08/24,105,42,63,9,0,219
vertica/verticapy-jupyterlab,v0.1.5,2023/08/04,1131,401,281,28,2,1843
okteto/vote,1.3,2019/02/24,5,22,22,4,0,53
rapidfort/apache2-ib,2.4.53,2023/11/08,22,40,0,0,0,62
airbyte/source-stripe-abprotocol-singer,0.1.3,2020/10/20,147,114,161,35,7,464
amazon/aws-sam-cli-emulation-image-ruby2.7,20220125,2022/01/25,5,29,21,11,1,67
rancher/mirrored-epinio-epinio-unpacker,v1.10.0,2023/09/25,0,1,2,0,1,4
balenalib/zynq-xz702-debian-node,18.6-20220714,2022/07/21,124,71,73,18,0,286
docker/ucp-proxy,1.1.6,2017/01/18,0,42,21,8,0,71
airbyte/source-braintree,0.2.1,2023/11/08,64,8,2,1,0,75
hashicorp/jsii-terraform,0.19.1,2023/11/13,768,245,221,18,0,1252
bitnami/rails,7.1.2,2023/11/11,188,71,47,5,0,311
airbyte/cloud-temporal-migrator,0.39.27-alpha-2865c30,2022/06/29,79,84,59,18,0,240
balenalib/orbitty-tx2-fedora,20231106,2023/11/06,null
okteto/init-syncthing,0.4.1,2019/01/27,null
mirantis/ucp-kube-compose-api,3.5.3,2019/11/07,4,14,9,1,0,28
grafana/drone-downstream,linux-amd64,2023/10/04,0,4,4,0,0,8
astronomerinc/ap-orbit-ui,0.11.0,2020/01/19,12,105,97,32,0,246
objectscale/install-controller,2.0.52,2020/10/14,14,38,53,6,0,111
docker/disk-usage-extension,0.2.8,2023/08/31,null
syncfusion/word-processor-server,23.1.36,2023/09/15,73,21,19,4,0,117
pachyderm/kubeflow-worker,v13,2018/03/28,0,0,1,0,0,1
appdynamics/zfi-sample-app,demo,2018/11/14,735,707,84,3,0,1529
balenalib/up-board-fedora-golang,20231103,2023/11/04,null
balenalib/artik710-fedora-golang,20230530,2023/06/07,null
rancher/ansible-runner,v0.0.1,2016/07/29,1377,2206,236,7,0,3826
airbyte/source-dynamodb,0.1.2,2023/02/23,30,127,201,15,1,374
amazon/aws-fsx-csi-driver,v0.9.0,2022/11/25,19,112,187,10,1,329
rancher/longhorn-manager,5948788,2018/08/09,207,432,15,0,0,654
rancher/mirrored-longhornio-csi-provisioner,v3.4.1,2023/04/05,0,3,3,0,0,6
vmware/lightwave-proxy-toolchain,2.0.0,2018/02/21,18,213,270,117,0,618
objectscale/ecs-flex-graphql-debug,0.54.0,2020/11/10,4,18,20,1,0,43
balenalib/odroid-xu4-alpine-golang,20231106,2023/11/07,0,2,2,0,0,4
balenalib/via-vab820-quad-debian-python,20220604,2022/06/12,124,82,74,20,0,300
balena/armv7hf-supervisor,1299,2020/07/31,6,26,55,9,0,96
vmware/wavefront-adapter-for-istio,0.1.5,2020/09/02,14,49,60,25,0,148
balenalib/odroid-c1-debian-golang,20220714,2022/07/28,473,260,213,28,1,975
couchbase/cloud-native-gateway,0.1.0,2023/08/05,0,3,3,0,0,6
greenbone/openvas-scanner,22.7.6,2023/10/11,109,42,29,4,0,184
balenalib/artik710-alpine-python,20230803,2023/08/04,2,7,5,2,0,16
rapidfort/airflow-scheduler,2.7.1,2023/10/25,38,18,5,1,0,62
balenalib/raspberrypi3-alpine-openjdk,8-20231106,2023/11/07,0,2,2,0,0,4
cimg/rust,1.73.0,2023/10/05,294,325,48,0,0,667
amazon/aws-xray-daemon,3.3.9,2023/10/31,7,40,26,5,1,79
bitnami/supabase-postgres-meta,0.74.3,2023/11/15,77,17,7,2,0,103
grafana/cortex-ingester,w37-0193e7b7,2018/09/11,0,0,0,2,0,2
hashicorp/consul-telemetry-collector,0.0.2,2023/09/19,0,5,6,0,0,11
cimg/cimg-orb,2023.09.1,2023/09/28,294,337,51,0,0,682
mathworks/matlab-runtime-deps,R2023b-ubuntu22.04,2023/11/13,45,55,0,0,0,100
airbyte/source-outbrain-amplify,0.1.2,2023/08/18,0,13,16,0,0,29
balenalib/asus-tinker-board-node,20230904,2023/09/09,118,39,39,6,0,202
airbyte/python-connector-base,1.2.0,2023/10/30,128,39,11,1,0,179
balenalib/parallella-fedora,20221210,2022/12/12,null
cimg/mysql,8.0.33,2023/08/14,294,325,48,0,0,667
datadog/datadog-agent-runner-circle,1.11.5,2019/02/05,201,480,527,98,15,1321
rapidfort/prometheus-ib,v2.44.0,2023/09/03,0,5,4,0,0,9
bitnami/apisix-dashboard,3.0.1,2023/11/13,74,17,8,2,0,101
ubuntu/telegraf,1.21-22.04_edge,2022/04/18,48,49,5,0,0,102
airbyte/source-gitlab,2.0.0,2023/10/26,64,22,6,1,0,93
okteto/github-runner,2.273.0,2020/09/10,190,148,247,47,9,641
airbyte/source-monday,1.1.3,2023/10/04,0,14,24,1,0,39
kasmweb/ubuntu-bionic-dind-rootless,develop-rolling,2022/03/18,272,879,25,0,0,1176
rancher/mirrored-coreos-prometheus-config-reloader,v0.40.0,2020/06/18,0,1,0,0,0,1
adobecoldfusion/fortuna,beta,2023/03/07,59,63,86,49,0,257
vmware/clair-db,9.6.3,2017/07/19,11,93,139,51,0,294
balenalib/qemux86-64-ubuntu,20230911,2023/09/11,42,9,4,0,0,55
balenalib/beaglebone-green-fedora-golang,20220523,2022/06/05,null
newrelic/tfd-kps,1.0.0,2019/07/19,4,14,9,3,0,30
rancher/mirrored-istio-kubectl,1.5.9,2020/08/07,405,1076,128,0,0,1609
onlyoffice/4testing-docspace-urlshortener,test-2022112110,2022/11/21,999,301,329,26,0,1655
rancher/mirrored-cilium-operator-generic,v1.14.4,2023/11/13,null
bitnami/pgbouncer,1.21.0,2023/11/06,95,20,8,2,0,125
sysdig/kube-psp-advisor,1.8.0,2020/05/20,2,10,27,4,0,43
mirantis/ucp-swarm,3.7.1,2023/09/26,3,3,6,2,0,14
docker/ssd,bump_18.09,2019/01/28,192,424,433,74,12,1135
bitnami/harbor-clair-archived,2.5.1,2022/06/10,139,117,69,19,0,344
onlyoffice/4testing-appserver-clear-events,test-2022081607,2022/08/16,1014,332,356,24,1,1727
balenalib/asus-tinker-board-openjdk,20230904,2023/09/09,129,65,42,6,0,242
bitnami/fluxcd-image-automation-controller,0.36.1,2023/10/16,74,14,7,2,0,97
ubuntu/cortex,1.11-22.04_edge,2023/01/16,45,60,30,0,0,135
balenalib/artik530-fedora-golang,20220714,2022/07/23,null
rancher/coreos-etcd,v3.2.24,2018/07/24,0,2,2,2,0,6
docker/buildkit-syft-scanner,1.2,2023/04/18,0,5,3,0,0,8
airbyte/source-exchangeratesapi-singer,0.2.2,2021/04/03,112,63,77,30,7,289
kasmweb/core-cuda-focal,1.14.0,2023/09/09,256,516,15,0,0,787
objectscale/control-service,0.71.3,2021/04/15,17,149,212,36,6,420
rancher/mirrored-longhornio-support-bundle-kit,v0.0.27,2023/08/22,4,7,11,0,1,23
graphcore/pytorch-paperspace-early-access,3.3.0-EA.1-ubuntu-20.04-20230504,2023/05/04,264,460,36,0,0,760
mirantis/virtlet-build,v1-2759075286cbf6a20ac746a342b61c11,2018/05/24,547,832,57,0,0,1436
balenalib/odroid-c1-node,18.6-20220714,2022/07/21,124,71,73,18,0,286
airbyte/source-alpha-vantage,0.1.1,2023/01/05,0,16,25,1,0,42
balenalib/revpi-core-3-ubuntu-python,20231026,2023/11/02,37,9,0,0,0,46
objectscale/secondary-scheduler-operator,1.4.0-124.541af8d,2023/11/13,631,678,83,4,0,1396
google/deepvariant,1.6.0,2023/10/23,121,163,7,0,0,291
amazon/amazon-ec2-metadata-mock,v1.9.2,2021/08/26,0,1,2,0,0,3
sysdig/sysdig-inspect,0.7.3.20230622.151714-dev,2023/06/22,669,498,478,62,7,1714
okteto/vote-queue,0.1,2019/02/26,1,16,13,4,0,34
rancher/mirrored-calico-cni,v3.26.3,2023/10/06,0,11,6,0,0,17
balenalib/imx6ul-var-dart-fedora-node,36-build-20230530,2023/06/29,0,1,1,0,0,2
balenalib/i386-alpine-python,3.8.10-3.13-20210506,2021/06/15,6,42,57,15,0,120
rancher/mirrored-thanosio-thanos,v0.21.1,2021/06/04,0,8,11,0,0,19
puppet/ezbake,2.2.1,2020/08/21,1078,1677,132,4,0,2891
appdynamics/cluster-agent-operator,23.9.0-552,2023/09/20,0,4,3,0,0,7
tenable/cns-onprem-scanner,2.5.9,2022/12/06,8,108,142,14,0,272
airbyte/source-visma-economic,0.2.0,2023/10/20,0,13,24,1,0,38
hashicorp/dashboard-service,0.0.4,2019/01/24,0,0,0,2,0,2
bitnami/kubeapps-pinniped-proxy,2.9.0,2023/10/26,74,13,6,2,0,95
mirantis/ucp-metallb-speaker,3.7.1,2023/09/26,0,6,4,0,0,10
objectscale/k8s-kubectl,2.70.0,2020/05/21,2,10,27,4,0,43
circleci/mysql,8.0.28,2022/02/22,145,72,76,22,6,321
balenalib/zynq-xz702-ubuntu,20220714,2022/08/02,87,81,11,0,0,179
rancher/mirrored-epinio-epinio-ui,v1.10.0-0.0.1-s390x,2023/09/07,0,3,7,1,0,11
onlyoffice/dropbox-gateway,1.0.0-rc7,2023/09/04,0,6,6,0,0,12
balenalib/artik5-fedora-golang,20220714,2022/07/23,null
intel/nginx,v2.4,2023/10/15,32,14,0,0,0,46
balenalib/raspberry-pi2-golang,20230911,2023/09/12,385,58,46,8,0,497
rancher/vm-novnc,v0.2.0,2018/12/21,123,215,12,0,0,350
airbyte/source-n8n,0.1.0,2022/11/08,0,17,25,1,0,43
rancher/mirrored-istio-node-agent-k8s,1.5.9,2020/08/07,405,1084,143,0,0,1632
vmware/resource-checker-codebuild,1.0,2019/01/30,18,231,277,120,0,646
qualys/qiac_security_cli,2.1.1,2023/11/01,3,4,3,0,0,10
airbyte/source-mongodb-strict-encrypt,0.2.5,2023/07/27,30,120,199,15,1,365
rancher/vault-volume-driver,v0.0.6,2017/12/13,58,97,13,0,0,168
vmware/vs-function-manager,v0.0.1,2017/11/28,15,81,98,70,0,264
appdynamics/zfi-service,demo,2018/11/14,15,87,189,109,0,400
balenalib/beaglebone-green-wifi-ubuntu-openjdk,11-xenial-20230911,2023/09/11,null
rancher/goharbor-registry-photon,v2.6.2-v1.7.5,2019/04/01,14,63,88,37,0,202
grafana/loki-build-image,0.32.0,2023/11/06,554,158,159,15,0,886
appdynamics/customer-support-images,java-nonroot-65532,2022/04/26,2,30,29,1,0,62
vmware/vcsim,4561966a,2023/03/16,null
rancher/container-crontab,v0.5.0,2018/03/08,0,10,2,0,0,12
airbyte/keycloak,0.50.34,2023/11/09,15,36,7,0,0,58
kasmweb/ubuntu-bionic-desktop,1.10.0,2021/11/16,341,1184,26,0,0,1551
rancher/mirrored-cilium-clustermesh-apiserver,v1.14.4,2023/11/13,null
grafana/k6-httpbin,v0.8.4,2023/08/18,1,5,9,3,0,18
amazon/aws-sam-cli-emulation-image-dotnetcore2.1,20220125,2022/01/25,6,126,95,15,1,243
rancher/mirrored-sig-storage-csi-resizer,v1.9.2,2023/11/09,null
intel/esp-web,v3.1.2,2023/07/25,null
airbyte/integration-singer-csv-destination,0.1.1,2020/10/07,111,78,85,30,7,311
balenalib/colibri-imx6dl-golang,20220714,2022/07/28,473,260,213,28,1,975
balenalib/artik530-node,20220714,2022/07/20,124,71,73,18,0,286
balenalib/kitra710-ubuntu-openjdk,11-xenial-20230904,2023/09/09,null
balenalib/kitra710-ubuntu,20230904,2023/09/09,42,9,4,0,0,55
newrelic/nri-statsd,2.8.0,2023/09/12,0,4,3,0,0,7
balenalib/qemux86-64-debian-node,20231106,2023/11/06,114,23,28,4,0,169
kong/incubator,gateway-wasmtime-3.0.0.0,2022/09/23,138,294,39,0,0,471
cimg/elixir,1.15.4,2023/08/28,231,294,30,0,0,555
pachyderm/pachdclustermetrics,1.08,2021/07/08,1440,1266,866,88,37,3697
balenalib/asus-tinker-board-ubuntu-golang,20231026,2023/11/02,133,131,0,0,0,264
bitnami/kubeapps-dashboard,2.9.0,2023/10/26,84,15,13,4,0,116
redhat/ubi9-minimal,9.3-1361,2023/11/01,17,13,2,0,0,32
bitnami/postgresql,16.1.0,2023/11/13,96,20,9,2,0,127
mattermost/ponos,v0.0.3,2022/07/08,1,10,16,3,0,30
mattermost/mattermost-push-proxy-amd64,5.26.0,2023/11/01,0,2,2,0,0,4
airbyte/destination-doris,0.1.0,2022/11/14,29,131,210,15,1,386
balenalib/raspberrypi3-node,20230530,2023/07/02,118,39,39,6,0,202
airbyte/source-toggl,0.1.0,2022/11/10,0,17,25,1,0,43
bitnami/phabricator-archived,2021.26.0,2021/09/29,372,323,207,43,12,957
kasmweb/core-debian-bullseye,1.14.0,2023/09/09,866,239,271,25,0,1401
onlyoffice/elasticsearch,7.16.3,2022/07/05,211,428,36,0,0,675
rancher/hardened-cni-plugins,v1.2.0-build20231009-s390x,2023/10/10,2,2,6,0,2,12
intel/fm-master,evi-2.0.0,2022/10/31,32,17,0,0,0,49
docker/dtr-jobrunner,2.8.1,2020/06/17,7,73,99,18,1,198
balenalib/artik533s-fedora-python,20220714,2022/07/23,0,1,1,0,0,2
jetbrains/datalore-connection-checker,2022.1.4,1970/01/01,123,433,29,0,0,585
balenalib/generic-armv7ahf-ubuntu-openjdk,11-xenial-20230904,2023/09/09,null
rancher/harvester-vm-import-controller,v0.1.6,2023/08/29,4,8,14,0,1,27
datadog/extendeddaemonset-check,0.5.0-rc.1,2020/12/24,105,225,33,1,0,364
pachyderm/example-rabbitmq-spout,2.1.0-rc.1,2022/02/15,0,4,14,1,0,19
bitnami/dotnet-sdk,7.0.404,2023/11/14,434,84,49,6,0,573
graphcore/pytorch-geometric,3.3.0,2023/07/03,146,189,27,0,0,362
airbyte/source-fauna,0.1.1,2022/12/14,0,16,26,1,0,43
docker/artifactory-agent,v1.0.45,2023/10/02,0,6,5,0,0,11
balenalib/hummingboard-ubuntu-golang,20230904,2023/09/09,141,146,23,0,0,310
qualys/qagent-rhcos,4.2.1-5,2023/08/24,6,3,18,0,0,27
percona/percona-server-mysql-operator,0.6.0,2023/09/04,31,43,12,0,0,86
okteto/kubelet-reconfig,1.0.2,2023/08/03,0,8,2,3,0,13
astronomerinc/ap-git-sync-relay,0.0.2-1,2023/06/12,1,6,4,4,0,15
rancher/drone-exporter,v0.0.2-amd64,2020/05/06,2,14,36,4,0,56
balenalib/generic-armv7ahf,20230904,2023/09/09,118,37,38,6,0,199
appdynamics/ad-air-mock-services,java,2021/01/15,140,133,104,32,0,409
objectscale/event-service,0.71.3,2021/04/15,17,149,212,36,6,420
balenalib/artik530-debian-openjdk,20220714,2022/07/22,157,128,83,18,0,386
objectscale/prometheus,3.9.0.0-1588.729cf194,2023/04/25,5,43,32,0,0,80
rancher/fluentd-geoip,v0.7.0,2020/01/02,145,328,340,44,10,867
astronomerinc/ap-kube-replicator,0.10.0-rc.8,2019/08/16,null
objectscale/dthealth,0.52.0,2020/10/14,0,8,12,0,0,20
onlyoffice/4testing-docspace-login,2.0.0.33,2023/11/15,315,72,56,2,0,445
airbyte/source-fullstory,0.1.0,2023/05/01,0,16,25,1,0,42
vmware/vs-event-driver,v0.0.1,2017/11/28,15,81,98,70,0,264
grafana/wix-toolset-ci,v3,2019/04/11,236,794,759,199,19,2007
newrelic/synthetics-ping-runtime,1.33.0,2023/10/17,43,14,0,0,0,57
cimg/android,2023.11.1,2023/11/06,193,249,29,1,0,472
intel/evi-clustering-archiving,master-ae213cd97d6931b1d44fc7689867cf5701e0f15d,2023/09/23,83,73,92,28,0,276
astronomerinc/ap-default-backend,0.28.21,2023/11/08,0,2,0,0,0,2
balenalib/fincm3-ubuntu-openjdk,11-xenial-20230712,2023/07/18,null
okteto/helm-installer,1.0.12,2021/02/18,102,66,73,22,6,269
okteto/mail,0.3.3,2018/11/19,0,3,11,11,0,25
mirantis/ucp-multus-cni,3.7.1,2023/09/26,55,18,9,1,0,83
atlassian/pipelines-auth-proxy,stg,2020/08/11,2,20,7,5,0,34
intel/test-hello-world-2,1.0.1,2022/02/24,53,25,0,0,0,78
balenalib/raspberry-pi2-fedora-openjdk,8-20221031,2022/11/04,null
balenalib/hummingboard-debian-node,20230904,2023/09/09,118,39,39,6,0,202
vmware/secureclouds-remediation-worker,437-python3.8-alpine3.12,2023/01/12,70,229,176,29,0,504
okteto/tfh,0.1.0,2023/09/28,null
balenalib/via-vab820-quad-ubuntu-node,20220715,2022/07/19,88,103,12,0,0,203
dynatrace/dynatrace-aws-s3-log-forwarder,v0.4.5-x86_64,2023/09/12,6,26,12,4,0,48
onlyoffice/controlpanel,3.5.0.516,2023/04/17,113,151,13,0,0,277
pachyderm/pachyderm_tflite_ex,v1,2019/04/11,350,535,124,7,0,1016
bitnami/influxdb-relay-archived,0.20200717.0,2022/04/20,null
bitnami/zookeeper,3.9.1,2023/10/11,85,18,14,4,0,121
vmware/go-kcl-toolchain,0.1.4,2021/10/22,502,431,342,61,2,1338
mirantis/ucp-interlock,3.7.1,2023/09/26,2,3,7,2,0,14
onlyoffice/docspace-migration-runner,1.1.4.1,2023/10/23,73,41,98,3,0,215
balenalib/artik533s-fedora-node,36-build-20220803,2022/08/04,0,1,1,0,0,2
rapidfort/nginx,1.25.2,2023/10/17,39,7,1,1,0,48
grafana/loki-helm-test,canary-test-9084cc9-WIP,2022/10/04,0,10,8,0,0,18
balenalib/parallella-debian-openjdk,20230904,2023/09/09,129,65,42,6,0,242
balenalib/artik533s-debian-node,20220714,2022/07/20,124,71,73,18,0,286
google/apigee-watcher,1.8.1,2022/09/12,0,3,6,0,0,9
couchbase/mobile-testkit,fix_update-docker-repo-path,2017/06/22,1578,2365,399,16,1,4359
jetbrains/teamcity-agent,2023.05.4,2023/09/19,64,102,107,10,0,283
onlyoffice/docspace-backup-background,1.1.4.1,2023/10/23,993,143,209,12,0,1357
docker/dev-environments-go,639923ad2c5ce6f29a24ca8d11c8f38f9206c462,2021/06/21,991,561,663,78,12,2305
bitnami/harbor-exporter,2.9.1,2023/11/08,74,13,6,2,0,95
balenalib/generic-armv7ahf-debian,20230904,2023/09/09,118,37,38,6,0,199
cimg/node,21.1.0,2023/10/26,294,325,48,0,0,667
balenalib/colibri-imx6dl-fedora-python,20220622,2022/07/12,0,1,1,0,0,2
rancher/opni-drain-service,v0.12.1-rc1,2023/11/10,2,10,13,0,7,32
balenalib/artik533s-python,20220714,2022/07/22,124,70,74,18,0,286
bitnami/spring-cloud-dataflow,2.11.1,2023/11/07,74,14,11,4,0,103
rancher/sonobuoy-sonobuoy,v0.19.0,2020/09/15,34,16,45,6,7,108
cockroachdb/kitsune,main,2023/02/13,0,0,1,0,0,1
balenalib/orangepi-plus2-debian,20230911,2023/09/11,118,37,38,6,0,199
airbyte/source-google-workspace-admin-reports,0.1.8,2022/02/24,0,22,52,8,0,82
rancher/os-syslog,v1.5.8,2021/02/05,null
mirantis/ucp-kube-state-metrics,3.7.1,2023/05/31,0,2,1,0,0,3
rancher/jenkins-boot,v0.1.1,2017/12/20,15,170,199,107,0,491
grafana/grafana-docs-dev,arm,2021/05/19,656,1753,162,5,0,2576
okteto/slack-notifier,0.1.1,2019/01/23,11,33,53,9,0,106
intel/hsm-sds-server,1.19.0,2023/09/06,24,16,6,0,0,46
balenalib/amd64-fedora-openjdk,8-20231103,2023/11/04,null
airbyte/source-zenloop,0.1.10,2023/06/29,0,15,25,1,0,41
datadog/trace-paketo-buildpack,1.0.0,1980/01/01,null
airbyte/source-newsdata,0.1.0,2022/11/10,0,17,25,1,0,43
airbyte/source-harvest,0.1.20,2023/10/15,64,22,6,1,0,93
bitnami/grafana-tempo,2.3.0,2023/11/08,74,15,8,2,0,99
apachepinot/zookeeper,3.7.0,2023/02/14,840,364,405,31,0,1640
balenalib/nitrogen6x-node,18.6-20220714,2022/07/21,124,71,73,18,0,286
intel/crypto-reference-stack,1.0,2021/04/14,232,349,45,0,0,626
pachyderm/ide-hub,2.0.0-b4,2021/08/26,472,1132,79,1,0,1684
pachyderm/worker-amd64,97276071e371d5b1ea221437e99cfd87b5599ddf,2023/11/03,1,7,8,0,0,16
docker/ucp-metrics-s390x,3.1.0-beta3,2018/10/04,0,2,6,16,0,24
mattermost/podman,1.8.0,2020/03/10,231,168,241,47,9,696
couchbase/observability-stack,dp2,2022/06/10,17,123,156,13,0,309
okteto/php,8,2023/08/24,240,93,53,9,0,395
rancher/mirrored-minio-mc,RELEASE.2023-06-28T21-54-17Z-s390x,2023/06/29,76,57,10,0,0,143
balenalib/aarch64-ubuntu-node,20231103,2023/11/06,35,9,1,0,0,45
objectscale/supportassist-ese-notifier,2.71.3,2021/04/14,2,18,21,0,0,41
balenalib/generic-armv7ahf-alpine-openjdk,8-20230904,2023/09/09,8,10,6,2,0,26
grafana/drone-grafana-docker,0.3.2,2020/09/29,3,24,46,5,0,78
balenalib/amd64-debian-python,20231106,2023/11/06,107,22,21,4,0,154
jetbrains/datalore-introspection,2022.1.4,1970/01/01,123,433,29,0,0,585
mirantis/ucp-auth-store,3.7.1,2023/09/26,3,6,7,2,0,18
okteto/weaver-sidecar,0.1.10,2023/01/17,66,50,10,0,0,126
rancher/pushprox-proxy,v0.1.0-rancher2-proxy,2021/06/03,0,7,28,4,0,39
balenalib/raspberrypi3-openjdk,20230530,2023/07/04,143,73,44,6,0,266
balenalib/am571x-evm-ubuntu,20220714,2022/08/02,87,81,11,0,0,179
lacework/container-auto-scan-inline,1.1.2,2023/03/28,182,94,89,12,0,377
balenalib/zynq-xz702-alpine-node,20220714,2022/07/19,7,38,34,10,0,89
airbyte/mssql_ssltest,dev,2021/05/12,148,255,14,0,0,417
balenalib/apalis-imx6q-debian-golang,20220714,2022/07/28,473,260,213,28,1,975
vmware/vsan-prometheus-servicediscovery,v20210225,2021/02/26,14,100,109,45,0,268
bitnami/dataplatform-exporter-archived,1.0.1,2022/05/18,0,1,1,0,0,2
amazon/aws-sagemaker-kfp-components,20200402,2020/04/02,26,333,252,37,1,649
balenalib/artik5-openjdk,20220714,2022/07/22,157,128,83,18,0,386
grafana/cortex-query-tee,v1.1.0-grafana-2,2020/06/08,2,16,36,4,0,58
intel/istioctl,1.19.0-intel.0,2023/09/27,29,13,6,0,0,48
balenalib/rpi-alpine-golang,20231026,2023/11/01,0,2,2,0,0,4
rancher/hardened-coredns,v1.7.1,2020/09/25,258,411,32,3,0,704
adobecoldfusion/pmt,latest-2021,2022/12/02,60,88,59,27,0,234
onlyoffice/docspace-router,1.1.4.1,2023/10/23,114,208,10,0,0,332
onlyoffice/docspace-people-server,1.1.4.1,2023/10/23,993,143,209,12,0,1357
ubuntu/mysql,8.0-22.04_edge,2023/11/09,22,4,0,0,0,26
grafana/grafana-enterprise-arm64v8-linux,7.0.6,2020/07/09,4,30,54,9,0,97
balenalib/raspberrypi3-fedora-python,20221109,2022/12/02,0,1,0,0,0,1
redislabs/redistimeseries,99.99.98,2023/10/08,72,19,16,2,0,109
rancher/rancher-ecr-credentials,v3.0.0,2018/03/08,78,100,15,0,0,193
atlassian/jira-software,9.11.3,2023/11/11,25,21,14,1,0,61
rancher/mirrored-cluster-api-controller,v1.4.4,2023/06/27,0,2,1,0,0,3
balenalib/generic-armv7ahf-ubuntu,20230904,2023/09/09,42,9,4,0,0,55
kasmweb/parrotos-5-desktop,1.14.0,2023/09/14,0,6,6,0,0,12
amazon/aws-for-fluent-bit,2.32.0.20231031,2023/11/03,null
bellsoft/liberica-openjre-alpine-musl,21.0.1-12,2023/11/14,0,2,2,0,0,4
balenalib/asus-tinker-board-alpine-openjdk,8-20231106,2023/11/07,0,2,2,0,0,4
mirantis/ucp-istio-mixer,3.4.15,2023/05/11,1,12,18,0,6,37
airbyte/source-zoom-singer,0.2.4,2021/07/06,565,318,282,39,7,1211
balenalib/beaglebone-green-wifi-fedora-openjdk,30-20210825,2021/09/03,null
airbyte/source-amazon-ads,3.4.1,2023/10/15,64,22,6,1,0,93
bitnami/envoy,1.28.0,2023/11/09,74,13,6,2,0,95
onlyoffice/documentserver-ucs,7.5.1.1,2023/11/08,116,106,3,1,0,226
mattermost/elrond,9775779,2023/07/06,0,15,13,2,0,30
balenalib/kitra710-golang,20230904,2023/09/09,448,112,72,9,0,641
balenalib/raspberry-pi2-fedora-node,36-build-20230911,2023/09/12,0,1,1,0,0,2
bitnami/opencart,4.0.2-3,2023/10/11,152,84,57,5,0,298
grafana/smtprelay,v1.5.0-0-gd399838,2021/10/05,75,59,45,17,0,196
balenalib/beaglebone-black-fedora-python,20220928,2022/10/04,0,1,1,0,0,2
onlyoffice/4testing-ds-example,6.0.0,2020/10/21,555,569,32,3,0,1159
balenalib/aarch64-alpine,20231106,2023/11/06,0,2,2,0,0,4
bellsoft/buildpacks.alpaquita-build,musl,2023/04/17,null
airbyte/actions-runner,test,2023/08/18,55,33,47,3,0,138
balenalib/colibri-imx6dl-fedora,20220604,2022/06/12,null
rancher/mirrored-calico-apiserver,v3.26.3,2023/10/06,0,2,5,0,0,7
rancher/mirrored-cloud-provider-vsphere-csi-release-driver,v3.1.1,2023/10/24,3,8,10,3,0,24
onlyoffice/telegram-github-changes-bot,v1.0.0-298-g01a9e56,2023/11/09,0,3,2,0,0,5
airbyte/source-tidb,0.3.0,2023/03/16,30,128,199,15,1,373
airbyte/source-salesloft,1.2.0,2023/07/11,0,15,25,1,0,41
bitnami/mariadb-galera,11.1.3,2023/11/15,90,19,14,2,0,125
objectscale/objectscale-health,1.4.0-397.adb0726,2023/11/13,0,3,2,0,0,5
balenalib/generic-armv7ahf-alpine,20230904,2023/09/09,2,2,5,2,0,11
appdynamics/agent-config-client,23.8.0-721,2023/08/24,0,2,2,0,0,4
balenalib/aarch64-golang,20231106,2023/11/07,441,81,51,5,0,578
cockroachdb/builder,20230830-211921,2023/08/30,192,246,15,0,0,453
airbyte/source-copper,0.3.0,2023/08/29,0,15,24,1,0,40
balenalib/apalis-imx6q-ubuntu-openjdk,20210826,2021/09/04,136,435,10,0,0,581
solace/docker-qpid-proton,ubuntu,2018/06/19,648,792,92,0,0,1532
mattermost/pgbouncer-config-reload,v1.1.1,2023/09/28,0,4,3,0,0,7
cockroachdb/acceptance,20221005-223354,2022/10/06,84,347,68,34,0,533
vmware/photon-2.0-k8s-dns-kube-dns-amd64,1.14.10-20180619,2018/06/19,15,72,90,57,0,234
balenalib/beaglebone-black-fedora-openjdk,30-20210825,2021/09/03,null
airbyte/source-confluence,0.2.0,2023/08/18,0,15,24,1,0,40
bitnami/phpmyadmin,5.2.1,2023/10/11,149,85,51,4,0,289
hashicorp/consul-replicate,0.4.0-scratch,2017/08/10,null
kasmweb/remmina,1.14.0,2023/09/14,193,396,0,0,0,589
mattermost/mattermost-push-proxy-arm64,5.26.0,2023/11/01,0,2,2,0,0,4
objectscale/alertmanager,3.7.0.0-1334.45d1715e,2021/09/22,6,58,82,3,5,154
kasmweb/java-dev,1.14.0,2023/09/14,228,520,0,0,0,748
kasmweb/pinta,1.14.0,2023/09/14,215,457,0,0,0,672
balenalib/generic-aarch64-ubuntu-golang,20231103,2023/11/06,139,131,0,0,0,270
sysdig/dockerfile-benchmarker,0.0.1,2020/03/16,2,10,29,4,0,45
mirantis/dtr-trivy-adapter,0.14.0,2020/07/31,10,47,78,15,0,150
okteto/civo-webhook,0.5.3,2023/10/18,0,2,4,0,0,6
newrelic/synthetics-node-api-runtime,1.2.1,2023/11/07,102,144,2,0,0,248
docker/imagefs,0.4.0-alpha,0001/01/01,null
rancher/mirrored-longhornio-longhorn-engine,v1.5.1,2023/07/19,5,33,59,0,7,104
rancher/slackin-extended,v2.1.3,2020/10/22,3,77,71,14,0,165
grafana/oncall,v1.3.58,2023/11/14,3,5,3,0,0,11
rancher/terraform-controller-executor,v0.0.13-alpha1,2020/11/19,11,56,105,14,0,186
appdynamics/dl-proxy,23.10.0,2023/10/31,26,9,0,0,0,35
newrelic/newrelic-fluentbit-output,1.17.3,2023/06/20,28,28,17,1,0,74
balenalib/artik5-fedora-python,20220714,2022/07/23,0,1,1,0,0,2
percona/everest-operator-bundle,0.4,2023/10/31,null
balenalib/intel-nuc-alpine-golang,20231106,2023/11/07,0,2,2,0,0,4
balenalib/via-vab820-quad,20220714,2022/07/20,124,69,72,18,0,283
circleci/picard,1.0.196890-89790297,2023/08/10,0,34,16,0,0,50
adobecoldfusion/coldfusionaddons,latest-2023,2023/05/19,270,424,123,46,0,863
mirantis/dtr-rethink,2.9.14,2023/09/28,2,33,27,2,0,64
airbyte/source-callrail,0.1.0,2022/11/15,0,17,25,1,0,43
balena/amd64-balena-multibuild-scripts,0.1.0,2019/10/01,4,14,9,1,0,28
rancher/harvester-csi-driver,v0.1.6,2023/10/18,1,8,9,0,2,20
newrelic/k8s-nri-mongodb,2.4.1,2020/02/10,2,11,29,4,0,46
vmware/likewise-open-toolchain-photon3,1.0.0,2019/12/04,24,216,233,65,0,538
snyk/kubernetes-scanner,v0.20.3,2023/10/16,null
datadog/extendeddaemonset,v0.9.0-rc.2,2022/09/27,67,77,14,1,0,159
airbyte/source-spacex-api,0.1.1,2023/11/07,0,13,24,1,0,38
hashicorp/waypoint-odr,0.11.4,2023/08/09,1,38,26,0,0,65
docker/dtr-registry,2.8.1,2020/06/17,2,9,8,1,0,20
newrelic/nri-forwarder,1.48.1,2023/11/02,0,4,0,0,0,4
balenalib/armv7hf-debian-golang,20230929,2023/10/02,447,109,73,9,0,638
objectscale/qualification-service-tools,0.69.0,2021/03/15,18,136,156,6,6,322
balenalib/raspberrypi3-alpine,20231106,2023/11/07,0,2,2,0,0,4
cockroachdb/loadgen-kv,0.2,2018/03/08,null
balenalib/up-board-fedora-openjdk,8-20231103,2023/11/04,null
okteto/buildkit-proxy,v0.0.1,2022/11/21,0,3,6,0,0,9
bitnami/appsmith,1.9.44,2023/11/08,87,24,21,4,0,136
balenalib/asus-tinker-board-s-python,20230911,2023/09/12,118,38,38,6,0,200
atlassian/default-image,4.20230906,2023/09/06,171,202,33,0,0,406
grafana/grafana-build,main,2023/11/15,0,9,7,0,0,16
vmware/photon-2.0-k8s-heapster-amd64,1.4.2-20180619,2018/06/19,15,72,90,57,0,234
airbyte/destination-google-sheets,0.2.3,2023/09/25,64,24,6,1,0,95
pachyderm/cert-manager-webhook,v0.15.1,2020/05/27,0,0,0,0,6,6
kong/pulp-api,1.1.38,2022/08/24,4,11,9,4,0,28
balenalib/jetson-tx1-ubuntu-node,20230530,2023/06/26,55,20,5,0,0,80
rancher/helm-locker,v0.0.1,2022/05/11,0,17,8,0,2,27
objectscale/confd-sidecar,3.9.0.0-1588.729cf194,2023/04/25,4,30,22,0,0,56
balenalib/generic-armv7ahf-fedora-node,36-build-20230530,2023/06/29,0,1,1,0,0,2
airbyte/workload-launcher,final-8,2023/11/15,12,55,65,4,1,137
datadog/dd-appsec-php-ci,toolchain,2023/08/23,498,190,122,24,0,834
kasmweb/retroarch,1.14.0,2023/09/14,199,394,0,0,0,593
intel/rpbs_app,1.0,2023/08/21,0,2,3,0,0,5
cockroachdb/cockroach-k8s-init,0.2,2017/05/31,132,246,16,0,0,394
rancher/network-policy-manager,v0.2.8,2018/07/08,306,388,24,0,0,718
onlyoffice/box-callback,1.0.1,2023/09/12,0,7,6,0,0,13
kasmweb/share,1.14.0,2023/09/14,28,9,1,0,0,38
balenalib/fincm3-alpine-golang,20221109,2022/11/25,6,30,28,9,0,73
airbyte/source-polygon-stock-api,0.1.1,2023/02/27,0,16,25,1,0,42
astronomerinc/ap-nats-server,2.10.2-1,2023/11/08,0,3,1,0,0,4
lacework/lacework-admission-controller,0.23.2,2023/11/10,0,2,1,0,0,3
balenalib/artik10,20220714,2022/07/22,124,69,72,18,0,283
airbyte/source-punk-api,0.1.0,2022/11/16,0,17,25,1,0,43
jetbrains/code-with-me-relay,1161,2023/01/23,0,19,18,0,0,37
objectscale/kube-scheduler,v0.26.7,2023/07/25,0,7,8,0,0,15
balenalib/revpi-core-3-fedora-golang,20220523,2022/06/04,null
bitnami/drupal-nginx,10.1.6,2023/11/03,163,83,52,5,0,303
mattermost/mattermost-test-team,9f6859c,2020/03/28,6,44,77,9,0,136
datadog/docker-library,zookeeper_3_4_10,2017/11/09,16,51,40,22,0,129
balenalib/zynq-xz702-ubuntu-openjdk,20210826,2021/09/04,136,435,10,0,0,581
graphcore/simple-server-framework,1.0.0,2023/07/20,167,261,32,0,0,460
airbyte/source-ringcentral,0.1.0,2023/05/18,0,16,25,1,0,42
intel/cri-resmgr-agent,v0.8.4,2023/08/25,0,6,4,0,0,10
couchbase/centos-69-sdk-nodevtoolset-build,20180809,2018/08/09,1610,2020,255,7,0,3892
percona/percona-distribution-postgresql,16,2023/09/13,0,2,42,0,0,44
onlyoffice/docspace-api-system,1.1.4.1,2023/10/23,993,143,210,12,0,1358
balenalib/zynq-xz702-ubuntu-node,20220715,2022/07/19,88,103,12,0,0,203
pachyderm/pdk,train-9195916,2023/10/03,504,264,72,10,0,850
jetbrains/datalore-database-command,2023.5.1,1970/01/01,67,101,7,0,0,175
balenalib/raspberrypi3-fedora,20221031,2022/11/04,null
objectscale/record-manager,0.71.3,2021/04/15,17,149,212,36,6,420
newrelic/k8s-operator,snapshot,2020/05/29,0,6,11,0,6,23
syncfusion/boldreports,5.3.8,2023/10/26,53,42,20,0,0,115
kong/statsd-exporter-advanced,0.3.1,2020/04/20,null
pachyderm/pachyderm,2.7.0-test.2,0001/01/01,null
airbyte/source-zendesk-talk,0.1.9,2023/08/03,140,79,40,3,0,262
airbyte/destination-pinecone,0.0.20,2023/11/13,64,22,8,4,0,98
rapidfort/couchdb_3-ib,3.3.2,2023/11/01,21,5,2,0,0,28
mattermost/mattermost-prod-db,v5.33.3,2021/03/31,9,27,42,7,0,85
rancher/goharbor-harbor-adminserver,v1.7.5,2019/04/01,14,63,88,37,0,202
objectscale/objectstore-pre-update,0.71.3,2021/03/24,2,17,20,0,0,39
objectscale/ecs-service-broker,2.3.1,2023/04/12,61,33,13,2,0,109
airbyte/source-gitlab-singer,0.1.3,2021/07/06,565,319,281,39,7,1211
airbyte/mirrored-keycloak-amd,21.1,2023/06/28,15,36,7,0,0,58
datadog/agent-dev,7-48-1-usm-extended-http-capturing-py3-jmx,2023/10/15,27,45,17,0,0,89
rancher/pipeline,v0.1.1,2018/01/11,161,285,17,0,0,463
vmware/hcx-helm,3.2,2021/01/07,20,137,170,64,0,391
portainer/portainer-ee,2.19.2,2023/11/12,0,17,13,0,0,30
rancher/harvester-network-controller,v0.3.5,2023/08/29,5,10,16,0,1,32
airbyte/airbyte-workload-api-server,final-0,2023/11/14,12,50,58,4,1,125
airbyte/source-news-api,0.1.1,2023/04/30,0,16,25,1,0,42
dynatrace/dynatrace-configuration-as-code,2.9.2,2023/11/06,0,2,2,0,0,4
balenalib/amd64-ubuntu-node,20230929,2023/10/07,40,10,5,0,0,55
balenalib/artik5-ubuntu-openjdk,20210826,2021/09/21,136,435,10,0,0,581
bitnami/jaeger,1.51.0,2023/11/08,74,13,10,2,0,99
airbyte/destination-bitdotio,0.1.0,2022/10/14,33,150,253,30,1,467
rapidfort/couchdb,3.3.2,2023/10/12,58,12,11,3,0,84
mirantis/gpu-example,cuda-10.2,2020/02/16,153,207,15,0,0,375
snyk/runtime-fixtures,ubuntu,2022/03/14,87,159,4,0,0,250
balenalib/qemux86-64-fedora-python,20231103,2023/11/04,null
rapidfort/nats,2.9.18,2023/06/20,23,8,6,0,0,37
docker/ucp-init-azure,2.1.0,2017/02/09,18,117,93,51,0,279
graphcore/pytorch-minimal-early-access,3.3.0-EA.1-ubuntu-20.04-20230504,2023/05/04,180,274,34,0,0,488
hashicorp/boundary,0.14.2,2023/10/31,0,3,0,0,0,3
astronomerinc/ap-cli-install,0.26.20,2023/11/08,0,2,0,0,0,2
balenalib/amd64-alpine-openjdk,8-20231106,2023/11/07,0,2,2,0,0,4
pachyderm/compile,go1.13.8,2020/02/14,620,875,78,0,0,1573
airbyte/destination-typesense,0.1.1,2023/08/23,0,15,24,1,0,40
balenalib/revpi-core-3-fedora-openjdk,8-20221031,2022/11/04,null
adobecoldfusion/coldfusionaddons2023,2023.0.0,2023/05/19,270,424,123,46,0,863
balenalib/hummingboard-fedora-openjdk,30-20210825,2021/09/03,null
ubuntu/dotnet-deps,7.0_beta,2023/11/01,null
dynatrace/edgeconnect,1.46.0,2023/11/06,12,4,0,0,0,16
redis/redis-stack-server,7.2.0-RC3,2023/07/10,27,16,2,0,0,45
primekey/ejbca-ce,8.0.0,2023/06/29,3,46,31,6,0,86
hashicorp/terraform,1.7.0-alpha20231108,2023/11/08,0,2,2,0,0,4
newrelic/synthetics-minion,3.0.95,2023/11/06,40,18,4,0,0,62
percona/percona-orchestrator,3.2.6-10,2023/09/19,126,32,9,0,0,167
okteto/react-getting-started,dev,2020/05/06,518,1482,1198,250,12,3460
balena/balena-redis,0.0.4,2021/01/06,2,6,32,4,0,44
bitnami/chartmuseum-archived,0.15.0,2023/05/21,75,68,34,5,0,182
rancher/mirrored-bci-busybox,15.4.11.2,2022/09/26,0,3,2,0,2,7
airbyte/source-gridly,0.1.1,2022/12/08,0,14,17,0,0,31
intel/apphsm,v2.4,2023/10/15,37,18,2,0,0,57
okteto/registry,2.7.2-dev2,2021/02/05,0,7,8,3,0,18
rancher/mirrored-longhornio-longhorn-instance-manager,v1.5.1,2023/07/19,4,29,51,0,7,91
airbyte/source-google-pagespeed-insights,0.1.1,2023/05/26,0,15,25,1,0,41
bitnami/ksql,7.5.2,2023/11/09,74,17,8,7,0,106
newrelic/kubernetes-operator,v0.0.8,2021/07/10,0,6,13,0,4,23
balenalib/am571x-evm-alpine-openjdk,8-3.14-20220112,2022/01/19,2,50,42,13,0,107
balenalib/asus-tinker-board-debian-openjdk,20230904,2023/09/09,129,65,42,6,0,242
rancher/longhorn-manager-test,5766348,2018/07/10,650,2164,1783,380,40,5017
portainer/pause,3.9,2023/08/30,null
okteto/wasp,alpha,2021/02/26,434,511,453,93,9,1500
adobecoldfusion/apimanageraddons,latest-2023,2023/05/17,37,25,8,3,0,73
balenalib/spacely-tx2-golang,20231106,2023/11/07,442,81,51,5,0,579
stackhawk/hawkscan,3.4.7,2023/11/10,51,31,5,0,0,87
mirantis/ucp-istio-pilot,3.4.15,2023/05/11,471,1162,150,1,0,1784
google/apigee-deployment-admissionhook,1.1.1,2020/02/05,0,0,0,0,6,6
rancher/storage-secrets-bridge-v2,v0.9.7,2018/07/09,125,218,12,0,0,355
balenalib/artik530-debian-golang,20220714,2022/07/22,473,263,219,28,1,984
airbyte/source-surveymonkey,0.2.3,2023/10/15,64,22,6,1,0,93
nginxinc/nginx-unprivileged,1.25.3,2023/11/14,81,21,5,1,0,108
kasmweb/nginx,1.25.1,2023/06/16,2,9,9,2,0,22
okteto/test,2,2022/04/20,113,124,78,23,0,338
atlassian/fisheye,4.8.13,2023/10/27,160,190,26,6,0,382
airbyte/destination-mqtt,0.1.3,2022/09/07,76,76,62,19,0,233
balenalib/artik710-alpine,20230904,2023/09/09,2,2,5,2,0,11
balenalib/raspberrypi3-python,20230530,2023/06/27,118,38,38,6,0,200
airbyte/source-nytimes,0.1.1,2023/03/02,0,16,25,1,0,42
airbyte/source-pagerduty,0.2.0,2023/10/23,0,13,24,1,0,38
onlyoffice/4testing-docspace-api,2.0.0.33,2023/11/15,993,142,206,12,0,1353
kong/fpm,0.8.1,2023/03/01,813,524,331,23,0,1691
balenalib/asus-tinker-board-ubuntu-python,20231026,2023/11/02,37,9,0,0,0,46
balenalib/beaglebone-green-node,20230911,2023/09/11,118,39,39,6,0,202
rancher/machine,v0.15.0-rancher106-s390x,2023/10/04,3,6,10,0,2,21
intel/intel-optimized-mysql,src,2023/02/11,210,314,50,0,0,574
cockroachdb/acceptance-gss-psql,20230920-104814,2023/09/20,117,38,19,3,0,177
docker/containerd-shim-process,6244e3d,2018/08/10,null
onlyoffice/docspace-proxy,1.1.1.1,2023/07/27,139,41,35,3,2,220
vertica/vertica-k8s,23.4.0-0,2023/09/21,66,139,19,0,0,224
hashicorp/vault-enterprise-fips,1.15.2-ent.fips1402,2023/11/07,70,18,0,0,0,88
docker/ucp-pause,3.3.1,2020/02/04,null
airbyte/source-yahoo-finance-price,0.2.0,2023/08/22,0,15,24,1,0,40
rapidfort/keycloak-official,22.0.5-0,2023/10/24,0,1,0,0,0,1
docker/ucp-hyperkube,3.3.1,2020/06/26,6,24,23,1,0,54
kong/kong-gateway,3.5.0.0,2023/11/07,22,3,0,0,0,25
docker/ucp-containerd-shim-process,3.3.1,2019/12/16,null
pingidentity/ldap-sdk-tools,2310,2023/11/01,0,2,1,0,0,3
calcom/cal.com,v3.4.7,2023/11/07,481,268,65,9,0,823
rancher/rpardini-docker-registry-proxy,0.6.1,2020/12/02,3,13,38,5,0,59
rancher/hardened-cilium-llvm,4c18d06f1d545ed6fde810c2b97935dc8938ddc8-build20210521,2021/05/21,536,493,32,3,0,1064
docker/ucp-kube-dns-sidecar,3.2.7,2020/06/26,0,0,0,2,0,2
balenalib/artik533s-debian-openjdk,20220714,2022/07/22,157,128,83,18,0,386
onlyoffice/4testing-docspace-socket,2.0.0.33,2023/11/15,315,74,56,2,0,447
mattermost/sync-helpwanted-tickets,1.1.2,2023/07/26,518,292,112,17,4,943
balenalib/artik533s-ubuntu,20220714,2022/08/02,87,81,11,0,0,179
grafana/pentagon,62,2022/01/25,0,21,31,1,0,53
redhat/ubi8-init,8.8-15,2023/09/13,145,41,6,0,0,192
balenalib/amd64-golang,20231106,2023/11/06,441,82,51,5,0,579
pachyderm/ubuntu_with_s3_clients,0.1,2021/05/02,487,618,58,0,0,1163
graphcore/pytorch-geometric-paperspace,3.3.0,2023/07/03,220,336,28,0,0,584
airbyte/source-oura,0.1.0,2022/10/28,0,17,25,1,0,43
airbyte/source-microsoft-dataverse,0.1.2,2023/08/25,0,13,16,0,0,29
balenalib/artik5-ubuntu-python,20220715,2022/08/02,87,82,13,0,0,182
balenalib/am571x-evm-alpine-python,20220714,2022/07/19,7,38,35,10,0,90
datadog/agent-buildimages-rpm_arm64,v20433308-6861270,2023/09/25,18,93,186,12,1,310
bitnami/rabbitmq-cluster-operator,2.5.0,2023/11/09,0,1,1,0,0,2
ubuntu/kafka,3.1-22.04_edge,2023/07/06,33,38,11,5,0,87
dynatrace/dynatrace-oneagent,1.277.165.20231024-150054,2023/10/25,7,2,0,0,0,9
redislabs/gesher,0.6,2022/01/05,0,4,11,1,0,16
balenalib/spacely-tx2-node,20231106,2023/11/07,114,23,28,4,0,169
airbyte/source-mongodb-internal-poc,0.0.1,2023/08/01,30,120,199,15,1,365
rapidfort/fluentd-ib,1.15.3,2023/06/28,28,11,4,0,0,43
rancher/agent-base,v0.3.0,2016/12/22,306,388,24,0,0,718
rancher/curlimages-curl,7.73.0,2020/10/14,2,10,27,4,0,43
rancher/git-logrotate,v0.7.0,2020/01/02,null
